transfer_id,created_at,creator,deleted_at,update_request_id,updated_at,updater,actual_fee,amount,confirmations,currency,direction,ext_tx_id,extra_info_chunk,memo,native_price,status,user_fee,user_id,wallet_balance,payment_method_id,wallet_id,type,version
7d9e2f7ee8a620310da068a870f373632e9f80aa0a21ddd367b7cd24597414e5-0,2018.11.6 8:44,UNKNOWN,,UNKNOWN-25c569cb-57a1-4054-852b-394b25eb304a,2018.11.6 9:22,UNKNOWN,0,1,8,HDAC,DEPOSIT,7d9e2f7ee8a620310da068a870f373632e9f80aa0a21ddd367b7cd24597414e5,{},,0,COMPLETED,0,sum-user-id,1,acd94460-de75-11e8-bd11-2f9252c4dc2f,accac570-de75-11e8-bd11-2f9252c4dc2f,,1
91f078267ef7fc341ba3221c40c9d729b30dbdce771a5121e5b0ebc2501329c2-0,2018-11-07 00:38:13.043,UNKNOWN,,UNKNOWN-49d1091e-25e5-430f-8f7c-832a77b0f1bc,2018.11.7 1:11,UNKNOWN,0,1999999,8,HDAC,DEPOSIT,91f078267ef7fc341ba3221c40c9d729b30dbdce771a5121e5b0ebc2501329c2,{},,0,COMPLETED,0,sum-user-id,2000000,acd94460-de75-11e8-bd11-2f9252c4dc2f,accac570-de75-11e8-bd11-2f9252c4dc2f,,1
airdrop-20181115-hdac-00151d76-1aa0-4cd8-b18f-8dbfd4b23f9d-withdrawal-exchange,2018.11.15 10:11,UNKNOWN,,UNKNOWN-55c0f2b7-dc24-425b-9be8-6b86719f2865,2018.11.15 10:11,UNKNOWN,0,100,0,HDAC,WITHDRAWAL,,,,0,COMPLETED,0,sum-user-id,1999900,airdrop-20181115-hdac-sum-user-id-withdrawal,accac570-de75-11e8-bd11-2f9252c4dc2f,AIRDROP,0
airdrop-20181115-hdac-005d559e-9146-47b5-ae3b-cc835b3d13a3-withdrawal-exchange,2018.11.15 10:11,UNKNOWN,,UNKNOWN-55c0f2b7-dc24-425b-9be8-6b86719f2865,2018.11.15 10:11,UNKNOWN,0,100,0,HDAC,WITHDRAWAL,,,,0,COMPLETED,0,sum-user-id,1999800,airdrop-20181115-hdac-sum-user-id-withdrawal,accac570-de75-11e8-bd11-2f9252c4dc2f,AIRDROP,0
airdrop-20181115-hdac-00695496-589f-4b1b-8be1-383932b4b512-withdrawal-exchange,2018.11.15 10:11,UNKNOWN,,UNKNOWN-55c0f2b7-dc24-425b-9be8-6b86719f2865,2018.11.15 10:11,UNKNOWN,0,100,0,HDAC,WITHDRAWAL,,,,0,COMPLETED,0,sum-user-id,1999700,airdrop-20181115-hdac-sum-user-id-withdrawal,accac570-de75-11e8-bd11-2f9252c4dc2f,AIRDROP,0
airdrop-20181115-hdac-006d5743-5b07-4268-b6a1-8483a53f0230-withdrawal-exchange,2018.11.15 10:11,UNKNOWN,,UNKNOWN-55c0f2b7-dc24-425b-9be8-6b86719f2865,2018.11.15 10:11,UNKNOWN,0,100,0,HDAC,WITHDRAWAL,,,,0,COMPLETED,0,sum-user-id,1999600,airdrop-20181115-hdac-sum-user-id-withdrawal,accac570-de75-11e8-bd11-2f9252c4dc2f,AIRDROP,0
airdrop-20181115-hdac-00738e8d-efb2-4993-9ef5-578464570f6d-withdrawal-exchange,2018.11.15 10:11,UNKNOWN,,UNKNOWN-55c0f2b7-dc24-425b-9be8-6b86719f2865,2018.11.15 10:11,UNKNOWN,0,100,0,HDAC,WITHDRAWAL,,,,0,COMPLETED,0,sum-user-id,1999500,airdrop-20181115-hdac-sum-user-id-withdrawal,accac570-de75-11e8-bd11-2f9252c4dc2f,AIRDROP,0
airdrop-20181115-hdac-0092137e-d8e8-4dce-bdae-bda2f6e6c1e2-withdrawal-exchange,2018.11.15 10:11,UNKNOWN,,UNKNOWN-55c0f2b7-dc24-425b-9be8-6b86719f2865,2018.11.15 10:11,UNKNOWN,0,100,0,HDAC,WITHDRAWAL,,,,0,COMPLETED,0,sum-user-id,1999400,airdrop-20181115-hdac-sum-user-id-withdrawal,accac570-de75-11e8-bd11-2f9252c4dc2f,AIRDROP,0
airdrop-20181115-hdac-00bf52fe-9595-4fd6-9821-b726e7057817-withdrawal-exchange,2018-11-15 10:11:07.018,UNKNOWN,,UNKNOWN-55c0f2b7-dc24-425b-9be8-6b86719f2865,2018-11-15 10:11:07.018,UNKNOWN,0,100,0,HDAC,WITHDRAWAL,,,,0,COMPLETED,0,sum-user-id,1999300,airdrop-20181115-hdac-sum-user-id-withdrawal,accac570-de75-11e8-bd11-2f9252c4dc2f,AIRDROP,0
airdrop-20181115-hdac-00c09223-23f3-4e27-b60d-9ea1a11738d6-withdrawal-exchange,2018-11-15 10:11:07.050,UNKNOWN,,UNKNOWN-55c0f2b7-dc24-425b-9be8-6b86719f2865,2018-11-15 10:11:07.050,UNKNOWN,0,100,0,HDAC,WITHDRAWAL,,,,0,COMPLETED,0,sum-user-id,1999200,airdrop-20181115-hdac-sum-user-id-withdrawal,accac570-de75-11e8-bd11-2f9252c4dc2f,AIRDROP,0
airdrop-20181115-hdac-00c0ec03-5b33-4b06-9f1a-b6309523cd46-withdrawal-exchange,2018-11-15 10:11:07.082,UNKNOWN,,UNKNOWN-55c0f2b7-dc24-425b-9be8-6b86719f2865,2018-11-15 10:11:07.082,UNKNOWN,0,100,0,HDAC,WITHDRAWAL,,,,0,COMPLETED,0,sum-user-id,1999100,airdrop-20181115-hdac-sum-user-id-withdrawal,accac570-de75-11e8-bd11-2f9252c4dc2f,AIRDROP,0
airdrop-20181115-hdac-00e9e67e-d3c6-4f90-a7a4-327e296996c0-withdrawal-exchange,2018.11.15 10:11,UNKNOWN,,UNKNOWN-55c0f2b7-dc24-425b-9be8-6b86719f2865,2018.11.15 10:11,UNKNOWN,0,100,0,HDAC,WITHDRAWAL,,,,0,COMPLETED,0,sum-user-id,1999000,airdrop-20181115-hdac-sum-user-id-withdrawal,accac570-de75-11e8-bd11-2f9252c4dc2f,AIRDROP,0
airdrop-20181115-hdac-0109d7e4-916e-4487-ae42-03110bd6843b-withdrawal-exchange,2018.11.15 10:11,UNKNOWN,,UNKNOWN-55c0f2b7-dc24-425b-9be8-6b86719f2865,2018.11.15 10:11,UNKNOWN,0,100,0,HDAC,WITHDRAWAL,,,,0,COMPLETED,0,sum-user-id,1998900,airdrop-20181115-hdac-sum-user-id-withdrawal,accac570-de75-11e8-bd11-2f9252c4dc2f,AIRDROP,0
airdrop-20181115-hdac-01530dbc-e2f7-44b2-9805-3a2be92b2ba6-withdrawal-exchange,2018.11.15 10:11,UNKNOWN,,UNKNOWN-55c0f2b7-dc24-425b-9be8-6b86719f2865,2018.11.15 10:11,UNKNOWN,0,100,0,HDAC,WITHDRAWAL,,,,0,COMPLETED,0,sum-user-id,1998800,airdrop-20181115-hdac-sum-user-id-withdrawal,accac570-de75-11e8-bd11-2f9252c4dc2f,AIRDROP,0
airdrop-20181115-hdac-0168b3fc-e98b-4252-92e9-1840aacc726e-withdrawal-exchange,2018.11.15 10:11,UNKNOWN,,UNKNOWN-55c0f2b7-dc24-425b-9be8-6b86719f2865,2018.11.15 10:11,UNKNOWN,0,100,0,HDAC,WITHDRAWAL,,,,0,COMPLETED,0,sum-user-id,1998700,airdrop-20181115-hdac-sum-user-id-withdrawal,accac570-de75-11e8-bd11-2f9252c4dc2f,AIRDROP,0
airdrop-20181115-hdac-01993702-5460-4e8b-9798-04e850b75d4f-withdrawal-exchange,2018.11.15 10:11,UNKNOWN,,UNKNOWN-55c0f2b7-dc24-425b-9be8-6b86719f2865,2018.11.15 10:11,UNKNOWN,0,100,0,HDAC,WITHDRAWAL,,,,0,COMPLETED,0,sum-user-id,1998600,airdrop-20181115-hdac-sum-user-id-withdrawal,accac570-de75-11e8-bd11-2f9252c4dc2f,AIRDROP,0
airdrop-20181115-hdac-01bcaf47-81e0-4449-aea2-5f2110016f5e-withdrawal-exchange,2018.11.15 10:11,UNKNOWN,,UNKNOWN-55c0f2b7-dc24-425b-9be8-6b86719f2865,2018.11.15 10:11,UNKNOWN,0,100,0,HDAC,WITHDRAWAL,,,,0,COMPLETED,0,sum-user-id,1998500,airdrop-20181115-hdac-sum-user-id-withdrawal,accac570-de75-11e8-bd11-2f9252c4dc2f,AIRDROP,0
airdrop-20181115-hdac-01c49649-51a6-44ca-89a9-c64b46182d6d-withdrawal-exchange,2018.11.15 10:11,UNKNOWN,,UNKNOWN-55c0f2b7-dc24-425b-9be8-6b86719f2865,2018.11.15 10:11,UNKNOWN,0,100,0,HDAC,WITHDRAWAL,,,,0,COMPLETED,0,sum-user-id,1998400,airdrop-20181115-hdac-sum-user-id-withdrawal,accac570-de75-11e8-bd11-2f9252c4dc2f,AIRDROP,0
airdrop-20181115-hdac-01c511c3-89a5-4a22-93ed-a8c0e5274aee-withdrawal-exchange,2018.11.15 10:11,UNKNOWN,,UNKNOWN-55c0f2b7-dc24-425b-9be8-6b86719f2865,2018.11.15 10:11,UNKNOWN,0,100,0,HDAC,WITHDRAWAL,,,,0,COMPLETED,0,sum-user-id,1998300,airdrop-20181115-hdac-sum-user-id-withdrawal,accac570-de75-11e8-bd11-2f9252c4dc2f,AIRDROP,0
airdrop-20181115-hdac-01cba3a7-1c38-4500-8f83-c93240e3fbaf-withdrawal-exchange,2018.11.15 10:11,UNKNOWN,,UNKNOWN-55c0f2b7-dc24-425b-9be8-6b86719f2865,2018.11.15 10:11,UNKNOWN,0,100,0,HDAC,WITHDRAWAL,,,,0,COMPLETED,0,sum-user-id,1998200,airdrop-20181115-hdac-sum-user-id-withdrawal,accac570-de75-11e8-bd11-2f9252c4dc2f,AIRDROP,0
airdrop-20181115-hdac-01f09064-0c25-4cb7-98e4-838cb935eadc-withdrawal-exchange,2018.11.15 10:11,UNKNOWN,,UNKNOWN-55c0f2b7-dc24-425b-9be8-6b86719f2865,2018.11.15 10:11,UNKNOWN,0,100,0,HDAC,WITHDRAWAL,,,,0,COMPLETED,0,sum-user-id,1998100,airdrop-20181115-hdac-sum-user-id-withdrawal,accac570-de75-11e8-bd11-2f9252c4dc2f,AIRDROP,0
airdrop-20181115-hdac-021f4ca1-dd73-4114-8c6d-6dfc5e610f0e-withdrawal-exchange,2018.11.15 10:11,UNKNOWN,,UNKNOWN-55c0f2b7-dc24-425b-9be8-6b86719f2865,2018.11.15 10:11,UNKNOWN,0,292.282144,0,HDAC,WITHDRAWAL,,,,0,COMPLETED,0,sum-user-id,1997807.718,airdrop-20181115-hdac-sum-user-id-withdrawal,accac570-de75-11e8-bd11-2f9252c4dc2f,AIRDROP,0
airdrop-20181115-hdac-0229fce0-70ba-45be-8de3-ab72dd010e8a-withdrawal-exchange,2018.11.15 10:11,UNKNOWN,,UNKNOWN-55c0f2b7-dc24-425b-9be8-6b86719f2865,2018.11.15 10:11,UNKNOWN,0,100,0,HDAC,WITHDRAWAL,,,,0,COMPLETED,0,sum-user-id,1997707.718,airdrop-20181115-hdac-sum-user-id-withdrawal,accac570-de75-11e8-bd11-2f9252c4dc2f,AIRDROP,0
airdrop-20181115-hdac-024fe05e-d630-4e2d-bc59-b0228c787309-withdrawal-exchange,2018.11.15 10:11,UNKNOWN,,UNKNOWN-55c0f2b7-dc24-425b-9be8-6b86719f2865,2018.11.15 10:11,UNKNOWN,0,100,0,HDAC,WITHDRAWAL,,,,0,COMPLETED,0,sum-user-id,1997607.718,airdrop-20181115-hdac-sum-user-id-withdrawal,accac570-de75-11e8-bd11-2f9252c4dc2f,AIRDROP,0
airdrop-20181115-hdac-02626745-476f-49ae-a62e-296d6d69c55f-withdrawal-exchange,2018.11.15 10:11,UNKNOWN,,UNKNOWN-55c0f2b7-dc24-425b-9be8-6b86719f2865,2018.11.15 10:11,UNKNOWN,0,100,0,HDAC,WITHDRAWAL,,,,0,COMPLETED,0,sum-user-id,1997507.718,airdrop-20181115-hdac-sum-user-id-withdrawal,accac570-de75-11e8-bd11-2f9252c4dc2f,AIRDROP,0
airdrop-20181115-hdac-027c894b-931d-4030-b76a-fb193146e8a2-withdrawal-exchange,2018.11.15 10:11,UNKNOWN,,UNKNOWN-55c0f2b7-dc24-425b-9be8-6b86719f2865,2018.11.15 10:11,UNKNOWN,0,100,0,HDAC,WITHDRAWAL,,,,0,COMPLETED,0,sum-user-id,1997407.718,airdrop-20181115-hdac-sum-user-id-withdrawal,accac570-de75-11e8-bd11-2f9252c4dc2f,AIRDROP,0
airdrop-20181115-hdac-0291625d-c3db-47b1-a516-44074d7b9477-withdrawal-exchange,2018.11.15 10:11,UNKNOWN,,UNKNOWN-55c0f2b7-dc24-425b-9be8-6b86719f2865,2018.11.15 10:11,UNKNOWN,0,100,0,HDAC,WITHDRAWAL,,,,0,COMPLETED,0,sum-user-id,1997307.718,airdrop-20181115-hdac-sum-user-id-withdrawal,accac570-de75-11e8-bd11-2f9252c4dc2f,AIRDROP,0
airdrop-20181115-hdac-0297651f-0d9a-41a5-a2e3-39991f4b0f81-withdrawal-exchange,2018.11.15 10:11,UNKNOWN,,UNKNOWN-55c0f2b7-dc24-425b-9be8-6b86719f2865,2018.11.15 10:11,UNKNOWN,0,100,0,HDAC,WITHDRAWAL,,,,0,COMPLETED,0,sum-user-id,1997207.718,airdrop-20181115-hdac-sum-user-id-withdrawal,accac570-de75-11e8-bd11-2f9252c4dc2f,AIRDROP,0
airdrop-20181115-hdac-02adde47-06eb-42b1-839e-9b2be0851d0f-withdrawal-exchange,2018.11.15 10:11,UNKNOWN,,UNKNOWN-55c0f2b7-dc24-425b-9be8-6b86719f2865,2018.11.15 10:11,UNKNOWN,0,100,0,HDAC,WITHDRAWAL,,,,0,COMPLETED,0,sum-user-id,1997107.718,airdrop-20181115-hdac-sum-user-id-withdrawal,accac570-de75-11e8-bd11-2f9252c4dc2f,AIRDROP,0
airdrop-20181115-hdac-02bd5e4a-85f8-4e1a-a83b-cd212acfc81e-withdrawal-exchange,2018.11.15 10:11,UNKNOWN,,UNKNOWN-55c0f2b7-dc24-425b-9be8-6b86719f2865,2018.11.15 10:11,UNKNOWN,0,100,0,HDAC,WITHDRAWAL,,,,0,COMPLETED,0,sum-user-id,1997007.718,airdrop-20181115-hdac-sum-user-id-withdrawal,accac570-de75-11e8-bd11-2f9252c4dc2f,AIRDROP,0
airdrop-20181115-hdac-02d30aac-e240-41ae-a389-4c0a0e0bafbb-withdrawal-exchange,2018.11.15 10:11,UNKNOWN,,UNKNOWN-55c0f2b7-dc24-425b-9be8-6b86719f2865,2018.11.15 10:11,UNKNOWN,0,100,0,HDAC,WITHDRAWAL,,,,0,COMPLETED,0,sum-user-id,1996907.718,airdrop-20181115-hdac-sum-user-id-withdrawal,accac570-de75-11e8-bd11-2f9252c4dc2f,AIRDROP,0
airdrop-20181115-hdac-02d75f43-df4b-46c2-8c82-d0a02f9b3195-withdrawal-exchange,2018.11.15 10:11,UNKNOWN,,UNKNOWN-55c0f2b7-dc24-425b-9be8-6b86719f2865,2018.11.15 10:11,UNKNOWN,0,100,0,HDAC,WITHDRAWAL,,,,0,COMPLETED,0,sum-user-id,1996807.718,airdrop-20181115-hdac-sum-user-id-withdrawal,accac570-de75-11e8-bd11-2f9252c4dc2f,AIRDROP,0
airdrop-20181115-hdac-02d773b9-e8f1-436b-b207-59431593fb5e-withdrawal-exchange,2018.11.15 10:11,UNKNOWN,,UNKNOWN-55c0f2b7-dc24-425b-9be8-6b86719f2865,2018.11.15 10:11,UNKNOWN,0,100,0,HDAC,WITHDRAWAL,,,,0,COMPLETED,0,sum-user-id,1996707.718,airdrop-20181115-hdac-sum-user-id-withdrawal,accac570-de75-11e8-bd11-2f9252c4dc2f,AIRDROP,0
airdrop-20181115-hdac-02e2b1d3-3440-41a0-aa4d-ea208603bb69-withdrawal-exchange,2018.11.15 10:11,UNKNOWN,,UNKNOWN-55c0f2b7-dc24-425b-9be8-6b86719f2865,2018.11.15 10:11,UNKNOWN,0,100,0,HDAC,WITHDRAWAL,,,,0,COMPLETED,0,sum-user-id,1996607.718,airdrop-20181115-hdac-sum-user-id-withdrawal,accac570-de75-11e8-bd11-2f9252c4dc2f,AIRDROP,0
airdrop-20181115-hdac-0303a584-2ac0-4b47-9bb2-c67d48ad959b-withdrawal-exchange,2018.11.15 10:11,UNKNOWN,,UNKNOWN-55c0f2b7-dc24-425b-9be8-6b86719f2865,2018.11.15 10:11,UNKNOWN,0,100,0,HDAC,WITHDRAWAL,,,,0,COMPLETED,0,sum-user-id,1996507.718,airdrop-20181115-hdac-sum-user-id-withdrawal,accac570-de75-11e8-bd11-2f9252c4dc2f,AIRDROP,0
airdrop-20181115-hdac-031e33df-7f53-4769-8dbe-32f209e68800-withdrawal-exchange,2018.11.15 10:11,UNKNOWN,,UNKNOWN-55c0f2b7-dc24-425b-9be8-6b86719f2865,2018.11.15 10:11,UNKNOWN,0,100,0,HDAC,WITHDRAWAL,,,,0,COMPLETED,0,sum-user-id,1996407.718,airdrop-20181115-hdac-sum-user-id-withdrawal,accac570-de75-11e8-bd11-2f9252c4dc2f,AIRDROP,0
airdrop-20181115-hdac-031e6503-44bc-4482-a4a2-1de687dddc6e-withdrawal-exchange,2018-11-15 10:11:08.009,UNKNOWN,,UNKNOWN-55c0f2b7-dc24-425b-9be8-6b86719f2865,2018-11-15 10:11:08.009,UNKNOWN,0,100,0,HDAC,WITHDRAWAL,,,,0,COMPLETED,0,sum-user-id,1996307.718,airdrop-20181115-hdac-sum-user-id-withdrawal,accac570-de75-11e8-bd11-2f9252c4dc2f,AIRDROP,0
airdrop-20181115-hdac-03294505-70cf-435b-b548-494b098c4061-withdrawal-exchange,2018-11-15 10:11:08.047,UNKNOWN,,UNKNOWN-55c0f2b7-dc24-425b-9be8-6b86719f2865,2018-11-15 10:11:08.047,UNKNOWN,0,100,0,HDAC,WITHDRAWAL,,,,0,COMPLETED,0,sum-user-id,1996207.718,airdrop-20181115-hdac-sum-user-id-withdrawal,accac570-de75-11e8-bd11-2f9252c4dc2f,AIRDROP,0
airdrop-20181115-hdac-0333c40d-1b07-49f6-9ca5-1bfec245000f-withdrawal-exchange,2018-11-15 10:11:08.092,UNKNOWN,,UNKNOWN-55c0f2b7-dc24-425b-9be8-6b86719f2865,2018-11-15 10:11:08.092,UNKNOWN,0,100,0,HDAC,WITHDRAWAL,,,,0,COMPLETED,0,sum-user-id,1996107.718,airdrop-20181115-hdac-sum-user-id-withdrawal,accac570-de75-11e8-bd11-2f9252c4dc2f,AIRDROP,0
airdrop-20181115-hdac-03431c5f-4006-4ef7-ac57-ce4d89964c97-withdrawal-exchange,2018.11.15 10:11,UNKNOWN,,UNKNOWN-55c0f2b7-dc24-425b-9be8-6b86719f2865,2018.11.15 10:11,UNKNOWN,0,100,0,HDAC,WITHDRAWAL,,,,0,COMPLETED,0,sum-user-id,1996007.718,airdrop-20181115-hdac-sum-user-id-withdrawal,accac570-de75-11e8-bd11-2f9252c4dc2f,AIRDROP,0
airdrop-20181115-hdac-034bade2-27bb-4bd8-9e55-d29834133135-withdrawal-exchange,2018.11.15 10:11,UNKNOWN,,UNKNOWN-55c0f2b7-dc24-425b-9be8-6b86719f2865,2018.11.15 10:11,UNKNOWN,0,100,0,HDAC,WITHDRAWAL,,,,0,COMPLETED,0,sum-user-id,1995907.718,airdrop-20181115-hdac-sum-user-id-withdrawal,accac570-de75-11e8-bd11-2f9252c4dc2f,AIRDROP,0
airdrop-20181115-hdac-036c8913-d8ca-4e23-958c-bfacfac59813-withdrawal-exchange,2018.11.15 10:11,UNKNOWN,,UNKNOWN-55c0f2b7-dc24-425b-9be8-6b86719f2865,2018.11.15 10:11,UNKNOWN,0,100,0,HDAC,WITHDRAWAL,,,,0,COMPLETED,0,sum-user-id,1995807.718,airdrop-20181115-hdac-sum-user-id-withdrawal,accac570-de75-11e8-bd11-2f9252c4dc2f,AIRDROP,0
airdrop-20181115-hdac-03817d30-7400-467e-8415-442732991cf2-withdrawal-exchange,2018.11.15 10:11,UNKNOWN,,UNKNOWN-55c0f2b7-dc24-425b-9be8-6b86719f2865,2018.11.15 10:11,UNKNOWN,0,100,0,HDAC,WITHDRAWAL,,,,0,COMPLETED,0,sum-user-id,1995707.718,airdrop-20181115-hdac-sum-user-id-withdrawal,accac570-de75-11e8-bd11-2f9252c4dc2f,AIRDROP,0
airdrop-20181115-hdac-0383526e-4bd3-4bfa-9ed8-ff5b21c81446-withdrawal-exchange,2018.11.15 10:11,UNKNOWN,,UNKNOWN-55c0f2b7-dc24-425b-9be8-6b86719f2865,2018.11.15 10:11,UNKNOWN,0,100,0,HDAC,WITHDRAWAL,,,,0,COMPLETED,0,sum-user-id,1995607.718,airdrop-20181115-hdac-sum-user-id-withdrawal,accac570-de75-11e8-bd11-2f9252c4dc2f,AIRDROP,0
airdrop-20181115-hdac-0391bd70-f15e-43db-bd91-e523f602a7e1-withdrawal-exchange,2018.11.15 10:11,UNKNOWN,,UNKNOWN-55c0f2b7-dc24-425b-9be8-6b86719f2865,2018.11.15 10:11,UNKNOWN,0,100,0,HDAC,WITHDRAWAL,,,,0,COMPLETED,0,sum-user-id,1995507.718,airdrop-20181115-hdac-sum-user-id-withdrawal,accac570-de75-11e8-bd11-2f9252c4dc2f,AIRDROP,0
airdrop-20181115-hdac-03bb69b3-dea1-4731-afe0-eaf7d527f6a2-withdrawal-exchange,2018.11.15 10:11,UNKNOWN,,UNKNOWN-55c0f2b7-dc24-425b-9be8-6b86719f2865,2018.11.15 10:11,UNKNOWN,0,100,0,HDAC,WITHDRAWAL,,,,0,COMPLETED,0,sum-user-id,1995407.718,airdrop-20181115-hdac-sum-user-id-withdrawal,accac570-de75-11e8-bd11-2f9252c4dc2f,AIRDROP,0
airdrop-20181115-hdac-03bd53a4-37e7-48fd-bc6a-f7940887caa8-withdrawal-exchange,2018.11.15 10:11,UNKNOWN,,UNKNOWN-55c0f2b7-dc24-425b-9be8-6b86719f2865,2018.11.15 10:11,UNKNOWN,0,100,0,HDAC,WITHDRAWAL,,,,0,COMPLETED,0,sum-user-id,1995307.718,airdrop-20181115-hdac-sum-user-id-withdrawal,accac570-de75-11e8-bd11-2f9252c4dc2f,AIRDROP,0
airdrop-20181115-hdac-03bd7aa0-08b4-44e7-bcc2-49457ad30435-withdrawal-exchange,2018.11.15 10:11,UNKNOWN,,UNKNOWN-55c0f2b7-dc24-425b-9be8-6b86719f2865,2018.11.15 10:11,UNKNOWN,0,9600.802844,0,HDAC,WITHDRAWAL,,,,0,COMPLETED,0,sum-user-id,1985706.915,airdrop-20181115-hdac-sum-user-id-withdrawal,accac570-de75-11e8-bd11-2f9252c4dc2f,AIRDROP,0
airdrop-20181115-hdac-03c9756d-78ae-42e4-9002-b64791b892cc-withdrawal-exchange,2018.11.15 10:11,UNKNOWN,,UNKNOWN-55c0f2b7-dc24-425b-9be8-6b86719f2865,2018.11.15 10:11,UNKNOWN,0,100,0,HDAC,WITHDRAWAL,,,,0,COMPLETED,0,sum-user-id,1985606.915,airdrop-20181115-hdac-sum-user-id-withdrawal,accac570-de75-11e8-bd11-2f9252c4dc2f,AIRDROP,0
airdrop-20181115-hdac-03d2f3e3-84da-4333-818b-e408aaeec290-withdrawal-exchange,2018.11.15 10:11,UNKNOWN,,UNKNOWN-55c0f2b7-dc24-425b-9be8-6b86719f2865,2018.11.15 10:11,UNKNOWN,0,100,0,HDAC,WITHDRAWAL,,,,0,COMPLETED,0,sum-user-id,1985506.915,airdrop-20181115-hdac-sum-user-id-withdrawal,accac570-de75-11e8-bd11-2f9252c4dc2f,AIRDROP,0
airdrop-20181115-hdac-03f351da-3b2e-41a0-8c92-a189fd45a21c-withdrawal-exchange,2018.11.15 10:11,UNKNOWN,,UNKNOWN-55c0f2b7-dc24-425b-9be8-6b86719f2865,2018.11.15 10:11,UNKNOWN,0,100,0,HDAC,WITHDRAWAL,,,,0,COMPLETED,0,sum-user-id,1985406.915,airdrop-20181115-hdac-sum-user-id-withdrawal,accac570-de75-11e8-bd11-2f9252c4dc2f,AIRDROP,0
airdrop-20181115-hdac-0462386b-f48e-4c17-bba8-f54943b5881c-withdrawal-exchange,2018.11.15 10:11,UNKNOWN,,UNKNOWN-55c0f2b7-dc24-425b-9be8-6b86719f2865,2018.11.15 10:11,UNKNOWN,0,100,0,HDAC,WITHDRAWAL,,,,0,COMPLETED,0,sum-user-id,1985306.915,airdrop-20181115-hdac-sum-user-id-withdrawal,accac570-de75-11e8-bd11-2f9252c4dc2f,AIRDROP,0
airdrop-20181115-hdac-04800bf0-2dda-4e08-9419-c3f442eeffbc-withdrawal-exchange,2018.11.15 10:11,UNKNOWN,,UNKNOWN-55c0f2b7-dc24-425b-9be8-6b86719f2865,2018.11.15 10:11,UNKNOWN,0,100,0,HDAC,WITHDRAWAL,,,,0,COMPLETED,0,sum-user-id,1985206.915,airdrop-20181115-hdac-sum-user-id-withdrawal,accac570-de75-11e8-bd11-2f9252c4dc2f,AIRDROP,0
airdrop-20181115-hdac-04842f19-08b0-4eeb-aa74-a234c1092edb-withdrawal-exchange,2018.11.15 10:11,UNKNOWN,,UNKNOWN-55c0f2b7-dc24-425b-9be8-6b86719f2865,2018.11.15 10:11,UNKNOWN,0,100,0,HDAC,WITHDRAWAL,,,,0,COMPLETED,0,sum-user-id,1985106.915,airdrop-20181115-hdac-sum-user-id-withdrawal,accac570-de75-11e8-bd11-2f9252c4dc2f,AIRDROP,0
airdrop-20181115-hdac-048db771-c1da-4c3b-b2a3-d80a99c61384-withdrawal-exchange,2018.11.15 10:11,UNKNOWN,,UNKNOWN-55c0f2b7-dc24-425b-9be8-6b86719f2865,2018.11.15 10:11,UNKNOWN,0,100,0,HDAC,WITHDRAWAL,,,,0,COMPLETED,0,sum-user-id,1985006.915,airdrop-20181115-hdac-sum-user-id-withdrawal,accac570-de75-11e8-bd11-2f9252c4dc2f,AIRDROP,0
airdrop-20181115-hdac-04a9d21b-5e1c-4d2c-b555-acd287a8af5f-withdrawal-exchange,2018.11.15 10:11,UNKNOWN,,UNKNOWN-55c0f2b7-dc24-425b-9be8-6b86719f2865,2018.11.15 10:11,UNKNOWN,0,100,0,HDAC,WITHDRAWAL,,,,0,COMPLETED,0,sum-user-id,1984906.915,airdrop-20181115-hdac-sum-user-id-withdrawal,accac570-de75-11e8-bd11-2f9252c4dc2f,AIRDROP,0
airdrop-20181115-hdac-04d20871-df2e-45db-8659-2d329b1ba255-withdrawal-exchange,2018.11.15 10:11,UNKNOWN,,UNKNOWN-55c0f2b7-dc24-425b-9be8-6b86719f2865,2018.11.15 10:11,UNKNOWN,0,100,0,HDAC,WITHDRAWAL,,,,0,COMPLETED,0,sum-user-id,1984806.915,airdrop-20181115-hdac-sum-user-id-withdrawal,accac570-de75-11e8-bd11-2f9252c4dc2f,AIRDROP,0
airdrop-20181115-hdac-04f7e9f1-5933-4721-a234-0d01e423138a-withdrawal-exchange,2018.11.15 10:11,UNKNOWN,,UNKNOWN-55c0f2b7-dc24-425b-9be8-6b86719f2865,2018.11.15 10:11,UNKNOWN,0,100,0,HDAC,WITHDRAWAL,,,,0,COMPLETED,0,sum-user-id,1984706.915,airdrop-20181115-hdac-sum-user-id-withdrawal,accac570-de75-11e8-bd11-2f9252c4dc2f,AIRDROP,0
airdrop-20181115-hdac-0501b76f-f814-4a99-b0b0-f1ce2ee31596-withdrawal-exchange,2018.11.15 10:11,UNKNOWN,,UNKNOWN-55c0f2b7-dc24-425b-9be8-6b86719f2865,2018.11.15 10:11,UNKNOWN,0,100,0,HDAC,WITHDRAWAL,,,,0,COMPLETED,0,sum-user-id,1984606.915,airdrop-20181115-hdac-sum-user-id-withdrawal,accac570-de75-11e8-bd11-2f9252c4dc2f,AIRDROP,0
airdrop-20181115-hdac-052eae7e-fe6b-49a6-a9e2-838a67841683-withdrawal-exchange,2018.11.15 10:11,UNKNOWN,,UNKNOWN-55c0f2b7-dc24-425b-9be8-6b86719f2865,2018.11.15 10:11,UNKNOWN,0,100,0,HDAC,WITHDRAWAL,,,,0,COMPLETED,0,sum-user-id,1984506.915,airdrop-20181115-hdac-sum-user-id-withdrawal,accac570-de75-11e8-bd11-2f9252c4dc2f,AIRDROP,0
airdrop-20181115-hdac-053f1628-be6b-4e63-8aea-c4a69ac94711-withdrawal-exchange,2018.11.15 10:11,UNKNOWN,,UNKNOWN-55c0f2b7-dc24-425b-9be8-6b86719f2865,2018.11.15 10:11,UNKNOWN,0,100,0,HDAC,WITHDRAWAL,,,,0,COMPLETED,0,sum-user-id,1984406.915,airdrop-20181115-hdac-sum-user-id-withdrawal,accac570-de75-11e8-bd11-2f9252c4dc2f,AIRDROP,0
airdrop-20181115-hdac-054d8a29-28f2-42a5-8576-5aa826d76378-withdrawal-exchange,2018.11.15 10:11,UNKNOWN,,UNKNOWN-55c0f2b7-dc24-425b-9be8-6b86719f2865,2018.11.15 10:11,UNKNOWN,0,100,0,HDAC,WITHDRAWAL,,,,0,COMPLETED,0,sum-user-id,1984306.915,airdrop-20181115-hdac-sum-user-id-withdrawal,accac570-de75-11e8-bd11-2f9252c4dc2f,AIRDROP,0
airdrop-20181115-hdac-055f4ceb-da45-4984-a923-3f8eed26775d-withdrawal-exchange,2018.11.15 10:11,UNKNOWN,,UNKNOWN-55c0f2b7-dc24-425b-9be8-6b86719f2865,2018.11.15 10:11,UNKNOWN,0,100,0,HDAC,WITHDRAWAL,,,,0,COMPLETED,0,sum-user-id,1984206.915,airdrop-20181115-hdac-sum-user-id-withdrawal,accac570-de75-11e8-bd11-2f9252c4dc2f,AIRDROP,0
airdrop-20181115-hdac-057630ed-abc0-4492-ab9d-bc74d062358c-withdrawal-exchange,2018.11.15 10:11,UNKNOWN,,UNKNOWN-55c0f2b7-dc24-425b-9be8-6b86719f2865,2018.11.15 10:11,UNKNOWN,0,100,0,HDAC,WITHDRAWAL,,,,0,COMPLETED,0,sum-user-id,1984106.915,airdrop-20181115-hdac-sum-user-id-withdrawal,accac570-de75-11e8-bd11-2f9252c4dc2f,AIRDROP,0
airdrop-20181115-hdac-0587b1e9-fd55-4324-b5b4-1ed5dab6c370-withdrawal-exchange,2018.11.15 10:11,UNKNOWN,,UNKNOWN-55c0f2b7-dc24-425b-9be8-6b86719f2865,2018.11.15 10:11,UNKNOWN,0,100,0,HDAC,WITHDRAWAL,,,,0,COMPLETED,0,sum-user-id,1984006.915,airdrop-20181115-hdac-sum-user-id-withdrawal,accac570-de75-11e8-bd11-2f9252c4dc2f,AIRDROP,0
airdrop-20181115-hdac-058bd9ec-f0e3-428c-b4e1-cd863dd34f5a-withdrawal-exchange,2018-11-15 10:11:09.035,UNKNOWN,,UNKNOWN-55c0f2b7-dc24-425b-9be8-6b86719f2865,2018-11-15 10:11:09.035,UNKNOWN,0,100,0,HDAC,WITHDRAWAL,,,,0,COMPLETED,0,sum-user-id,1983906.915,airdrop-20181115-hdac-sum-user-id-withdrawal,accac570-de75-11e8-bd11-2f9252c4dc2f,AIRDROP,0
airdrop-20181115-hdac-05a6ef61-6773-4485-aebc-9afcc46f1055-withdrawal-exchange,2018-11-15 10:11:09.068,UNKNOWN,,UNKNOWN-55c0f2b7-dc24-425b-9be8-6b86719f2865,2018-11-15 10:11:09.068,UNKNOWN,0,100,0,HDAC,WITHDRAWAL,,,,0,COMPLETED,0,sum-user-id,1983806.915,airdrop-20181115-hdac-sum-user-id-withdrawal,accac570-de75-11e8-bd11-2f9252c4dc2f,AIRDROP,0
airdrop-20181115-hdac-05a7b43d-f777-4873-912b-110e08840290-withdrawal-exchange,2018.11.15 10:11,UNKNOWN,,UNKNOWN-55c0f2b7-dc24-425b-9be8-6b86719f2865,2018.11.15 10:11,UNKNOWN,0,100,0,HDAC,WITHDRAWAL,,,,0,COMPLETED,0,sum-user-id,1983706.915,airdrop-20181115-hdac-sum-user-id-withdrawal,accac570-de75-11e8-bd11-2f9252c4dc2f,AIRDROP,0
airdrop-20181115-hdac-05b06f6c-1079-4754-8f48-dbff0f762145-withdrawal-exchange,2018.11.15 10:11,UNKNOWN,,UNKNOWN-55c0f2b7-dc24-425b-9be8-6b86719f2865,2018.11.15 10:11,UNKNOWN,0,100,0,HDAC,WITHDRAWAL,,,,0,COMPLETED,0,sum-user-id,1983606.915,airdrop-20181115-hdac-sum-user-id-withdrawal,accac570-de75-11e8-bd11-2f9252c4dc2f,AIRDROP,0
airdrop-20181115-hdac-064648db-c0f0-457b-841d-c7a97762e5be-withdrawal-exchange,2018.11.15 10:11,UNKNOWN,,UNKNOWN-55c0f2b7-dc24-425b-9be8-6b86719f2865,2018.11.15 10:11,UNKNOWN,0,100,0,HDAC,WITHDRAWAL,,,,0,COMPLETED,0,sum-user-id,1983506.915,airdrop-20181115-hdac-sum-user-id-withdrawal,accac570-de75-11e8-bd11-2f9252c4dc2f,AIRDROP,0
airdrop-20181115-hdac-064f62d4-b037-410d-8e03-c189399b43c6-withdrawal-exchange,2018.11.15 10:11,UNKNOWN,,UNKNOWN-55c0f2b7-dc24-425b-9be8-6b86719f2865,2018.11.15 10:11,UNKNOWN,0,100,0,HDAC,WITHDRAWAL,,,,0,COMPLETED,0,sum-user-id,1983406.915,airdrop-20181115-hdac-sum-user-id-withdrawal,accac570-de75-11e8-bd11-2f9252c4dc2f,AIRDROP,0
airdrop-20181115-hdac-066596fa-eb3f-4fd4-8597-ed32fad8152f-withdrawal-exchange,2018.11.15 10:11,UNKNOWN,,UNKNOWN-55c0f2b7-dc24-425b-9be8-6b86719f2865,2018.11.15 10:11,UNKNOWN,0,100,0,HDAC,WITHDRAWAL,,,,0,COMPLETED,0,sum-user-id,1983306.915,airdrop-20181115-hdac-sum-user-id-withdrawal,accac570-de75-11e8-bd11-2f9252c4dc2f,AIRDROP,0
airdrop-20181115-hdac-068de9af-5594-4cd9-bd5a-4d87a2abf572-withdrawal-exchange,2018.11.15 10:11,UNKNOWN,,UNKNOWN-55c0f2b7-dc24-425b-9be8-6b86719f2865,2018.11.15 10:11,UNKNOWN,0,11135.45945,0,HDAC,WITHDRAWAL,,,,0,COMPLETED,0,sum-user-id,1972171.456,airdrop-20181115-hdac-sum-user-id-withdrawal,accac570-de75-11e8-bd11-2f9252c4dc2f,AIRDROP,0
airdrop-20181115-hdac-07368797-7ab8-4a8c-92fc-c79a2b34cecb-withdrawal-exchange,2018.11.15 10:11,UNKNOWN,,UNKNOWN-55c0f2b7-dc24-425b-9be8-6b86719f2865,2018.11.15 10:11,UNKNOWN,0,100,0,HDAC,WITHDRAWAL,,,,0,COMPLETED,0,sum-user-id,1972071.456,airdrop-20181115-hdac-sum-user-id-withdrawal,accac570-de75-11e8-bd11-2f9252c4dc2f,AIRDROP,0
airdrop-20181115-hdac-0758d050-4a78-4855-8a76-cb8331d71913-withdrawal-exchange,2018.11.15 10:11,UNKNOWN,,UNKNOWN-55c0f2b7-dc24-425b-9be8-6b86719f2865,2018.11.15 10:11,UNKNOWN,0,100,0,HDAC,WITHDRAWAL,,,,0,COMPLETED,0,sum-user-id,1971971.456,airdrop-20181115-hdac-sum-user-id-withdrawal,accac570-de75-11e8-bd11-2f9252c4dc2f,AIRDROP,0
airdrop-20181115-hdac-075b7811-d1be-4a7b-a9b7-6878c53eb812-withdrawal-exchange,2018.11.15 10:11,UNKNOWN,,UNKNOWN-55c0f2b7-dc24-425b-9be8-6b86719f2865,2018.11.15 10:11,UNKNOWN,0,100,0,HDAC,WITHDRAWAL,,,,0,COMPLETED,0,sum-user-id,1971871.456,airdrop-20181115-hdac-sum-user-id-withdrawal,accac570-de75-11e8-bd11-2f9252c4dc2f,AIRDROP,0
airdrop-20181115-hdac-0783e002-4176-45c4-ab06-25b420a4b4a9-withdrawal-exchange,2018.11.15 10:11,UNKNOWN,,UNKNOWN-55c0f2b7-dc24-425b-9be8-6b86719f2865,2018.11.15 10:11,UNKNOWN,0,100,0,HDAC,WITHDRAWAL,,,,0,COMPLETED,0,sum-user-id,1971771.456,airdrop-20181115-hdac-sum-user-id-withdrawal,accac570-de75-11e8-bd11-2f9252c4dc2f,AIRDROP,0
airdrop-20181115-hdac-07a977a0-373c-4b3e-b440-9bd9f7705da4-withdrawal-exchange,2018.11.15 10:11,UNKNOWN,,UNKNOWN-55c0f2b7-dc24-425b-9be8-6b86719f2865,2018.11.15 10:11,UNKNOWN,0,100,0,HDAC,WITHDRAWAL,,,,0,COMPLETED,0,sum-user-id,1971671.456,airdrop-20181115-hdac-sum-user-id-withdrawal,accac570-de75-11e8-bd11-2f9252c4dc2f,AIRDROP,0
airdrop-20181115-hdac-07c07aa4-5d31-4b7d-8388-4d053c5cff1d-withdrawal-exchange,2018.11.15 10:11,UNKNOWN,,UNKNOWN-55c0f2b7-dc24-425b-9be8-6b86719f2865,2018.11.15 10:11,UNKNOWN,0,1106.3,0,HDAC,WITHDRAWAL,,,,0,COMPLETED,0,sum-user-id,1970565.156,airdrop-20181115-hdac-sum-user-id-withdrawal,accac570-de75-11e8-bd11-2f9252c4dc2f,AIRDROP,0
airdrop-20181115-hdac-07c9c638-d2bf-46e8-8733-cb805932bb69-withdrawal-exchange,2018.11.15 10:11,UNKNOWN,,UNKNOWN-55c0f2b7-dc24-425b-9be8-6b86719f2865,2018.11.15 10:11,UNKNOWN,0,100,0,HDAC,WITHDRAWAL,,,,0,COMPLETED,0,sum-user-id,1970465.156,airdrop-20181115-hdac-sum-user-id-withdrawal,accac570-de75-11e8-bd11-2f9252c4dc2f,AIRDROP,0
airdrop-20181115-hdac-07caa285-0f0a-45f5-be0d-c6630960615c-withdrawal-exchange,2018.11.15 10:11,UNKNOWN,,UNKNOWN-55c0f2b7-dc24-425b-9be8-6b86719f2865,2018.11.15 10:11,UNKNOWN,0,100,0,HDAC,WITHDRAWAL,,,,0,COMPLETED,0,sum-user-id,1970365.156,airdrop-20181115-hdac-sum-user-id-withdrawal,accac570-de75-11e8-bd11-2f9252c4dc2f,AIRDROP,0
airdrop-20181115-hdac-07ef3ae9-bdff-4a39-948a-6d50c7821d6a-withdrawal-exchange,2018.11.15 10:11,UNKNOWN,,UNKNOWN-55c0f2b7-dc24-425b-9be8-6b86719f2865,2018.11.15 10:11,UNKNOWN,0,100,0,HDAC,WITHDRAWAL,,,,0,COMPLETED,0,sum-user-id,1970265.156,airdrop-20181115-hdac-sum-user-id-withdrawal,accac570-de75-11e8-bd11-2f9252c4dc2f,AIRDROP,0
airdrop-20181115-hdac-07f5f975-da0d-4b28-9f4d-2e81bda220a2-withdrawal-exchange,2018.11.15 10:11,UNKNOWN,,UNKNOWN-55c0f2b7-dc24-425b-9be8-6b86719f2865,2018.11.15 10:11,UNKNOWN,0,100,0,HDAC,WITHDRAWAL,,,,0,COMPLETED,0,sum-user-id,1970165.156,airdrop-20181115-hdac-sum-user-id-withdrawal,accac570-de75-11e8-bd11-2f9252c4dc2f,AIRDROP,0
airdrop-20181115-hdac-0802e7fd-fe42-4d23-a60a-f53b89d35a81-withdrawal-exchange,2018.11.15 10:11,UNKNOWN,,UNKNOWN-55c0f2b7-dc24-425b-9be8-6b86719f2865,2018.11.15 10:11,UNKNOWN,0,100,0,HDAC,WITHDRAWAL,,,,0,COMPLETED,0,sum-user-id,1970065.156,airdrop-20181115-hdac-sum-user-id-withdrawal,accac570-de75-11e8-bd11-2f9252c4dc2f,AIRDROP,0
airdrop-20181115-hdac-083af54a-5122-471a-8ea2-31f70adce2f6-withdrawal-exchange,2018.11.15 10:11,UNKNOWN,,UNKNOWN-55c0f2b7-dc24-425b-9be8-6b86719f2865,2018.11.15 10:11,UNKNOWN,0,100,0,HDAC,WITHDRAWAL,,,,0,COMPLETED,0,sum-user-id,1969965.156,airdrop-20181115-hdac-sum-user-id-withdrawal,accac570-de75-11e8-bd11-2f9252c4dc2f,AIRDROP,0
airdrop-20181115-hdac-0867ffba-0a19-4e36-b934-b632e9be3bd2-withdrawal-exchange,2018.11.15 10:11,UNKNOWN,,UNKNOWN-55c0f2b7-dc24-425b-9be8-6b86719f2865,2018.11.15 10:11,UNKNOWN,0,100,0,HDAC,WITHDRAWAL,,,,0,COMPLETED,0,sum-user-id,1969865.156,airdrop-20181115-hdac-sum-user-id-withdrawal,accac570-de75-11e8-bd11-2f9252c4dc2f,AIRDROP,0
airdrop-20181115-hdac-0877b760-21c5-4179-9fff-e8bd095a8bc5-withdrawal-exchange,2018.11.15 10:11,UNKNOWN,,UNKNOWN-55c0f2b7-dc24-425b-9be8-6b86719f2865,2018.11.15 10:11,UNKNOWN,0,100,0,HDAC,WITHDRAWAL,,,,0,COMPLETED,0,sum-user-id,1969765.156,airdrop-20181115-hdac-sum-user-id-withdrawal,accac570-de75-11e8-bd11-2f9252c4dc2f,AIRDROP,0
airdrop-20181115-hdac-08b73486-0e6d-4c47-89b9-0a39730b6dc9-withdrawal-exchange,2018.11.15 10:11,UNKNOWN,,UNKNOWN-55c0f2b7-dc24-425b-9be8-6b86719f2865,2018.11.15 10:11,UNKNOWN,0,100,0,HDAC,WITHDRAWAL,,,,0,COMPLETED,0,sum-user-id,1969665.156,airdrop-20181115-hdac-sum-user-id-withdrawal,accac570-de75-11e8-bd11-2f9252c4dc2f,AIRDROP,0
airdrop-20181115-hdac-08c88484-a9e3-4ac3-b1cb-b76d676cdd29-withdrawal-exchange,2018.11.15 10:11,UNKNOWN,,UNKNOWN-55c0f2b7-dc24-425b-9be8-6b86719f2865,2018.11.15 10:11,UNKNOWN,0,100,0,HDAC,WITHDRAWAL,,,,0,COMPLETED,0,sum-user-id,1969565.156,airdrop-20181115-hdac-sum-user-id-withdrawal,accac570-de75-11e8-bd11-2f9252c4dc2f,AIRDROP,0
airdrop-20181115-hdac-090ddf39-b0d0-4a94-bc75-b192e81a9a3e-withdrawal-exchange,2018.11.15 10:11,UNKNOWN,,UNKNOWN-55c0f2b7-dc24-425b-9be8-6b86719f2865,2018.11.15 10:11,UNKNOWN,0,100,0,HDAC,WITHDRAWAL,,,,0,COMPLETED,0,sum-user-id,1969465.156,airdrop-20181115-hdac-sum-user-id-withdrawal,accac570-de75-11e8-bd11-2f9252c4dc2f,AIRDROP,0
airdrop-20181115-hdac-0912c3f9-d391-4b79-82ac-3601915685b4-withdrawal-exchange,2018.11.15 10:11,UNKNOWN,,UNKNOWN-55c0f2b7-dc24-425b-9be8-6b86719f2865,2018.11.15 10:11,UNKNOWN,0,100,0,HDAC,WITHDRAWAL,,,,0,COMPLETED,0,sum-user-id,1969365.156,airdrop-20181115-hdac-sum-user-id-withdrawal,accac570-de75-11e8-bd11-2f9252c4dc2f,AIRDROP,0
airdrop-20181115-hdac-092549b9-4845-44e5-8b65-7ce343ac690f-withdrawal-exchange,2018.11.15 10:11,UNKNOWN,,UNKNOWN-55c0f2b7-dc24-425b-9be8-6b86719f2865,2018.11.15 10:11,UNKNOWN,0,100,0,HDAC,WITHDRAWAL,,,,0,COMPLETED,0,sum-user-id,1969265.156,airdrop-20181115-hdac-sum-user-id-withdrawal,accac570-de75-11e8-bd11-2f9252c4dc2f,AIRDROP,0
airdrop-20181115-hdac-0941a720-ef03-4868-a775-2d9fbba34c52-withdrawal-exchange,2018-11-15 10:11:10.005,UNKNOWN,,UNKNOWN-55c0f2b7-dc24-425b-9be8-6b86719f2865,2018-11-15 10:11:10.005,UNKNOWN,0,100,0,HDAC,WITHDRAWAL,,,,0,COMPLETED,0,sum-user-id,1969165.156,airdrop-20181115-hdac-sum-user-id-withdrawal,accac570-de75-11e8-bd11-2f9252c4dc2f,AIRDROP,0
airdrop-20181115-hdac-09446413-0202-444d-af2f-1a41182db85b-withdrawal-exchange,2018-11-15 10:11:10.042,UNKNOWN,,UNKNOWN-55c0f2b7-dc24-425b-9be8-6b86719f2865,2018-11-15 10:11:10.042,UNKNOWN,0,100,0,HDAC,WITHDRAWAL,,,,0,COMPLETED,0,sum-user-id,1969065.156,airdrop-20181115-hdac-sum-user-id-withdrawal,accac570-de75-11e8-bd11-2f9252c4dc2f,AIRDROP,0
airdrop-20181115-hdac-09631761-267d-4fb4-a458-0b0c9aec28d0-withdrawal-exchange,2018-11-15 10:11:10.077,UNKNOWN,,UNKNOWN-55c0f2b7-dc24-425b-9be8-6b86719f2865,2018-11-15 10:11:10.077,UNKNOWN,0,100,0,HDAC,WITHDRAWAL,,,,0,COMPLETED,0,sum-user-id,1968965.156,airdrop-20181115-hdac-sum-user-id-withdrawal,accac570-de75-11e8-bd11-2f9252c4dc2f,AIRDROP,0
airdrop-20181115-hdac-096f8c9f-340a-4bfe-a9d7-f884d6e35301-withdrawal-exchange,2018.11.15 10:11,UNKNOWN,,UNKNOWN-55c0f2b7-dc24-425b-9be8-6b86719f2865,2018.11.15 10:11,UNKNOWN,0,100,0,HDAC,WITHDRAWAL,,,,0,COMPLETED,0,sum-user-id,1968865.156,airdrop-20181115-hdac-sum-user-id-withdrawal,accac570-de75-11e8-bd11-2f9252c4dc2f,AIRDROP,0
airdrop-20181115-hdac-098e3929-45d2-43e1-aac0-c212b16446f4-withdrawal-exchange,2018.11.15 10:11,UNKNOWN,,UNKNOWN-55c0f2b7-dc24-425b-9be8-6b86719f2865,2018.11.15 10:11,UNKNOWN,0,100,0,HDAC,WITHDRAWAL,,,,0,COMPLETED,0,sum-user-id,1968765.156,airdrop-20181115-hdac-sum-user-id-withdrawal,accac570-de75-11e8-bd11-2f9252c4dc2f,AIRDROP,0
airdrop-20181115-hdac-09af990a-7adf-4308-aa81-ad840e20b54a-withdrawal-exchange,2018.11.15 10:11,UNKNOWN,,UNKNOWN-55c0f2b7-dc24-425b-9be8-6b86719f2865,2018.11.15 10:11,UNKNOWN,0,100,0,HDAC,WITHDRAWAL,,,,0,COMPLETED,0,sum-user-id,1968665.156,airdrop-20181115-hdac-sum-user-id-withdrawal,accac570-de75-11e8-bd11-2f9252c4dc2f,AIRDROP,0
airdrop-20181115-hdac-09b28c8d-025a-4cc1-8a1b-cbf806f6e91d-withdrawal-exchange,2018.11.15 10:11,UNKNOWN,,UNKNOWN-55c0f2b7-dc24-425b-9be8-6b86719f2865,2018.11.15 10:11,UNKNOWN,0,100,0,HDAC,WITHDRAWAL,,,,0,COMPLETED,0,sum-user-id,1968565.156,airdrop-20181115-hdac-sum-user-id-withdrawal,accac570-de75-11e8-bd11-2f9252c4dc2f,AIRDROP,0
airdrop-20181115-hdac-09bd038e-5f50-4f91-a871-c9cf353a49d1-withdrawal-exchange,2018.11.15 10:11,UNKNOWN,,UNKNOWN-55c0f2b7-dc24-425b-9be8-6b86719f2865,2018.11.15 10:11,UNKNOWN,0,100,0,HDAC,WITHDRAWAL,,,,0,COMPLETED,0,sum-user-id,1968465.156,airdrop-20181115-hdac-sum-user-id-withdrawal,accac570-de75-11e8-bd11-2f9252c4dc2f,AIRDROP,0
airdrop-20181115-hdac-09e51559-d888-4832-80cc-1a94807f8423-withdrawal-exchange,2018.11.15 10:11,UNKNOWN,,UNKNOWN-55c0f2b7-dc24-425b-9be8-6b86719f2865,2018.11.15 10:11,UNKNOWN,0,100,0,HDAC,WITHDRAWAL,,,,0,COMPLETED,0,sum-user-id,1968365.156,airdrop-20181115-hdac-sum-user-id-withdrawal,accac570-de75-11e8-bd11-2f9252c4dc2f,AIRDROP,0
airdrop-20181115-hdac-09f09ca0-81d0-46ec-82a7-904c34659a9e-withdrawal-exchange,2018.11.15 10:11,UNKNOWN,,UNKNOWN-55c0f2b7-dc24-425b-9be8-6b86719f2865,2018.11.15 10:11,UNKNOWN,0,100,0,HDAC,WITHDRAWAL,,,,0,COMPLETED,0,sum-user-id,1968265.156,airdrop-20181115-hdac-sum-user-id-withdrawal,accac570-de75-11e8-bd11-2f9252c4dc2f,AIRDROP,0
airdrop-20181115-hdac-0a29a2b2-8255-4811-b0fb-6fbf57c2b083-withdrawal-exchange,2018.11.15 10:11,UNKNOWN,,UNKNOWN-55c0f2b7-dc24-425b-9be8-6b86719f2865,2018.11.15 10:11,UNKNOWN,0,100,0,HDAC,WITHDRAWAL,,,,0,COMPLETED,0,sum-user-id,1968165.156,airdrop-20181115-hdac-sum-user-id-withdrawal,accac570-de75-11e8-bd11-2f9252c4dc2f,AIRDROP,0
airdrop-20181115-hdac-0a2eacd2-589d-4aed-bbc5-15aa1a2437d5-withdrawal-exchange,2018.11.15 10:11,UNKNOWN,,UNKNOWN-55c0f2b7-dc24-425b-9be8-6b86719f2865,2018.11.15 10:11,UNKNOWN,0,100,0,HDAC,WITHDRAWAL,,,,0,COMPLETED,0,sum-user-id,1968065.156,airdrop-20181115-hdac-sum-user-id-withdrawal,accac570-de75-11e8-bd11-2f9252c4dc2f,AIRDROP,0
airdrop-20181115-hdac-0a2f5b56-8e2f-4afb-8595-d5c12818a1e5-withdrawal-exchange,2018.11.15 10:11,UNKNOWN,,UNKNOWN-55c0f2b7-dc24-425b-9be8-6b86719f2865,2018.11.15 10:11,UNKNOWN,0,100,0,HDAC,WITHDRAWAL,,,,0,COMPLETED,0,sum-user-id,1967965.156,airdrop-20181115-hdac-sum-user-id-withdrawal,accac570-de75-11e8-bd11-2f9252c4dc2f,AIRDROP,0
airdrop-20181115-hdac-0a614068-3b6f-4995-8b1a-2777b62e6a54-withdrawal-exchange,2018.11.15 10:11,UNKNOWN,,UNKNOWN-55c0f2b7-dc24-425b-9be8-6b86719f2865,2018.11.15 10:11,UNKNOWN,0,100,0,HDAC,WITHDRAWAL,,,,0,COMPLETED,0,sum-user-id,1967865.156,airdrop-20181115-hdac-sum-user-id-withdrawal,accac570-de75-11e8-bd11-2f9252c4dc2f,AIRDROP,0
airdrop-20181115-hdac-0a952bd5-4cbd-4794-8aa0-b81079578295-withdrawal-exchange,2018.11.15 10:11,UNKNOWN,,UNKNOWN-55c0f2b7-dc24-425b-9be8-6b86719f2865,2018.11.15 10:11,UNKNOWN,0,100,0,HDAC,WITHDRAWAL,,,,0,COMPLETED,0,sum-user-id,1967765.156,airdrop-20181115-hdac-sum-user-id-withdrawal,accac570-de75-11e8-bd11-2f9252c4dc2f,AIRDROP,0
airdrop-20181115-hdac-0addb863-b2c5-4dcc-a7ad-81f0db4554d9-withdrawal-exchange,2018.11.15 10:11,UNKNOWN,,UNKNOWN-55c0f2b7-dc24-425b-9be8-6b86719f2865,2018.11.15 10:11,UNKNOWN,0,100,0,HDAC,WITHDRAWAL,,,,0,COMPLETED,0,sum-user-id,1967665.156,airdrop-20181115-hdac-sum-user-id-withdrawal,accac570-de75-11e8-bd11-2f9252c4dc2f,AIRDROP,0
airdrop-20181115-hdac-0b31fb66-dfcb-4c1d-a16b-1b8e77dd39ff-withdrawal-exchange,2018.11.15 10:11,UNKNOWN,,UNKNOWN-55c0f2b7-dc24-425b-9be8-6b86719f2865,2018.11.15 10:11,UNKNOWN,0,100,0,HDAC,WITHDRAWAL,,,,0,COMPLETED,0,sum-user-id,1967565.156,airdrop-20181115-hdac-sum-user-id-withdrawal,accac570-de75-11e8-bd11-2f9252c4dc2f,AIRDROP,0
airdrop-20181115-hdac-0b4a19de-bf43-4ae2-af66-40ab93cae747-withdrawal-exchange,2018.11.15 10:11,UNKNOWN,,UNKNOWN-55c0f2b7-dc24-425b-9be8-6b86719f2865,2018.11.15 10:11,UNKNOWN,0,100,0,HDAC,WITHDRAWAL,,,,0,COMPLETED,0,sum-user-id,1967465.156,airdrop-20181115-hdac-sum-user-id-withdrawal,accac570-de75-11e8-bd11-2f9252c4dc2f,AIRDROP,0
airdrop-20181115-hdac-0b671262-2e24-4dae-adcb-a654322a542e-withdrawal-exchange,2018.11.15 10:11,UNKNOWN,,UNKNOWN-55c0f2b7-dc24-425b-9be8-6b86719f2865,2018.11.15 10:11,UNKNOWN,0,100,0,HDAC,WITHDRAWAL,,,,0,COMPLETED,0,sum-user-id,1967365.156,airdrop-20181115-hdac-sum-user-id-withdrawal,accac570-de75-11e8-bd11-2f9252c4dc2f,AIRDROP,0
airdrop-20181115-hdac-0b9dd10b-9d57-49f6-95e9-aefc758a4328-withdrawal-exchange,2018.11.15 10:11,UNKNOWN,,UNKNOWN-55c0f2b7-dc24-425b-9be8-6b86719f2865,2018.11.15 10:11,UNKNOWN,0,100,0,HDAC,WITHDRAWAL,,,,0,COMPLETED,0,sum-user-id,1967265.156,airdrop-20181115-hdac-sum-user-id-withdrawal,accac570-de75-11e8-bd11-2f9252c4dc2f,AIRDROP,0
airdrop-20181115-hdac-0ba14e9f-2eab-4f5d-8aca-45d7fb6f2580-withdrawal-exchange,2018.11.15 10:11,UNKNOWN,,UNKNOWN-55c0f2b7-dc24-425b-9be8-6b86719f2865,2018.11.15 10:11,UNKNOWN,0,100,0,HDAC,WITHDRAWAL,,,,0,COMPLETED,0,sum-user-id,1967165.156,airdrop-20181115-hdac-sum-user-id-withdrawal,accac570-de75-11e8-bd11-2f9252c4dc2f,AIRDROP,0
airdrop-20181115-hdac-0bf381fb-f9c9-4f7f-8025-988589b25c90-withdrawal-exchange,2018.11.15 10:11,UNKNOWN,,UNKNOWN-55c0f2b7-dc24-425b-9be8-6b86719f2865,2018.11.15 10:11,UNKNOWN,0,100,0,HDAC,WITHDRAWAL,,,,0,COMPLETED,0,sum-user-id,1967065.156,airdrop-20181115-hdac-sum-user-id-withdrawal,accac570-de75-11e8-bd11-2f9252c4dc2f,AIRDROP,0
airdrop-20181115-hdac-0c06f8bf-75fd-488b-8d55-f45c3550f273-withdrawal-exchange,2018.11.15 10:11,UNKNOWN,,UNKNOWN-55c0f2b7-dc24-425b-9be8-6b86719f2865,2018.11.15 10:11,UNKNOWN,0,100,0,HDAC,WITHDRAWAL,,,,0,COMPLETED,0,sum-user-id,1966965.156,airdrop-20181115-hdac-sum-user-id-withdrawal,accac570-de75-11e8-bd11-2f9252c4dc2f,AIRDROP,0
airdrop-20181115-hdac-0c176f9a-fffc-4b2c-9451-34dd772930cb-withdrawal-exchange,2018.11.15 10:11,UNKNOWN,,UNKNOWN-55c0f2b7-dc24-425b-9be8-6b86719f2865,2018.11.15 10:11,UNKNOWN,0,100,0,HDAC,WITHDRAWAL,,,,0,COMPLETED,0,sum-user-id,1966865.156,airdrop-20181115-hdac-sum-user-id-withdrawal,accac570-de75-11e8-bd11-2f9252c4dc2f,AIRDROP,0
airdrop-20181115-hdac-0c4157e8-6c95-45cd-9b97-a4329f31f214-withdrawal-exchange,2018.11.15 10:11,UNKNOWN,,UNKNOWN-55c0f2b7-dc24-425b-9be8-6b86719f2865,2018.11.15 10:11,UNKNOWN,0,100,0,HDAC,WITHDRAWAL,,,,0,COMPLETED,0,sum-user-id,1966765.156,airdrop-20181115-hdac-sum-user-id-withdrawal,accac570-de75-11e8-bd11-2f9252c4dc2f,AIRDROP,0
airdrop-20181115-hdac-0c4a7358-ebae-4c9e-bbfb-e53b50150eb1-withdrawal-exchange,2018.11.15 10:11,UNKNOWN,,UNKNOWN-55c0f2b7-dc24-425b-9be8-6b86719f2865,2018.11.15 10:11,UNKNOWN,0,100,0,HDAC,WITHDRAWAL,,,,0,COMPLETED,0,sum-user-id,1966665.156,airdrop-20181115-hdac-sum-user-id-withdrawal,accac570-de75-11e8-bd11-2f9252c4dc2f,AIRDROP,0
airdrop-20181115-hdac-0c6738b9-e6c5-4902-9198-154eb3557db0-withdrawal-exchange,2018.11.15 10:11,UNKNOWN,,UNKNOWN-55c0f2b7-dc24-425b-9be8-6b86719f2865,2018.11.15 10:11,UNKNOWN,0,100,0,HDAC,WITHDRAWAL,,,,0,COMPLETED,0,sum-user-id,1966565.156,airdrop-20181115-hdac-sum-user-id-withdrawal,accac570-de75-11e8-bd11-2f9252c4dc2f,AIRDROP,0
airdrop-20181115-hdac-0c696ba1-3e81-4fc6-b763-760aa8217e3a-withdrawal-exchange,2018.11.15 10:11,UNKNOWN,,UNKNOWN-55c0f2b7-dc24-425b-9be8-6b86719f2865,2018.11.15 10:11,UNKNOWN,0,100,0,HDAC,WITHDRAWAL,,,,0,COMPLETED,0,sum-user-id,1966465.156,airdrop-20181115-hdac-sum-user-id-withdrawal,accac570-de75-11e8-bd11-2f9252c4dc2f,AIRDROP,0
airdrop-20181115-hdac-0c8bcca3-aab3-44d1-80db-633580c69ff3-withdrawal-exchange,2018.11.15 10:11,UNKNOWN,,UNKNOWN-55c0f2b7-dc24-425b-9be8-6b86719f2865,2018.11.15 10:11,UNKNOWN,0,100,0,HDAC,WITHDRAWAL,,,,0,COMPLETED,0,sum-user-id,1966365.156,airdrop-20181115-hdac-sum-user-id-withdrawal,accac570-de75-11e8-bd11-2f9252c4dc2f,AIRDROP,0
airdrop-20181115-hdac-0cb85226-6165-4e27-8c40-8ef1092645af-withdrawal-exchange,2018-11-15 10:11:11.021,UNKNOWN,,UNKNOWN-55c0f2b7-dc24-425b-9be8-6b86719f2865,2018-11-15 10:11:11.021,UNKNOWN,0,100,0,HDAC,WITHDRAWAL,,,,0,COMPLETED,0,sum-user-id,1966265.156,airdrop-20181115-hdac-sum-user-id-withdrawal,accac570-de75-11e8-bd11-2f9252c4dc2f,AIRDROP,0
airdrop-20181115-hdac-0cbc8037-5fa6-414d-97ab-897019b83574-withdrawal-exchange,2018-11-15 10:11:11.056,UNKNOWN,,UNKNOWN-55c0f2b7-dc24-425b-9be8-6b86719f2865,2018-11-15 10:11:11.056,UNKNOWN,0,100,0,HDAC,WITHDRAWAL,,,,0,COMPLETED,0,sum-user-id,1966165.156,airdrop-20181115-hdac-sum-user-id-withdrawal,accac570-de75-11e8-bd11-2f9252c4dc2f,AIRDROP,0
airdrop-20181115-hdac-0cfd5b3d-2f67-4b83-95c3-a5d3b47c1683-withdrawal-exchange,2018-11-15 10:11:11.088,UNKNOWN,,UNKNOWN-55c0f2b7-dc24-425b-9be8-6b86719f2865,2018-11-15 10:11:11.088,UNKNOWN,0,100,0,HDAC,WITHDRAWAL,,,,0,COMPLETED,0,sum-user-id,1966065.156,airdrop-20181115-hdac-sum-user-id-withdrawal,accac570-de75-11e8-bd11-2f9252c4dc2f,AIRDROP,0
airdrop-20181115-hdac-0d016233-2b3d-4f43-99fe-73abfde3b257-withdrawal-exchange,2018.11.15 10:11,UNKNOWN,,UNKNOWN-55c0f2b7-dc24-425b-9be8-6b86719f2865,2018.11.15 10:11,UNKNOWN,0,100,0,HDAC,WITHDRAWAL,,,,0,COMPLETED,0,sum-user-id,1965965.156,airdrop-20181115-hdac-sum-user-id-withdrawal,accac570-de75-11e8-bd11-2f9252c4dc2f,AIRDROP,0
airdrop-20181115-hdac-0d1a2d90-6d1b-4088-b83f-69f5b41178d3-withdrawal-exchange,2018.11.15 10:11,UNKNOWN,,UNKNOWN-55c0f2b7-dc24-425b-9be8-6b86719f2865,2018.11.15 10:11,UNKNOWN,0,100,0,HDAC,WITHDRAWAL,,,,0,COMPLETED,0,sum-user-id,1965865.156,airdrop-20181115-hdac-sum-user-id-withdrawal,accac570-de75-11e8-bd11-2f9252c4dc2f,AIRDROP,0
airdrop-20181115-hdac-0d21c36c-7d02-41b2-8557-a05de227a003-withdrawal-exchange,2018.11.15 10:11,UNKNOWN,,UNKNOWN-55c0f2b7-dc24-425b-9be8-6b86719f2865,2018.11.15 10:11,UNKNOWN,0,100,0,HDAC,WITHDRAWAL,,,,0,COMPLETED,0,sum-user-id,1965765.156,airdrop-20181115-hdac-sum-user-id-withdrawal,accac570-de75-11e8-bd11-2f9252c4dc2f,AIRDROP,0
airdrop-20181115-hdac-0d360f8a-6d39-4a98-9853-8b95030d30ba-withdrawal-exchange,2018.11.15 10:11,UNKNOWN,,UNKNOWN-55c0f2b7-dc24-425b-9be8-6b86719f2865,2018.11.15 10:11,UNKNOWN,0,100,0,HDAC,WITHDRAWAL,,,,0,COMPLETED,0,sum-user-id,1965665.156,airdrop-20181115-hdac-sum-user-id-withdrawal,accac570-de75-11e8-bd11-2f9252c4dc2f,AIRDROP,0
airdrop-20181115-hdac-0d7ca825-46a0-4e02-9b02-3ad575210462-withdrawal-exchange,2018.11.15 10:11,UNKNOWN,,UNKNOWN-55c0f2b7-dc24-425b-9be8-6b86719f2865,2018.11.15 10:11,UNKNOWN,0,100,0,HDAC,WITHDRAWAL,,,,0,COMPLETED,0,sum-user-id,1965565.156,airdrop-20181115-hdac-sum-user-id-withdrawal,accac570-de75-11e8-bd11-2f9252c4dc2f,AIRDROP,0
airdrop-20181115-hdac-0d7e5d71-ea55-4c0e-aa15-f97d813c055e-withdrawal-exchange,2018.11.15 10:11,UNKNOWN,,UNKNOWN-55c0f2b7-dc24-425b-9be8-6b86719f2865,2018.11.15 10:11,UNKNOWN,0,100,0,HDAC,WITHDRAWAL,,,,0,COMPLETED,0,sum-user-id,1965465.156,airdrop-20181115-hdac-sum-user-id-withdrawal,accac570-de75-11e8-bd11-2f9252c4dc2f,AIRDROP,0
airdrop-20181115-hdac-0d92f4cc-3711-4de9-93f0-9ae246e495b1-withdrawal-exchange,2018.11.15 10:11,UNKNOWN,,UNKNOWN-55c0f2b7-dc24-425b-9be8-6b86719f2865,2018.11.15 10:11,UNKNOWN,0,100,0,HDAC,WITHDRAWAL,,,,0,COMPLETED,0,sum-user-id,1965365.156,airdrop-20181115-hdac-sum-user-id-withdrawal,accac570-de75-11e8-bd11-2f9252c4dc2f,AIRDROP,0
airdrop-20181115-hdac-0d9792de-3952-42cf-a2a8-dc1f94f1e816-withdrawal-exchange,2018.11.15 10:11,UNKNOWN,,UNKNOWN-55c0f2b7-dc24-425b-9be8-6b86719f2865,2018.11.15 10:11,UNKNOWN,0,100,0,HDAC,WITHDRAWAL,,,,0,COMPLETED,0,sum-user-id,1965265.156,airdrop-20181115-hdac-sum-user-id-withdrawal,accac570-de75-11e8-bd11-2f9252c4dc2f,AIRDROP,0
airdrop-20181115-hdac-0da48064-07f0-4583-b50b-7b3b975e8f6f-withdrawal-exchange,2018.11.15 10:11,UNKNOWN,,UNKNOWN-55c0f2b7-dc24-425b-9be8-6b86719f2865,2018.11.15 10:11,UNKNOWN,0,100,0,HDAC,WITHDRAWAL,,,,0,COMPLETED,0,sum-user-id,1965165.156,airdrop-20181115-hdac-sum-user-id-withdrawal,accac570-de75-11e8-bd11-2f9252c4dc2f,AIRDROP,0
airdrop-20181115-hdac-0dc6859e-d098-4930-8632-a1fa1650ce4e-withdrawal-exchange,2018.11.15 10:11,UNKNOWN,,UNKNOWN-55c0f2b7-dc24-425b-9be8-6b86719f2865,2018.11.15 10:11,UNKNOWN,0,100,0,HDAC,WITHDRAWAL,,,,0,COMPLETED,0,sum-user-id,1965065.156,airdrop-20181115-hdac-sum-user-id-withdrawal,accac570-de75-11e8-bd11-2f9252c4dc2f,AIRDROP,0
airdrop-20181115-hdac-0dec78db-5333-4bad-a689-3979921550a0-withdrawal-exchange,2018.11.15 10:11,UNKNOWN,,UNKNOWN-55c0f2b7-dc24-425b-9be8-6b86719f2865,2018.11.15 10:11,UNKNOWN,0,100,0,HDAC,WITHDRAWAL,,,,0,COMPLETED,0,sum-user-id,1964965.156,airdrop-20181115-hdac-sum-user-id-withdrawal,accac570-de75-11e8-bd11-2f9252c4dc2f,AIRDROP,0
airdrop-20181115-hdac-0df39f2f-dee0-4f5a-a49e-951632637564-withdrawal-exchange,2018.11.15 10:11,UNKNOWN,,UNKNOWN-55c0f2b7-dc24-425b-9be8-6b86719f2865,2018.11.15 10:11,UNKNOWN,0,100,0,HDAC,WITHDRAWAL,,,,0,COMPLETED,0,sum-user-id,1964865.156,airdrop-20181115-hdac-sum-user-id-withdrawal,accac570-de75-11e8-bd11-2f9252c4dc2f,AIRDROP,0
airdrop-20181115-hdac-0e5ea54e-5e1b-4f8c-98bb-6e06b7f9e66b-withdrawal-exchange,2018.11.15 10:11,UNKNOWN,,UNKNOWN-55c0f2b7-dc24-425b-9be8-6b86719f2865,2018.11.15 10:11,UNKNOWN,0,100,0,HDAC,WITHDRAWAL,,,,0,COMPLETED,0,sum-user-id,1964765.156,airdrop-20181115-hdac-sum-user-id-withdrawal,accac570-de75-11e8-bd11-2f9252c4dc2f,AIRDROP,0
airdrop-20181115-hdac-0e9c1fa4-af31-4ae9-a147-a56eaf9bf8b9-withdrawal-exchange,2018.11.15 10:11,UNKNOWN,,UNKNOWN-55c0f2b7-dc24-425b-9be8-6b86719f2865,2018.11.15 10:11,UNKNOWN,0,375.218459,0,HDAC,WITHDRAWAL,,,,0,COMPLETED,0,sum-user-id,1964389.937,airdrop-20181115-hdac-sum-user-id-withdrawal,accac570-de75-11e8-bd11-2f9252c4dc2f,AIRDROP,0
airdrop-20181115-hdac-0eb8d3b7-ec91-48d8-9149-3d4385d8c494-withdrawal-exchange,2018.11.15 10:11,UNKNOWN,,UNKNOWN-55c0f2b7-dc24-425b-9be8-6b86719f2865,2018.11.15 10:11,UNKNOWN,0,100,0,HDAC,WITHDRAWAL,,,,0,COMPLETED,0,sum-user-id,1964289.937,airdrop-20181115-hdac-sum-user-id-withdrawal,accac570-de75-11e8-bd11-2f9252c4dc2f,AIRDROP,0
airdrop-20181115-hdac-0ec26625-c20c-4a62-a84c-06befaa022ef-withdrawal-exchange,2018.11.15 10:11,UNKNOWN,,UNKNOWN-55c0f2b7-dc24-425b-9be8-6b86719f2865,2018.11.15 10:11,UNKNOWN,0,100,0,HDAC,WITHDRAWAL,,,,0,COMPLETED,0,sum-user-id,1964189.937,airdrop-20181115-hdac-sum-user-id-withdrawal,accac570-de75-11e8-bd11-2f9252c4dc2f,AIRDROP,0
airdrop-20181115-hdac-0efa2f6d-0c4e-4493-b862-5b2c232642ef-withdrawal-exchange,2018.11.15 10:11,UNKNOWN,,UNKNOWN-55c0f2b7-dc24-425b-9be8-6b86719f2865,2018.11.15 10:11,UNKNOWN,0,100,0,HDAC,WITHDRAWAL,,,,0,COMPLETED,0,sum-user-id,1964089.937,airdrop-20181115-hdac-sum-user-id-withdrawal,accac570-de75-11e8-bd11-2f9252c4dc2f,AIRDROP,0
airdrop-20181115-hdac-0f09bb89-a925-45bc-bc29-dc94f56b8244-withdrawal-exchange,2018.11.15 10:11,UNKNOWN,,UNKNOWN-55c0f2b7-dc24-425b-9be8-6b86719f2865,2018.11.15 10:11,UNKNOWN,0,100,0,HDAC,WITHDRAWAL,,,,0,COMPLETED,0,sum-user-id,1963989.937,airdrop-20181115-hdac-sum-user-id-withdrawal,accac570-de75-11e8-bd11-2f9252c4dc2f,AIRDROP,0
airdrop-20181115-hdac-0f3fdccd-1d7d-4fe6-b58f-5869fda9d6fe-withdrawal-exchange,2018.11.15 10:11,UNKNOWN,,UNKNOWN-55c0f2b7-dc24-425b-9be8-6b86719f2865,2018.11.15 10:11,UNKNOWN,0,100,0,HDAC,WITHDRAWAL,,,,0,COMPLETED,0,sum-user-id,1963889.937,airdrop-20181115-hdac-sum-user-id-withdrawal,accac570-de75-11e8-bd11-2f9252c4dc2f,AIRDROP,0
airdrop-20181115-hdac-0f475801-2370-4e3d-919c-b71f65efcaf3-withdrawal-exchange,2018.11.15 10:11,UNKNOWN,,UNKNOWN-55c0f2b7-dc24-425b-9be8-6b86719f2865,2018.11.15 10:11,UNKNOWN,0,100,0,HDAC,WITHDRAWAL,,,,0,COMPLETED,0,sum-user-id,1963789.937,airdrop-20181115-hdac-sum-user-id-withdrawal,accac570-de75-11e8-bd11-2f9252c4dc2f,AIRDROP,0
airdrop-20181115-hdac-0f4a67dd-f370-4659-87f0-5c47f4e0b60f-withdrawal-exchange,2018.11.15 10:11,UNKNOWN,,UNKNOWN-55c0f2b7-dc24-425b-9be8-6b86719f2865,2018.11.15 10:11,UNKNOWN,0,100,0,HDAC,WITHDRAWAL,,,,0,COMPLETED,0,sum-user-id,1963689.937,airdrop-20181115-hdac-sum-user-id-withdrawal,accac570-de75-11e8-bd11-2f9252c4dc2f,AIRDROP,0
airdrop-20181115-hdac-0f730148-1944-406b-8d42-ba7d2b74aa1d-withdrawal-exchange,2018.11.15 10:12,UNKNOWN,,UNKNOWN-55c0f2b7-dc24-425b-9be8-6b86719f2865,2018.11.15 10:12,UNKNOWN,0,2019.27,0,HDAC,WITHDRAWAL,,,,0,COMPLETED,0,sum-user-id,1367746.069,airdrop-20181115-hdac-sum-user-id-withdrawal,accac570-de75-11e8-bd11-2f9252c4dc2f,AIRDROP,0
airdrop-20181115-hdac-0f76bab2-8b48-4ce0-9bc9-42c0043a203a-withdrawal-exchange,2018.11.15 10:11,UNKNOWN,,UNKNOWN-55c0f2b7-dc24-425b-9be8-6b86719f2865,2018.11.15 10:11,UNKNOWN,0,100,0,HDAC,WITHDRAWAL,,,,0,COMPLETED,0,sum-user-id,1963589.937,airdrop-20181115-hdac-sum-user-id-withdrawal,accac570-de75-11e8-bd11-2f9252c4dc2f,AIRDROP,0
airdrop-20181115-hdac-0fad0d49-952a-42dd-9a99-4377aff382b5-withdrawal-exchange,2018.11.15 10:11,UNKNOWN,,UNKNOWN-55c0f2b7-dc24-425b-9be8-6b86719f2865,2018.11.15 10:11,UNKNOWN,0,100,0,HDAC,WITHDRAWAL,,,,0,COMPLETED,0,sum-user-id,1963489.937,airdrop-20181115-hdac-sum-user-id-withdrawal,accac570-de75-11e8-bd11-2f9252c4dc2f,AIRDROP,0
airdrop-20181115-hdac-0fb82442-bff5-4df5-b00d-19493411eeed-withdrawal-exchange,2018.11.15 10:11,UNKNOWN,,UNKNOWN-55c0f2b7-dc24-425b-9be8-6b86719f2865,2018.11.15 10:11,UNKNOWN,0,100,0,HDAC,WITHDRAWAL,,,,0,COMPLETED,0,sum-user-id,1963389.937,airdrop-20181115-hdac-sum-user-id-withdrawal,accac570-de75-11e8-bd11-2f9252c4dc2f,AIRDROP,0
airdrop-20181115-hdac-10064c0d-9788-46a8-8e27-2a4a5e22922b-withdrawal-exchange,2018.11.15 10:11,UNKNOWN,,UNKNOWN-55c0f2b7-dc24-425b-9be8-6b86719f2865,2018.11.15 10:11,UNKNOWN,0,100,0,HDAC,WITHDRAWAL,,,,0,COMPLETED,0,sum-user-id,1963289.937,airdrop-20181115-hdac-sum-user-id-withdrawal,accac570-de75-11e8-bd11-2f9252c4dc2f,AIRDROP,0
airdrop-20181115-hdac-10293015-f3e1-4cf0-95a0-fb5169fa301f-withdrawal-exchange,2018.11.15 10:11,UNKNOWN,,UNKNOWN-55c0f2b7-dc24-425b-9be8-6b86719f2865,2018.11.15 10:11,UNKNOWN,0,100,0,HDAC,WITHDRAWAL,,,,0,COMPLETED,0,sum-user-id,1963189.937,airdrop-20181115-hdac-sum-user-id-withdrawal,accac570-de75-11e8-bd11-2f9252c4dc2f,AIRDROP,0
airdrop-20181115-hdac-1049a75e-ac12-4eef-9821-d3f426462304-withdrawal-exchange,2018.11.15 10:11,UNKNOWN,,UNKNOWN-55c0f2b7-dc24-425b-9be8-6b86719f2865,2018.11.15 10:11,UNKNOWN,0,100,0,HDAC,WITHDRAWAL,,,,0,COMPLETED,0,sum-user-id,1963089.937,airdrop-20181115-hdac-sum-user-id-withdrawal,accac570-de75-11e8-bd11-2f9252c4dc2f,AIRDROP,0
airdrop-20181115-hdac-1058a0b6-2175-4378-8614-d7ed9c2c1265-withdrawal-exchange,2018-11-15 10:11:12.019,UNKNOWN,,UNKNOWN-55c0f2b7-dc24-425b-9be8-6b86719f2865,2018-11-15 10:11:12.019,UNKNOWN,0,100,0,HDAC,WITHDRAWAL,,,,0,COMPLETED,0,sum-user-id,1962989.937,airdrop-20181115-hdac-sum-user-id-withdrawal,accac570-de75-11e8-bd11-2f9252c4dc2f,AIRDROP,0
airdrop-20181115-hdac-10599d5a-5dd2-46b8-a0bb-1c2d909b60f0-withdrawal-exchange,2018-11-15 10:11:12.052,UNKNOWN,,UNKNOWN-55c0f2b7-dc24-425b-9be8-6b86719f2865,2018-11-15 10:11:12.052,UNKNOWN,0,100,0,HDAC,WITHDRAWAL,,,,0,COMPLETED,0,sum-user-id,1962889.937,airdrop-20181115-hdac-sum-user-id-withdrawal,accac570-de75-11e8-bd11-2f9252c4dc2f,AIRDROP,0
airdrop-20181115-hdac-105fea83-8545-4857-9fb6-7b2bbc99b888-withdrawal-exchange,2018-11-15 10:11:12.090,UNKNOWN,,UNKNOWN-55c0f2b7-dc24-425b-9be8-6b86719f2865,2018-11-15 10:11:12.090,UNKNOWN,0,100,0,HDAC,WITHDRAWAL,,,,0,COMPLETED,0,sum-user-id,1962789.937,airdrop-20181115-hdac-sum-user-id-withdrawal,accac570-de75-11e8-bd11-2f9252c4dc2f,AIRDROP,0
airdrop-20181115-hdac-1083343c-08c5-44a2-8de3-ecc36885efdd-withdrawal-exchange,2018.11.15 10:11,UNKNOWN,,UNKNOWN-55c0f2b7-dc24-425b-9be8-6b86719f2865,2018.11.15 10:11,UNKNOWN,0,100,0,HDAC,WITHDRAWAL,,,,0,COMPLETED,0,sum-user-id,1962689.937,airdrop-20181115-hdac-sum-user-id-withdrawal,accac570-de75-11e8-bd11-2f9252c4dc2f,AIRDROP,0
airdrop-20181115-hdac-10869f96-c996-4303-a616-9a753842b3aa-withdrawal-exchange,2018.11.15 10:11,UNKNOWN,,UNKNOWN-55c0f2b7-dc24-425b-9be8-6b86719f2865,2018.11.15 10:11,UNKNOWN,0,100,0,HDAC,WITHDRAWAL,,,,0,COMPLETED,0,sum-user-id,1962589.937,airdrop-20181115-hdac-sum-user-id-withdrawal,accac570-de75-11e8-bd11-2f9252c4dc2f,AIRDROP,0
airdrop-20181115-hdac-1095a09f-a94f-4e8a-908f-45a0a3807e9d-withdrawal-exchange,2018.11.15 10:11,UNKNOWN,,UNKNOWN-55c0f2b7-dc24-425b-9be8-6b86719f2865,2018.11.15 10:11,UNKNOWN,0,100,0,HDAC,WITHDRAWAL,,,,0,COMPLETED,0,sum-user-id,1962489.937,airdrop-20181115-hdac-sum-user-id-withdrawal,accac570-de75-11e8-bd11-2f9252c4dc2f,AIRDROP,0
airdrop-20181115-hdac-10ad2ca1-267c-4d21-8e8b-a1b16c5bfbc5-withdrawal-exchange,2018.11.15 10:11,UNKNOWN,,UNKNOWN-55c0f2b7-dc24-425b-9be8-6b86719f2865,2018.11.15 10:11,UNKNOWN,0,100,0,HDAC,WITHDRAWAL,,,,0,COMPLETED,0,sum-user-id,1962389.937,airdrop-20181115-hdac-sum-user-id-withdrawal,accac570-de75-11e8-bd11-2f9252c4dc2f,AIRDROP,0
airdrop-20181115-hdac-10b4ce11-6bb0-4d04-8cea-a6f247e5e67a-withdrawal-exchange,2018.11.15 10:11,UNKNOWN,,UNKNOWN-55c0f2b7-dc24-425b-9be8-6b86719f2865,2018.11.15 10:11,UNKNOWN,0,100,0,HDAC,WITHDRAWAL,,,,0,COMPLETED,0,sum-user-id,1962289.937,airdrop-20181115-hdac-sum-user-id-withdrawal,accac570-de75-11e8-bd11-2f9252c4dc2f,AIRDROP,0
airdrop-20181115-hdac-10c0cae1-5508-47d4-97c2-d81af349f976-withdrawal-exchange,2018.11.15 10:11,UNKNOWN,,UNKNOWN-55c0f2b7-dc24-425b-9be8-6b86719f2865,2018.11.15 10:11,UNKNOWN,0,100,0,HDAC,WITHDRAWAL,,,,0,COMPLETED,0,sum-user-id,1962189.937,airdrop-20181115-hdac-sum-user-id-withdrawal,accac570-de75-11e8-bd11-2f9252c4dc2f,AIRDROP,0
airdrop-20181115-hdac-10d8e2f9-b556-4cff-b782-521d76676c2a-withdrawal-exchange,2018.11.15 10:11,UNKNOWN,,UNKNOWN-55c0f2b7-dc24-425b-9be8-6b86719f2865,2018.11.15 10:11,UNKNOWN,0,100,0,HDAC,WITHDRAWAL,,,,0,COMPLETED,0,sum-user-id,1962089.937,airdrop-20181115-hdac-sum-user-id-withdrawal,accac570-de75-11e8-bd11-2f9252c4dc2f,AIRDROP,0
airdrop-20181115-hdac-11040dbc-d9fe-4fe0-9a64-86e6f8256cc9-withdrawal-exchange,2018.11.15 10:11,UNKNOWN,,UNKNOWN-55c0f2b7-dc24-425b-9be8-6b86719f2865,2018.11.15 10:11,UNKNOWN,0,100,0,HDAC,WITHDRAWAL,,,,0,COMPLETED,0,sum-user-id,1961989.937,airdrop-20181115-hdac-sum-user-id-withdrawal,accac570-de75-11e8-bd11-2f9252c4dc2f,AIRDROP,0
airdrop-20181115-hdac-1124076a-5720-4608-961c-61804556b718-withdrawal-exchange,2018.11.15 10:11,UNKNOWN,,UNKNOWN-55c0f2b7-dc24-425b-9be8-6b86719f2865,2018.11.15 10:11,UNKNOWN,0,100,0,HDAC,WITHDRAWAL,,,,0,COMPLETED,0,sum-user-id,1961889.937,airdrop-20181115-hdac-sum-user-id-withdrawal,accac570-de75-11e8-bd11-2f9252c4dc2f,AIRDROP,0
airdrop-20181115-hdac-1154d95c-a596-406d-adc2-20bdca7af229-withdrawal-exchange,2018.11.15 10:11,UNKNOWN,,UNKNOWN-55c0f2b7-dc24-425b-9be8-6b86719f2865,2018.11.15 10:11,UNKNOWN,0,100,0,HDAC,WITHDRAWAL,,,,0,COMPLETED,0,sum-user-id,1961789.937,airdrop-20181115-hdac-sum-user-id-withdrawal,accac570-de75-11e8-bd11-2f9252c4dc2f,AIRDROP,0
airdrop-20181115-hdac-117b932f-527c-405d-88a5-4a5af6954f83-withdrawal-exchange,2018.11.15 10:11,UNKNOWN,,UNKNOWN-55c0f2b7-dc24-425b-9be8-6b86719f2865,2018.11.15 10:11,UNKNOWN,0,100,0,HDAC,WITHDRAWAL,,,,0,COMPLETED,0,sum-user-id,1961689.937,airdrop-20181115-hdac-sum-user-id-withdrawal,accac570-de75-11e8-bd11-2f9252c4dc2f,AIRDROP,0
airdrop-20181115-hdac-11b6d817-0d92-428d-af4f-9d79bde3aaa6-withdrawal-exchange,2018.11.15 10:12,UNKNOWN,,UNKNOWN-55c0f2b7-dc24-425b-9be8-6b86719f2865,2018.11.15 10:12,UNKNOWN,0,20000,0,HDAC,WITHDRAWAL,,,,0,COMPLETED,0,sum-user-id,1347746.069,airdrop-20181115-hdac-sum-user-id-withdrawal,accac570-de75-11e8-bd11-2f9252c4dc2f,AIRDROP,0
airdrop-20181115-hdac-1203d61c-2eb4-4ada-98b8-d23309c84f47-withdrawal-exchange,2018.11.15 10:11,UNKNOWN,,UNKNOWN-55c0f2b7-dc24-425b-9be8-6b86719f2865,2018.11.15 10:11,UNKNOWN,0,100,0,HDAC,WITHDRAWAL,,,,0,COMPLETED,0,sum-user-id,1961589.937,airdrop-20181115-hdac-sum-user-id-withdrawal,accac570-de75-11e8-bd11-2f9252c4dc2f,AIRDROP,0
airdrop-20181115-hdac-12056e28-5347-4a21-9ded-757e392a5525-withdrawal-exchange,2018.11.15 10:11,UNKNOWN,,UNKNOWN-55c0f2b7-dc24-425b-9be8-6b86719f2865,2018.11.15 10:11,UNKNOWN,0,100,0,HDAC,WITHDRAWAL,,,,0,COMPLETED,0,sum-user-id,1961489.937,airdrop-20181115-hdac-sum-user-id-withdrawal,accac570-de75-11e8-bd11-2f9252c4dc2f,AIRDROP,0
airdrop-20181115-hdac-121af9db-cfb9-4818-8c7a-a4f55ce7b358-withdrawal-exchange,2018.11.15 10:11,UNKNOWN,,UNKNOWN-55c0f2b7-dc24-425b-9be8-6b86719f2865,2018.11.15 10:11,UNKNOWN,0,100,0,HDAC,WITHDRAWAL,,,,0,COMPLETED,0,sum-user-id,1961389.937,airdrop-20181115-hdac-sum-user-id-withdrawal,accac570-de75-11e8-bd11-2f9252c4dc2f,AIRDROP,0
airdrop-20181115-hdac-122032af-0b4a-418f-8cd1-dee6792a4033-withdrawal-exchange,2018.11.15 10:11,UNKNOWN,,UNKNOWN-55c0f2b7-dc24-425b-9be8-6b86719f2865,2018.11.15 10:11,UNKNOWN,0,100,0,HDAC,WITHDRAWAL,,,,0,COMPLETED,0,sum-user-id,1961289.937,airdrop-20181115-hdac-sum-user-id-withdrawal,accac570-de75-11e8-bd11-2f9252c4dc2f,AIRDROP,0
airdrop-20181115-hdac-122ef8fc-5e51-431e-9875-df161175afc9-withdrawal-exchange,2018.11.15 10:11,UNKNOWN,,UNKNOWN-55c0f2b7-dc24-425b-9be8-6b86719f2865,2018.11.15 10:11,UNKNOWN,0,100,0,HDAC,WITHDRAWAL,,,,0,COMPLETED,0,sum-user-id,1961189.937,airdrop-20181115-hdac-sum-user-id-withdrawal,accac570-de75-11e8-bd11-2f9252c4dc2f,AIRDROP,0
airdrop-20181115-hdac-125884a4-13c1-4003-8fc3-a6e7d6d11018-withdrawal-exchange,2018.11.15 10:11,UNKNOWN,,UNKNOWN-55c0f2b7-dc24-425b-9be8-6b86719f2865,2018.11.15 10:11,UNKNOWN,0,100,0,HDAC,WITHDRAWAL,,,,0,COMPLETED,0,sum-user-id,1961089.937,airdrop-20181115-hdac-sum-user-id-withdrawal,accac570-de75-11e8-bd11-2f9252c4dc2f,AIRDROP,0
airdrop-20181115-hdac-127971da-dcaa-47d8-87d4-4bc1bb7d0ad3-withdrawal-exchange,2018.11.15 10:11,UNKNOWN,,UNKNOWN-55c0f2b7-dc24-425b-9be8-6b86719f2865,2018.11.15 10:11,UNKNOWN,0,100,0,HDAC,WITHDRAWAL,,,,0,COMPLETED,0,sum-user-id,1960989.937,airdrop-20181115-hdac-sum-user-id-withdrawal,accac570-de75-11e8-bd11-2f9252c4dc2f,AIRDROP,0
airdrop-20181115-hdac-12917a29-c68a-44d2-952b-504c16108d8d-withdrawal-exchange,2018.11.15 10:11,UNKNOWN,,UNKNOWN-55c0f2b7-dc24-425b-9be8-6b86719f2865,2018.11.15 10:11,UNKNOWN,0,100,0,HDAC,WITHDRAWAL,,,,0,COMPLETED,0,sum-user-id,1960889.937,airdrop-20181115-hdac-sum-user-id-withdrawal,accac570-de75-11e8-bd11-2f9252c4dc2f,AIRDROP,0
airdrop-20181115-hdac-129b4713-dd30-4e20-ba81-81c119642b35-withdrawal-exchange,2018.11.15 10:11,UNKNOWN,,UNKNOWN-55c0f2b7-dc24-425b-9be8-6b86719f2865,2018.11.15 10:11,UNKNOWN,0,100,0,HDAC,WITHDRAWAL,,,,0,COMPLETED,0,sum-user-id,1960789.937,airdrop-20181115-hdac-sum-user-id-withdrawal,accac570-de75-11e8-bd11-2f9252c4dc2f,AIRDROP,0
airdrop-20181115-hdac-12bbf40e-0721-4910-b1c6-969c33a2242c-withdrawal-exchange,2018.11.15 10:11,UNKNOWN,,UNKNOWN-55c0f2b7-dc24-425b-9be8-6b86719f2865,2018.11.15 10:11,UNKNOWN,0,100,0,HDAC,WITHDRAWAL,,,,0,COMPLETED,0,sum-user-id,1960689.937,airdrop-20181115-hdac-sum-user-id-withdrawal,accac570-de75-11e8-bd11-2f9252c4dc2f,AIRDROP,0
airdrop-20181115-hdac-12dc5127-95a7-427d-b10b-d10b096c26df-withdrawal-exchange,2018.11.15 10:11,UNKNOWN,,UNKNOWN-55c0f2b7-dc24-425b-9be8-6b86719f2865,2018.11.15 10:11,UNKNOWN,0,100,0,HDAC,WITHDRAWAL,,,,0,COMPLETED,0,sum-user-id,1960589.937,airdrop-20181115-hdac-sum-user-id-withdrawal,accac570-de75-11e8-bd11-2f9252c4dc2f,AIRDROP,0
airdrop-20181115-hdac-12ec727c-365d-427e-af7c-31a0600811e2-withdrawal-exchange,2018.11.15 10:11,UNKNOWN,,UNKNOWN-55c0f2b7-dc24-425b-9be8-6b86719f2865,2018.11.15 10:11,UNKNOWN,0,100,0,HDAC,WITHDRAWAL,,,,0,COMPLETED,0,sum-user-id,1960489.937,airdrop-20181115-hdac-sum-user-id-withdrawal,accac570-de75-11e8-bd11-2f9252c4dc2f,AIRDROP,0
airdrop-20181115-hdac-134141c3-d7ac-4cf7-838e-99349b73076f-withdrawal-exchange,2018.11.15 10:11,UNKNOWN,,UNKNOWN-55c0f2b7-dc24-425b-9be8-6b86719f2865,2018.11.15 10:11,UNKNOWN,0,100,0,HDAC,WITHDRAWAL,,,,0,COMPLETED,0,sum-user-id,1960389.937,airdrop-20181115-hdac-sum-user-id-withdrawal,accac570-de75-11e8-bd11-2f9252c4dc2f,AIRDROP,0
airdrop-20181115-hdac-1357f69d-67e1-4291-924d-d547e016954e-withdrawal-exchange,2018.11.15 10:11,UNKNOWN,,UNKNOWN-55c0f2b7-dc24-425b-9be8-6b86719f2865,2018.11.15 10:11,UNKNOWN,0,100,0,HDAC,WITHDRAWAL,,,,0,COMPLETED,0,sum-user-id,1960289.937,airdrop-20181115-hdac-sum-user-id-withdrawal,accac570-de75-11e8-bd11-2f9252c4dc2f,AIRDROP,0
airdrop-20181115-hdac-13830148-4846-4d8b-a68e-1df86ac5727d-withdrawal-exchange,2018-11-15 10:11:13.015,UNKNOWN,,UNKNOWN-55c0f2b7-dc24-425b-9be8-6b86719f2865,2018-11-15 10:11:13.015,UNKNOWN,0,100,0,HDAC,WITHDRAWAL,,,,0,COMPLETED,0,sum-user-id,1960189.937,airdrop-20181115-hdac-sum-user-id-withdrawal,accac570-de75-11e8-bd11-2f9252c4dc2f,AIRDROP,0
airdrop-20181115-hdac-138808fe-db2a-4c8d-8d15-1903aa7230d9-withdrawal-exchange,2018-11-15 10:11:13.050,UNKNOWN,,UNKNOWN-55c0f2b7-dc24-425b-9be8-6b86719f2865,2018-11-15 10:11:13.050,UNKNOWN,0,100,0,HDAC,WITHDRAWAL,,,,0,COMPLETED,0,sum-user-id,1960089.937,airdrop-20181115-hdac-sum-user-id-withdrawal,accac570-de75-11e8-bd11-2f9252c4dc2f,AIRDROP,0
airdrop-20181115-hdac-13d04ce2-5e6c-40e0-bb77-cd9af3cf5a60-withdrawal-exchange,2018-11-15 10:11:13.083,UNKNOWN,,UNKNOWN-55c0f2b7-dc24-425b-9be8-6b86719f2865,2018-11-15 10:11:13.083,UNKNOWN,0,100,0,HDAC,WITHDRAWAL,,,,0,COMPLETED,0,sum-user-id,1959989.937,airdrop-20181115-hdac-sum-user-id-withdrawal,accac570-de75-11e8-bd11-2f9252c4dc2f,AIRDROP,0
airdrop-20181115-hdac-13d5142a-f1da-4dc1-b2bb-2421d75b6bdc-withdrawal-exchange,2018.11.15 10:11,UNKNOWN,,UNKNOWN-55c0f2b7-dc24-425b-9be8-6b86719f2865,2018.11.15 10:11,UNKNOWN,0,100,0,HDAC,WITHDRAWAL,,,,0,COMPLETED,0,sum-user-id,1959889.937,airdrop-20181115-hdac-sum-user-id-withdrawal,accac570-de75-11e8-bd11-2f9252c4dc2f,AIRDROP,0
airdrop-20181115-hdac-13ee2501-3f15-42f2-bd63-0f9676ffd7e4-withdrawal-exchange,2018.11.15 10:11,UNKNOWN,,UNKNOWN-55c0f2b7-dc24-425b-9be8-6b86719f2865,2018.11.15 10:11,UNKNOWN,0,100,0,HDAC,WITHDRAWAL,,,,0,COMPLETED,0,sum-user-id,1959789.937,airdrop-20181115-hdac-sum-user-id-withdrawal,accac570-de75-11e8-bd11-2f9252c4dc2f,AIRDROP,0
airdrop-20181115-hdac-13f463d9-7b2a-476f-8e88-b50d0d9d5329-withdrawal-exchange,2018.11.15 10:11,UNKNOWN,,UNKNOWN-55c0f2b7-dc24-425b-9be8-6b86719f2865,2018.11.15 10:11,UNKNOWN,0,100,0,HDAC,WITHDRAWAL,,,,0,COMPLETED,0,sum-user-id,1959689.937,airdrop-20181115-hdac-sum-user-id-withdrawal,accac570-de75-11e8-bd11-2f9252c4dc2f,AIRDROP,0
airdrop-20181115-hdac-13f63694-389d-4a66-8d9c-34b92f9a005f-withdrawal-exchange,2018.11.15 10:11,UNKNOWN,,UNKNOWN-55c0f2b7-dc24-425b-9be8-6b86719f2865,2018.11.15 10:11,UNKNOWN,0,100,0,HDAC,WITHDRAWAL,,,,0,COMPLETED,0,sum-user-id,1959589.937,airdrop-20181115-hdac-sum-user-id-withdrawal,accac570-de75-11e8-bd11-2f9252c4dc2f,AIRDROP,0
airdrop-20181115-hdac-140a2382-eb24-4030-bfe0-f3eae12c503b-withdrawal-exchange,2018.11.15 10:11,UNKNOWN,,UNKNOWN-55c0f2b7-dc24-425b-9be8-6b86719f2865,2018.11.15 10:11,UNKNOWN,0,100,0,HDAC,WITHDRAWAL,,,,0,COMPLETED,0,sum-user-id,1959489.937,airdrop-20181115-hdac-sum-user-id-withdrawal,accac570-de75-11e8-bd11-2f9252c4dc2f,AIRDROP,0
airdrop-20181115-hdac-14434cd7-3454-41a9-abcb-a594805deb4b-withdrawal-exchange,2018.11.15 10:11,UNKNOWN,,UNKNOWN-55c0f2b7-dc24-425b-9be8-6b86719f2865,2018.11.15 10:11,UNKNOWN,0,100,0,HDAC,WITHDRAWAL,,,,0,COMPLETED,0,sum-user-id,1959389.937,airdrop-20181115-hdac-sum-user-id-withdrawal,accac570-de75-11e8-bd11-2f9252c4dc2f,AIRDROP,0
airdrop-20181115-hdac-149095dd-06ed-44fc-8401-7d7d712ae4e0-withdrawal-exchange,2018.11.15 10:11,UNKNOWN,,UNKNOWN-55c0f2b7-dc24-425b-9be8-6b86719f2865,2018.11.15 10:11,UNKNOWN,0,100,0,HDAC,WITHDRAWAL,,,,0,COMPLETED,0,sum-user-id,1959289.937,airdrop-20181115-hdac-sum-user-id-withdrawal,accac570-de75-11e8-bd11-2f9252c4dc2f,AIRDROP,0
airdrop-20181115-hdac-14917f3c-1c3e-4511-80d7-2188e86ca488-withdrawal-exchange,2018.11.15 10:11,UNKNOWN,,UNKNOWN-55c0f2b7-dc24-425b-9be8-6b86719f2865,2018.11.15 10:11,UNKNOWN,0,100,0,HDAC,WITHDRAWAL,,,,0,COMPLETED,0,sum-user-id,1959189.937,airdrop-20181115-hdac-sum-user-id-withdrawal,accac570-de75-11e8-bd11-2f9252c4dc2f,AIRDROP,0
airdrop-20181115-hdac-1494ac32-e58b-4089-8368-0853823a0286-withdrawal-exchange,2018.11.15 10:11,UNKNOWN,,UNKNOWN-55c0f2b7-dc24-425b-9be8-6b86719f2865,2018.11.15 10:11,UNKNOWN,0,100,0,HDAC,WITHDRAWAL,,,,0,COMPLETED,0,sum-user-id,1959089.937,airdrop-20181115-hdac-sum-user-id-withdrawal,accac570-de75-11e8-bd11-2f9252c4dc2f,AIRDROP,0
airdrop-20181115-hdac-14bde8da-42d1-47a4-96d9-940988e61135-withdrawal-exchange,2018.11.15 10:11,UNKNOWN,,UNKNOWN-55c0f2b7-dc24-425b-9be8-6b86719f2865,2018.11.15 10:11,UNKNOWN,0,100,0,HDAC,WITHDRAWAL,,,,0,COMPLETED,0,sum-user-id,1958989.937,airdrop-20181115-hdac-sum-user-id-withdrawal,accac570-de75-11e8-bd11-2f9252c4dc2f,AIRDROP,0
airdrop-20181115-hdac-14ce4d17-2a1d-4eab-8a5d-62deb6e22686-withdrawal-exchange,2018.11.15 10:12,UNKNOWN,,UNKNOWN-55c0f2b7-dc24-425b-9be8-6b86719f2865,2018.11.15 10:12,UNKNOWN,0,139.748237,0,HDAC,WITHDRAWAL,,,,0,COMPLETED,0,sum-user-id,1347606.321,airdrop-20181115-hdac-sum-user-id-withdrawal,accac570-de75-11e8-bd11-2f9252c4dc2f,AIRDROP,0
airdrop-20181115-hdac-14d91f28-709a-4883-a2fb-21988cc4a09b-withdrawal-exchange,2018.11.15 10:11,UNKNOWN,,UNKNOWN-55c0f2b7-dc24-425b-9be8-6b86719f2865,2018.11.15 10:11,UNKNOWN,0,100,0,HDAC,WITHDRAWAL,,,,0,COMPLETED,0,sum-user-id,1958889.937,airdrop-20181115-hdac-sum-user-id-withdrawal,accac570-de75-11e8-bd11-2f9252c4dc2f,AIRDROP,0
airdrop-20181115-hdac-14dc38d8-57b4-4697-b82f-482f147f487a-withdrawal-exchange,2018.11.15 10:11,UNKNOWN,,UNKNOWN-55c0f2b7-dc24-425b-9be8-6b86719f2865,2018.11.15 10:11,UNKNOWN,0,100,0,HDAC,WITHDRAWAL,,,,0,COMPLETED,0,sum-user-id,1958789.937,airdrop-20181115-hdac-sum-user-id-withdrawal,accac570-de75-11e8-bd11-2f9252c4dc2f,AIRDROP,0
airdrop-20181115-hdac-14e362e5-c415-45ab-af35-1076103f8bc3-withdrawal-exchange,2018.11.15 10:11,UNKNOWN,,UNKNOWN-55c0f2b7-dc24-425b-9be8-6b86719f2865,2018.11.15 10:11,UNKNOWN,0,100,0,HDAC,WITHDRAWAL,,,,0,COMPLETED,0,sum-user-id,1958689.937,airdrop-20181115-hdac-sum-user-id-withdrawal,accac570-de75-11e8-bd11-2f9252c4dc2f,AIRDROP,0
airdrop-20181115-hdac-14e64328-f356-4870-b8a8-6a1f53681b2c-withdrawal-exchange,2018.11.15 10:11,UNKNOWN,,UNKNOWN-55c0f2b7-dc24-425b-9be8-6b86719f2865,2018.11.15 10:11,UNKNOWN,0,100,0,HDAC,WITHDRAWAL,,,,0,COMPLETED,0,sum-user-id,1958589.937,airdrop-20181115-hdac-sum-user-id-withdrawal,accac570-de75-11e8-bd11-2f9252c4dc2f,AIRDROP,0
airdrop-20181115-hdac-14e769c7-d0f8-4634-bf98-a0a7f8ec84f5-withdrawal-exchange,2018.11.15 10:11,UNKNOWN,,UNKNOWN-55c0f2b7-dc24-425b-9be8-6b86719f2865,2018.11.15 10:11,UNKNOWN,0,100,0,HDAC,WITHDRAWAL,,,,0,COMPLETED,0,sum-user-id,1958489.937,airdrop-20181115-hdac-sum-user-id-withdrawal,accac570-de75-11e8-bd11-2f9252c4dc2f,AIRDROP,0
airdrop-20181115-hdac-1506afbd-5ff9-4a0a-a25d-b0df1a7e10a8-withdrawal-exchange,2018.11.15 10:11,UNKNOWN,,UNKNOWN-55c0f2b7-dc24-425b-9be8-6b86719f2865,2018.11.15 10:11,UNKNOWN,0,100,0,HDAC,WITHDRAWAL,,,,0,COMPLETED,0,sum-user-id,1958389.937,airdrop-20181115-hdac-sum-user-id-withdrawal,accac570-de75-11e8-bd11-2f9252c4dc2f,AIRDROP,0
airdrop-20181115-hdac-1509409d-bf3e-4699-a61c-5fb010aeab08-withdrawal-exchange,2018.11.15 10:12,UNKNOWN,,UNKNOWN-55c0f2b7-dc24-425b-9be8-6b86719f2865,2018.11.15 10:12,UNKNOWN,0,2030.2,0,HDAC,WITHDRAWAL,,,,0,COMPLETED,0,sum-user-id,1345576.121,airdrop-20181115-hdac-sum-user-id-withdrawal,accac570-de75-11e8-bd11-2f9252c4dc2f,AIRDROP,0
airdrop-20181115-hdac-150f4560-10d6-4a84-bbc8-c0dc60d52c38-withdrawal-exchange,2018.11.15 10:11,UNKNOWN,,UNKNOWN-55c0f2b7-dc24-425b-9be8-6b86719f2865,2018.11.15 10:11,UNKNOWN,0,100,0,HDAC,WITHDRAWAL,,,,0,COMPLETED,0,sum-user-id,1958289.937,airdrop-20181115-hdac-sum-user-id-withdrawal,accac570-de75-11e8-bd11-2f9252c4dc2f,AIRDROP,0
airdrop-20181115-hdac-1518f64b-b459-4775-92b1-2d59ff7aae72-withdrawal-exchange,2018.11.15 10:11,UNKNOWN,,UNKNOWN-55c0f2b7-dc24-425b-9be8-6b86719f2865,2018.11.15 10:11,UNKNOWN,0,100,0,HDAC,WITHDRAWAL,,,,0,COMPLETED,0,sum-user-id,1958189.937,airdrop-20181115-hdac-sum-user-id-withdrawal,accac570-de75-11e8-bd11-2f9252c4dc2f,AIRDROP,0
airdrop-20181115-hdac-152208c0-50a4-4bba-bb2c-3c4c32208796-withdrawal-exchange,2018.11.15 10:11,UNKNOWN,,UNKNOWN-55c0f2b7-dc24-425b-9be8-6b86719f2865,2018.11.15 10:11,UNKNOWN,0,100,0,HDAC,WITHDRAWAL,,,,0,COMPLETED,0,sum-user-id,1958089.937,airdrop-20181115-hdac-sum-user-id-withdrawal,accac570-de75-11e8-bd11-2f9252c4dc2f,AIRDROP,0
airdrop-20181115-hdac-1528e230-6967-4a7b-9a5c-4d3ba9f7f753-withdrawal-exchange,2018.11.15 10:11,UNKNOWN,,UNKNOWN-55c0f2b7-dc24-425b-9be8-6b86719f2865,2018.11.15 10:11,UNKNOWN,0,100,0,HDAC,WITHDRAWAL,,,,0,COMPLETED,0,sum-user-id,1957989.937,airdrop-20181115-hdac-sum-user-id-withdrawal,accac570-de75-11e8-bd11-2f9252c4dc2f,AIRDROP,0
airdrop-20181115-hdac-15316ff5-d40c-41ca-815b-e0a4da0a8646-withdrawal-exchange,2018.11.15 10:11,UNKNOWN,,UNKNOWN-55c0f2b7-dc24-425b-9be8-6b86719f2865,2018.11.15 10:11,UNKNOWN,0,100,0,HDAC,WITHDRAWAL,,,,0,COMPLETED,0,sum-user-id,1957889.937,airdrop-20181115-hdac-sum-user-id-withdrawal,accac570-de75-11e8-bd11-2f9252c4dc2f,AIRDROP,0
airdrop-20181115-hdac-1532e247-dbe0-4260-8b30-bcf6c3895f8e-withdrawal-exchange,2018.11.15 10:11,UNKNOWN,,UNKNOWN-55c0f2b7-dc24-425b-9be8-6b86719f2865,2018.11.15 10:11,UNKNOWN,0,100,0,HDAC,WITHDRAWAL,,,,0,COMPLETED,0,sum-user-id,1957789.937,airdrop-20181115-hdac-sum-user-id-withdrawal,accac570-de75-11e8-bd11-2f9252c4dc2f,AIRDROP,0
airdrop-20181115-hdac-159f3a99-17d9-4423-a7e9-f308714c1ac8-withdrawal-exchange,2018.11.15 10:11,UNKNOWN,,UNKNOWN-55c0f2b7-dc24-425b-9be8-6b86719f2865,2018.11.15 10:11,UNKNOWN,0,100,0,HDAC,WITHDRAWAL,,,,0,COMPLETED,0,sum-user-id,1957689.937,airdrop-20181115-hdac-sum-user-id-withdrawal,accac570-de75-11e8-bd11-2f9252c4dc2f,AIRDROP,0
airdrop-20181115-hdac-15a65b06-028c-47ed-8c01-5f1585b1baf9-withdrawal-exchange,2018.11.15 10:11,UNKNOWN,,UNKNOWN-55c0f2b7-dc24-425b-9be8-6b86719f2865,2018.11.15 10:11,UNKNOWN,0,100,0,HDAC,WITHDRAWAL,,,,0,COMPLETED,0,sum-user-id,1957589.937,airdrop-20181115-hdac-sum-user-id-withdrawal,accac570-de75-11e8-bd11-2f9252c4dc2f,AIRDROP,0
airdrop-20181115-hdac-15b2e418-d6c4-49af-9441-072e655670c9-withdrawal-exchange,2018.11.15 10:11,UNKNOWN,,UNKNOWN-55c0f2b7-dc24-425b-9be8-6b86719f2865,2018.11.15 10:11,UNKNOWN,0,100,0,HDAC,WITHDRAWAL,,,,0,COMPLETED,0,sum-user-id,1957489.937,airdrop-20181115-hdac-sum-user-id-withdrawal,accac570-de75-11e8-bd11-2f9252c4dc2f,AIRDROP,0
airdrop-20181115-hdac-15c91970-394e-45c8-b9ae-fd0da5ad53ed-withdrawal-exchange,2018.11.15 10:11,UNKNOWN,,UNKNOWN-55c0f2b7-dc24-425b-9be8-6b86719f2865,2018.11.15 10:11,UNKNOWN,0,100,0,HDAC,WITHDRAWAL,,,,0,COMPLETED,0,sum-user-id,1957389.937,airdrop-20181115-hdac-sum-user-id-withdrawal,accac570-de75-11e8-bd11-2f9252c4dc2f,AIRDROP,0
airdrop-20181115-hdac-15ea0424-780f-4ebb-9c09-68dac3f36411-withdrawal-exchange,2018.11.15 10:11,UNKNOWN,,UNKNOWN-55c0f2b7-dc24-425b-9be8-6b86719f2865,2018.11.15 10:11,UNKNOWN,0,100,0,HDAC,WITHDRAWAL,,,,0,COMPLETED,0,sum-user-id,1957289.937,airdrop-20181115-hdac-sum-user-id-withdrawal,accac570-de75-11e8-bd11-2f9252c4dc2f,AIRDROP,0
airdrop-20181115-hdac-15f9dfba-fdfd-43e6-9721-666c0acf0f5c-withdrawal-exchange,2018-11-15 10:11:14.021,UNKNOWN,,UNKNOWN-55c0f2b7-dc24-425b-9be8-6b86719f2865,2018-11-15 10:11:14.021,UNKNOWN,0,100,0,HDAC,WITHDRAWAL,,,,0,COMPLETED,0,sum-user-id,1957189.937,airdrop-20181115-hdac-sum-user-id-withdrawal,accac570-de75-11e8-bd11-2f9252c4dc2f,AIRDROP,0
airdrop-20181115-hdac-15fac4fb-dfe3-48c2-a110-b54ae17a7a40-withdrawal-exchange,2018-11-15 10:11:14.055,UNKNOWN,,UNKNOWN-55c0f2b7-dc24-425b-9be8-6b86719f2865,2018-11-15 10:11:14.055,UNKNOWN,0,100,0,HDAC,WITHDRAWAL,,,,0,COMPLETED,0,sum-user-id,1957089.937,airdrop-20181115-hdac-sum-user-id-withdrawal,accac570-de75-11e8-bd11-2f9252c4dc2f,AIRDROP,0
airdrop-20181115-hdac-167f5771-004d-4557-af90-849165a24f33-withdrawal-exchange,2018-11-15 10:11:14.083,UNKNOWN,,UNKNOWN-55c0f2b7-dc24-425b-9be8-6b86719f2865,2018-11-15 10:11:14.083,UNKNOWN,0,100,0,HDAC,WITHDRAWAL,,,,0,COMPLETED,0,sum-user-id,1956989.937,airdrop-20181115-hdac-sum-user-id-withdrawal,accac570-de75-11e8-bd11-2f9252c4dc2f,AIRDROP,0
airdrop-20181115-hdac-168b0b12-6fa1-421e-9e4b-4d43ac4d27c2-withdrawal-exchange,2018.11.15 10:11,UNKNOWN,,UNKNOWN-55c0f2b7-dc24-425b-9be8-6b86719f2865,2018.11.15 10:11,UNKNOWN,0,100,0,HDAC,WITHDRAWAL,,,,0,COMPLETED,0,sum-user-id,1956889.937,airdrop-20181115-hdac-sum-user-id-withdrawal,accac570-de75-11e8-bd11-2f9252c4dc2f,AIRDROP,0
airdrop-20181115-hdac-16e1d238-597c-4dfb-b103-e005751e76c6-withdrawal-exchange,2018.11.15 10:11,UNKNOWN,,UNKNOWN-55c0f2b7-dc24-425b-9be8-6b86719f2865,2018.11.15 10:11,UNKNOWN,0,100,0,HDAC,WITHDRAWAL,,,,0,COMPLETED,0,sum-user-id,1956789.937,airdrop-20181115-hdac-sum-user-id-withdrawal,accac570-de75-11e8-bd11-2f9252c4dc2f,AIRDROP,0
airdrop-20181115-hdac-170219a3-e264-40b3-b33a-91f9c48a5ee7-withdrawal-exchange,2018.11.15 10:11,UNKNOWN,,UNKNOWN-55c0f2b7-dc24-425b-9be8-6b86719f2865,2018.11.15 10:11,UNKNOWN,0,100,0,HDAC,WITHDRAWAL,,,,0,COMPLETED,0,sum-user-id,1956689.937,airdrop-20181115-hdac-sum-user-id-withdrawal,accac570-de75-11e8-bd11-2f9252c4dc2f,AIRDROP,0
airdrop-20181115-hdac-17239ced-c5f5-4a18-b437-7c5ca7ddbcd2-withdrawal-exchange,2018.11.15 10:11,UNKNOWN,,UNKNOWN-55c0f2b7-dc24-425b-9be8-6b86719f2865,2018.11.15 10:11,UNKNOWN,0,100,0,HDAC,WITHDRAWAL,,,,0,COMPLETED,0,sum-user-id,1956589.937,airdrop-20181115-hdac-sum-user-id-withdrawal,accac570-de75-11e8-bd11-2f9252c4dc2f,AIRDROP,0
airdrop-20181115-hdac-172b5a7d-ab0e-4a5c-ab6c-1caa32db62d3-withdrawal-exchange,2018.11.15 10:11,UNKNOWN,,UNKNOWN-55c0f2b7-dc24-425b-9be8-6b86719f2865,2018.11.15 10:11,UNKNOWN,0,100,0,HDAC,WITHDRAWAL,,,,0,COMPLETED,0,sum-user-id,1956489.937,airdrop-20181115-hdac-sum-user-id-withdrawal,accac570-de75-11e8-bd11-2f9252c4dc2f,AIRDROP,0
airdrop-20181115-hdac-17409796-0c94-4df5-8701-b568187e3cf9-withdrawal-exchange,2018.11.15 10:11,UNKNOWN,,UNKNOWN-55c0f2b7-dc24-425b-9be8-6b86719f2865,2018.11.15 10:11,UNKNOWN,0,100,0,HDAC,WITHDRAWAL,,,,0,COMPLETED,0,sum-user-id,1956389.937,airdrop-20181115-hdac-sum-user-id-withdrawal,accac570-de75-11e8-bd11-2f9252c4dc2f,AIRDROP,0
airdrop-20181115-hdac-1792baae-9ff3-4fd7-9bab-cd4c2ba6e667-withdrawal-exchange,2018.11.15 10:11,UNKNOWN,,UNKNOWN-55c0f2b7-dc24-425b-9be8-6b86719f2865,2018.11.15 10:11,UNKNOWN,0,100,0,HDAC,WITHDRAWAL,,,,0,COMPLETED,0,sum-user-id,1956289.937,airdrop-20181115-hdac-sum-user-id-withdrawal,accac570-de75-11e8-bd11-2f9252c4dc2f,AIRDROP,0
airdrop-20181115-hdac-1793155d-26e7-4ccb-b930-c6afc1be4553-withdrawal-exchange,2018.11.15 10:11,UNKNOWN,,UNKNOWN-55c0f2b7-dc24-425b-9be8-6b86719f2865,2018.11.15 10:11,UNKNOWN,0,100,0,HDAC,WITHDRAWAL,,,,0,COMPLETED,0,sum-user-id,1956189.937,airdrop-20181115-hdac-sum-user-id-withdrawal,accac570-de75-11e8-bd11-2f9252c4dc2f,AIRDROP,0
airdrop-20181115-hdac-179fecb4-7097-474b-a4e0-783370687f1c-withdrawal-exchange,2018.11.15 10:11,UNKNOWN,,UNKNOWN-55c0f2b7-dc24-425b-9be8-6b86719f2865,2018.11.15 10:11,UNKNOWN,0,100,0,HDAC,WITHDRAWAL,,,,0,COMPLETED,0,sum-user-id,1956089.937,airdrop-20181115-hdac-sum-user-id-withdrawal,accac570-de75-11e8-bd11-2f9252c4dc2f,AIRDROP,0
airdrop-20181115-hdac-17c5f3a6-6ea0-4caf-a44f-a06b32cd7ea1-withdrawal-exchange,2018.11.15 10:11,UNKNOWN,,UNKNOWN-55c0f2b7-dc24-425b-9be8-6b86719f2865,2018.11.15 10:11,UNKNOWN,0,100,0,HDAC,WITHDRAWAL,,,,0,COMPLETED,0,sum-user-id,1955989.937,airdrop-20181115-hdac-sum-user-id-withdrawal,accac570-de75-11e8-bd11-2f9252c4dc2f,AIRDROP,0
airdrop-20181115-hdac-17ceec8d-31d6-41ff-9b9f-7c72472c8c5e-withdrawal-exchange,2018.11.15 10:11,UNKNOWN,,UNKNOWN-55c0f2b7-dc24-425b-9be8-6b86719f2865,2018.11.15 10:11,UNKNOWN,0,100,0,HDAC,WITHDRAWAL,,,,0,COMPLETED,0,sum-user-id,1955889.937,airdrop-20181115-hdac-sum-user-id-withdrawal,accac570-de75-11e8-bd11-2f9252c4dc2f,AIRDROP,0
airdrop-20181115-hdac-1855fd3b-d66b-4974-a88b-b0998b9689fe-withdrawal-exchange,2018.11.15 10:11,UNKNOWN,,UNKNOWN-55c0f2b7-dc24-425b-9be8-6b86719f2865,2018.11.15 10:11,UNKNOWN,0,100,0,HDAC,WITHDRAWAL,,,,0,COMPLETED,0,sum-user-id,1955789.937,airdrop-20181115-hdac-sum-user-id-withdrawal,accac570-de75-11e8-bd11-2f9252c4dc2f,AIRDROP,0
airdrop-20181115-hdac-1865c2e8-5557-46a8-b132-c0a5b46450a5-withdrawal-exchange,2018.11.15 10:11,UNKNOWN,,UNKNOWN-55c0f2b7-dc24-425b-9be8-6b86719f2865,2018.11.15 10:11,UNKNOWN,0,100,0,HDAC,WITHDRAWAL,,,,0,COMPLETED,0,sum-user-id,1955689.937,airdrop-20181115-hdac-sum-user-id-withdrawal,accac570-de75-11e8-bd11-2f9252c4dc2f,AIRDROP,0
airdrop-20181115-hdac-1869e723-fb13-4d87-87b0-294c062f404d-withdrawal-exchange,2018.11.15 10:11,UNKNOWN,,UNKNOWN-55c0f2b7-dc24-425b-9be8-6b86719f2865,2018.11.15 10:11,UNKNOWN,0,100,0,HDAC,WITHDRAWAL,,,,0,COMPLETED,0,sum-user-id,1955589.937,airdrop-20181115-hdac-sum-user-id-withdrawal,accac570-de75-11e8-bd11-2f9252c4dc2f,AIRDROP,0
airdrop-20181115-hdac-186a8eec-b7e3-424e-877f-511a584a2578-withdrawal-exchange,2018.11.15 10:11,UNKNOWN,,UNKNOWN-55c0f2b7-dc24-425b-9be8-6b86719f2865,2018.11.15 10:11,UNKNOWN,0,100,0,HDAC,WITHDRAWAL,,,,0,COMPLETED,0,sum-user-id,1955489.937,airdrop-20181115-hdac-sum-user-id-withdrawal,accac570-de75-11e8-bd11-2f9252c4dc2f,AIRDROP,0
airdrop-20181115-hdac-187ccb78-de57-433a-89fc-b274f4912a3b-withdrawal-exchange,2018.11.15 10:11,UNKNOWN,,UNKNOWN-55c0f2b7-dc24-425b-9be8-6b86719f2865,2018.11.15 10:11,UNKNOWN,0,100,0,HDAC,WITHDRAWAL,,,,0,COMPLETED,0,sum-user-id,1955389.937,airdrop-20181115-hdac-sum-user-id-withdrawal,accac570-de75-11e8-bd11-2f9252c4dc2f,AIRDROP,0
airdrop-20181115-hdac-18b454ac-25ab-4514-b109-5117095e5bc5-withdrawal-exchange,2018.11.15 10:11,UNKNOWN,,UNKNOWN-55c0f2b7-dc24-425b-9be8-6b86719f2865,2018.11.15 10:11,UNKNOWN,0,100,0,HDAC,WITHDRAWAL,,,,0,COMPLETED,0,sum-user-id,1955289.937,airdrop-20181115-hdac-sum-user-id-withdrawal,accac570-de75-11e8-bd11-2f9252c4dc2f,AIRDROP,0
airdrop-20181115-hdac-190567f0-bf9a-4976-97b9-8129ff2acf90-withdrawal-exchange,2018.11.15 10:11,UNKNOWN,,UNKNOWN-55c0f2b7-dc24-425b-9be8-6b86719f2865,2018.11.15 10:11,UNKNOWN,0,100,0,HDAC,WITHDRAWAL,,,,0,COMPLETED,0,sum-user-id,1955189.937,airdrop-20181115-hdac-sum-user-id-withdrawal,accac570-de75-11e8-bd11-2f9252c4dc2f,AIRDROP,0
airdrop-20181115-hdac-19162d84-8343-448e-96c2-a4be62c18d53-withdrawal-exchange,2018.11.15 10:11,UNKNOWN,,UNKNOWN-55c0f2b7-dc24-425b-9be8-6b86719f2865,2018.11.15 10:11,UNKNOWN,0,100,0,HDAC,WITHDRAWAL,,,,0,COMPLETED,0,sum-user-id,1955089.937,airdrop-20181115-hdac-sum-user-id-withdrawal,accac570-de75-11e8-bd11-2f9252c4dc2f,AIRDROP,0
airdrop-20181115-hdac-193a7be5-bd9c-4078-9065-5a09c968bfb7-withdrawal-exchange,2018.11.15 10:11,UNKNOWN,,UNKNOWN-55c0f2b7-dc24-425b-9be8-6b86719f2865,2018.11.15 10:11,UNKNOWN,0,100,0,HDAC,WITHDRAWAL,,,,0,COMPLETED,0,sum-user-id,1954989.937,airdrop-20181115-hdac-sum-user-id-withdrawal,accac570-de75-11e8-bd11-2f9252c4dc2f,AIRDROP,0
airdrop-20181115-hdac-193cf4aa-f8f9-49ea-9812-d09735076046-withdrawal-exchange,2018.11.15 10:11,UNKNOWN,,UNKNOWN-55c0f2b7-dc24-425b-9be8-6b86719f2865,2018.11.15 10:11,UNKNOWN,0,100,0,HDAC,WITHDRAWAL,,,,0,COMPLETED,0,sum-user-id,1954889.937,airdrop-20181115-hdac-sum-user-id-withdrawal,accac570-de75-11e8-bd11-2f9252c4dc2f,AIRDROP,0
airdrop-20181115-hdac-194dc5da-b0c9-48d0-98fb-e4982502faca-withdrawal-exchange,2018.11.15 10:11,UNKNOWN,,UNKNOWN-55c0f2b7-dc24-425b-9be8-6b86719f2865,2018.11.15 10:11,UNKNOWN,0,100,0,HDAC,WITHDRAWAL,,,,0,COMPLETED,0,sum-user-id,1954789.937,airdrop-20181115-hdac-sum-user-id-withdrawal,accac570-de75-11e8-bd11-2f9252c4dc2f,AIRDROP,0
airdrop-20181115-hdac-19541266-7deb-40c4-8587-0c0e3318e06a-withdrawal-exchange,2018.11.15 10:11,UNKNOWN,,UNKNOWN-55c0f2b7-dc24-425b-9be8-6b86719f2865,2018.11.15 10:11,UNKNOWN,0,100,0,HDAC,WITHDRAWAL,,,,0,COMPLETED,0,sum-user-id,1954689.937,airdrop-20181115-hdac-sum-user-id-withdrawal,accac570-de75-11e8-bd11-2f9252c4dc2f,AIRDROP,0
airdrop-20181115-hdac-19918a47-75aa-4c05-ac6a-46189373cdba-withdrawal-exchange,2018.11.15 10:11,UNKNOWN,,UNKNOWN-55c0f2b7-dc24-425b-9be8-6b86719f2865,2018.11.15 10:11,UNKNOWN,0,100,0,HDAC,WITHDRAWAL,,,,0,COMPLETED,0,sum-user-id,1954589.937,airdrop-20181115-hdac-sum-user-id-withdrawal,accac570-de75-11e8-bd11-2f9252c4dc2f,AIRDROP,0
airdrop-20181115-hdac-1999f54b-c99c-48ac-a615-82491af69f99-withdrawal-exchange,2018.11.15 10:11,UNKNOWN,,UNKNOWN-55c0f2b7-dc24-425b-9be8-6b86719f2865,2018.11.15 10:11,UNKNOWN,0,100,0,HDAC,WITHDRAWAL,,,,0,COMPLETED,0,sum-user-id,1954489.937,airdrop-20181115-hdac-sum-user-id-withdrawal,accac570-de75-11e8-bd11-2f9252c4dc2f,AIRDROP,0
airdrop-20181115-hdac-19b84185-6ace-47c0-962a-2fabeaa0ace3-withdrawal-exchange,2018.11.15 10:11,UNKNOWN,,UNKNOWN-55c0f2b7-dc24-425b-9be8-6b86719f2865,2018.11.15 10:11,UNKNOWN,0,100,0,HDAC,WITHDRAWAL,,,,0,COMPLETED,0,sum-user-id,1954389.937,airdrop-20181115-hdac-sum-user-id-withdrawal,accac570-de75-11e8-bd11-2f9252c4dc2f,AIRDROP,0
airdrop-20181115-hdac-19c0f040-806b-459d-8783-398e0d09f50d-withdrawal-exchange,2018.11.15 10:11,UNKNOWN,,UNKNOWN-55c0f2b7-dc24-425b-9be8-6b86719f2865,2018.11.15 10:11,UNKNOWN,0,100,0,HDAC,WITHDRAWAL,,,,0,COMPLETED,0,sum-user-id,1954289.937,airdrop-20181115-hdac-sum-user-id-withdrawal,accac570-de75-11e8-bd11-2f9252c4dc2f,AIRDROP,0
airdrop-20181115-hdac-19d88575-622a-4b68-882a-93b76b506820-withdrawal-exchange,2018-11-15 10:11:15.035,UNKNOWN,,UNKNOWN-55c0f2b7-dc24-425b-9be8-6b86719f2865,2018-11-15 10:11:15.035,UNKNOWN,0,100,0,HDAC,WITHDRAWAL,,,,0,COMPLETED,0,sum-user-id,1954189.937,airdrop-20181115-hdac-sum-user-id-withdrawal,accac570-de75-11e8-bd11-2f9252c4dc2f,AIRDROP,0
airdrop-20181115-hdac-19db0a47-f6d1-4bec-9bd0-febdf8c02c9a-withdrawal-exchange,2018-11-15 10:11:15.067,UNKNOWN,,UNKNOWN-55c0f2b7-dc24-425b-9be8-6b86719f2865,2018-11-15 10:11:15.067,UNKNOWN,0,100,0,HDAC,WITHDRAWAL,,,,0,COMPLETED,0,sum-user-id,1954089.937,airdrop-20181115-hdac-sum-user-id-withdrawal,accac570-de75-11e8-bd11-2f9252c4dc2f,AIRDROP,0
airdrop-20181115-hdac-19dd145a-5fd4-4f5a-9f85-39e7b2784845-withdrawal-exchange,2018-11-15 10:11:15.098,UNKNOWN,,UNKNOWN-55c0f2b7-dc24-425b-9be8-6b86719f2865,2018-11-15 10:11:15.098,UNKNOWN,0,100,0,HDAC,WITHDRAWAL,,,,0,COMPLETED,0,sum-user-id,1953989.937,airdrop-20181115-hdac-sum-user-id-withdrawal,accac570-de75-11e8-bd11-2f9252c4dc2f,AIRDROP,0
airdrop-20181115-hdac-1a14b0b9-33e0-4547-be4e-62f3928c6ca7-withdrawal-exchange,2018.11.15 10:11,UNKNOWN,,UNKNOWN-55c0f2b7-dc24-425b-9be8-6b86719f2865,2018.11.15 10:11,UNKNOWN,0,100,0,HDAC,WITHDRAWAL,,,,0,COMPLETED,0,sum-user-id,1953889.937,airdrop-20181115-hdac-sum-user-id-withdrawal,accac570-de75-11e8-bd11-2f9252c4dc2f,AIRDROP,0
airdrop-20181115-hdac-1a35afe5-034b-4e0a-a250-a104167f48f9-withdrawal-exchange,2018.11.15 10:11,UNKNOWN,,UNKNOWN-55c0f2b7-dc24-425b-9be8-6b86719f2865,2018.11.15 10:11,UNKNOWN,0,100,0,HDAC,WITHDRAWAL,,,,0,COMPLETED,0,sum-user-id,1953789.937,airdrop-20181115-hdac-sum-user-id-withdrawal,accac570-de75-11e8-bd11-2f9252c4dc2f,AIRDROP,0
airdrop-20181115-hdac-1a3877b2-88a6-409d-b0fb-c10e15f9da54-withdrawal-exchange,2018.11.15 10:11,UNKNOWN,,UNKNOWN-55c0f2b7-dc24-425b-9be8-6b86719f2865,2018.11.15 10:11,UNKNOWN,0,100,0,HDAC,WITHDRAWAL,,,,0,COMPLETED,0,sum-user-id,1953689.937,airdrop-20181115-hdac-sum-user-id-withdrawal,accac570-de75-11e8-bd11-2f9252c4dc2f,AIRDROP,0
airdrop-20181115-hdac-1a46cba2-a82f-4032-acdc-35d2cc424a59-withdrawal-exchange,2018.11.15 10:11,UNKNOWN,,UNKNOWN-55c0f2b7-dc24-425b-9be8-6b86719f2865,2018.11.15 10:11,UNKNOWN,0,100,0,HDAC,WITHDRAWAL,,,,0,COMPLETED,0,sum-user-id,1953589.937,airdrop-20181115-hdac-sum-user-id-withdrawal,accac570-de75-11e8-bd11-2f9252c4dc2f,AIRDROP,0
airdrop-20181115-hdac-1a677e4b-0dd9-4a01-b57f-273ad6dad8f6-withdrawal-exchange,2018.11.15 10:11,UNKNOWN,,UNKNOWN-55c0f2b7-dc24-425b-9be8-6b86719f2865,2018.11.15 10:11,UNKNOWN,0,100,0,HDAC,WITHDRAWAL,,,,0,COMPLETED,0,sum-user-id,1953489.937,airdrop-20181115-hdac-sum-user-id-withdrawal,accac570-de75-11e8-bd11-2f9252c4dc2f,AIRDROP,0
airdrop-20181115-hdac-1a71fe88-4c31-45c2-95e0-149d70cec2fb-withdrawal-exchange,2018.11.15 10:11,UNKNOWN,,UNKNOWN-55c0f2b7-dc24-425b-9be8-6b86719f2865,2018.11.15 10:11,UNKNOWN,0,100,0,HDAC,WITHDRAWAL,,,,0,COMPLETED,0,sum-user-id,1953389.937,airdrop-20181115-hdac-sum-user-id-withdrawal,accac570-de75-11e8-bd11-2f9252c4dc2f,AIRDROP,0
airdrop-20181115-hdac-1a747000-3688-459e-86f1-3d836097babf-withdrawal-exchange,2018.11.15 10:11,UNKNOWN,,UNKNOWN-55c0f2b7-dc24-425b-9be8-6b86719f2865,2018.11.15 10:11,UNKNOWN,0,100,0,HDAC,WITHDRAWAL,,,,0,COMPLETED,0,sum-user-id,1953289.937,airdrop-20181115-hdac-sum-user-id-withdrawal,accac570-de75-11e8-bd11-2f9252c4dc2f,AIRDROP,0
airdrop-20181115-hdac-1a77229c-d6d3-405f-98b3-62ac837626b8-withdrawal-exchange,2018.11.15 10:11,UNKNOWN,,UNKNOWN-55c0f2b7-dc24-425b-9be8-6b86719f2865,2018.11.15 10:11,UNKNOWN,0,100,0,HDAC,WITHDRAWAL,,,,0,COMPLETED,0,sum-user-id,1953189.937,airdrop-20181115-hdac-sum-user-id-withdrawal,accac570-de75-11e8-bd11-2f9252c4dc2f,AIRDROP,0
airdrop-20181115-hdac-1a8dd1c5-9ae4-4106-adb4-e49b72ba733c-withdrawal-exchange,2018.11.15 10:11,UNKNOWN,,UNKNOWN-55c0f2b7-dc24-425b-9be8-6b86719f2865,2018.11.15 10:11,UNKNOWN,0,100,0,HDAC,WITHDRAWAL,,,,0,COMPLETED,0,sum-user-id,1953089.937,airdrop-20181115-hdac-sum-user-id-withdrawal,accac570-de75-11e8-bd11-2f9252c4dc2f,AIRDROP,0
airdrop-20181115-hdac-1ab6986a-0e50-4140-8a29-fa87bfb4cb97-withdrawal-exchange,2018.11.15 10:11,UNKNOWN,,UNKNOWN-55c0f2b7-dc24-425b-9be8-6b86719f2865,2018.11.15 10:11,UNKNOWN,0,100,0,HDAC,WITHDRAWAL,,,,0,COMPLETED,0,sum-user-id,1952989.937,airdrop-20181115-hdac-sum-user-id-withdrawal,accac570-de75-11e8-bd11-2f9252c4dc2f,AIRDROP,0
airdrop-20181115-hdac-1ab8ffb4-62a7-494a-bae3-65178ec20fdb-withdrawal-exchange,2018.11.15 10:11,UNKNOWN,,UNKNOWN-55c0f2b7-dc24-425b-9be8-6b86719f2865,2018.11.15 10:11,UNKNOWN,0,100,0,HDAC,WITHDRAWAL,,,,0,COMPLETED,0,sum-user-id,1952889.937,airdrop-20181115-hdac-sum-user-id-withdrawal,accac570-de75-11e8-bd11-2f9252c4dc2f,AIRDROP,0
airdrop-20181115-hdac-1ad1a434-8b6b-45eb-8bd7-2287a166c2d9-withdrawal-exchange,2018.11.15 10:11,UNKNOWN,,UNKNOWN-55c0f2b7-dc24-425b-9be8-6b86719f2865,2018.11.15 10:11,UNKNOWN,0,100,0,HDAC,WITHDRAWAL,,,,0,COMPLETED,0,sum-user-id,1952789.937,airdrop-20181115-hdac-sum-user-id-withdrawal,accac570-de75-11e8-bd11-2f9252c4dc2f,AIRDROP,0
airdrop-20181115-hdac-1ad3403a-90ac-4a10-ab54-2da174546c14-withdrawal-exchange,2018.11.15 10:11,UNKNOWN,,UNKNOWN-55c0f2b7-dc24-425b-9be8-6b86719f2865,2018.11.15 10:11,UNKNOWN,0,100,0,HDAC,WITHDRAWAL,,,,0,COMPLETED,0,sum-user-id,1952689.937,airdrop-20181115-hdac-sum-user-id-withdrawal,accac570-de75-11e8-bd11-2f9252c4dc2f,AIRDROP,0
airdrop-20181115-hdac-1af04d7b-aac5-4171-a24d-4192a75a0b42-withdrawal-exchange,2018.11.15 10:11,UNKNOWN,,UNKNOWN-55c0f2b7-dc24-425b-9be8-6b86719f2865,2018.11.15 10:11,UNKNOWN,0,100,0,HDAC,WITHDRAWAL,,,,0,COMPLETED,0,sum-user-id,1952589.937,airdrop-20181115-hdac-sum-user-id-withdrawal,accac570-de75-11e8-bd11-2f9252c4dc2f,AIRDROP,0
airdrop-20181115-hdac-1afacbeb-00d1-41f4-bdcf-91168d11ee4b-withdrawal-exchange,2018.11.15 10:11,UNKNOWN,,UNKNOWN-55c0f2b7-dc24-425b-9be8-6b86719f2865,2018.11.15 10:11,UNKNOWN,0,100,0,HDAC,WITHDRAWAL,,,,0,COMPLETED,0,sum-user-id,1952489.937,airdrop-20181115-hdac-sum-user-id-withdrawal,accac570-de75-11e8-bd11-2f9252c4dc2f,AIRDROP,0
airdrop-20181115-hdac-1b015b7e-5006-40ba-ba82-922bbc4f2f38-withdrawal-exchange,2018.11.15 10:11,UNKNOWN,,UNKNOWN-55c0f2b7-dc24-425b-9be8-6b86719f2865,2018.11.15 10:11,UNKNOWN,0,100,0,HDAC,WITHDRAWAL,,,,0,COMPLETED,0,sum-user-id,1952389.937,airdrop-20181115-hdac-sum-user-id-withdrawal,accac570-de75-11e8-bd11-2f9252c4dc2f,AIRDROP,0
airdrop-20181115-hdac-1b35f0c9-4ba3-464c-be66-c7a6b67604ab-withdrawal-exchange,2018.11.15 10:11,UNKNOWN,,UNKNOWN-55c0f2b7-dc24-425b-9be8-6b86719f2865,2018.11.15 10:11,UNKNOWN,0,100,0,HDAC,WITHDRAWAL,,,,0,COMPLETED,0,sum-user-id,1952289.937,airdrop-20181115-hdac-sum-user-id-withdrawal,accac570-de75-11e8-bd11-2f9252c4dc2f,AIRDROP,0
airdrop-20181115-hdac-1b4bd79c-4ecf-4336-9998-fff71656e7a8-withdrawal-exchange,2018.11.15 10:11,UNKNOWN,,UNKNOWN-55c0f2b7-dc24-425b-9be8-6b86719f2865,2018.11.15 10:11,UNKNOWN,0,100,0,HDAC,WITHDRAWAL,,,,0,COMPLETED,0,sum-user-id,1952189.937,airdrop-20181115-hdac-sum-user-id-withdrawal,accac570-de75-11e8-bd11-2f9252c4dc2f,AIRDROP,0
airdrop-20181115-hdac-1b97140d-d025-46d4-9708-e892bf63538f-withdrawal-exchange,2018.11.15 10:11,UNKNOWN,,UNKNOWN-55c0f2b7-dc24-425b-9be8-6b86719f2865,2018.11.15 10:11,UNKNOWN,0,100,0,HDAC,WITHDRAWAL,,,,0,COMPLETED,0,sum-user-id,1952089.937,airdrop-20181115-hdac-sum-user-id-withdrawal,accac570-de75-11e8-bd11-2f9252c4dc2f,AIRDROP,0
airdrop-20181115-hdac-1bcff83c-f415-46a4-ad33-8dd029964f99-withdrawal-exchange,2018.11.15 10:11,UNKNOWN,,UNKNOWN-55c0f2b7-dc24-425b-9be8-6b86719f2865,2018.11.15 10:11,UNKNOWN,0,100,0,HDAC,WITHDRAWAL,,,,0,COMPLETED,0,sum-user-id,1951989.937,airdrop-20181115-hdac-sum-user-id-withdrawal,accac570-de75-11e8-bd11-2f9252c4dc2f,AIRDROP,0
airdrop-20181115-hdac-1bed460c-25b2-4e1a-a24e-80dec6a48a23-withdrawal-exchange,2018.11.15 10:11,UNKNOWN,,UNKNOWN-55c0f2b7-dc24-425b-9be8-6b86719f2865,2018.11.15 10:11,UNKNOWN,0,100,0,HDAC,WITHDRAWAL,,,,0,COMPLETED,0,sum-user-id,1951889.937,airdrop-20181115-hdac-sum-user-id-withdrawal,accac570-de75-11e8-bd11-2f9252c4dc2f,AIRDROP,0
airdrop-20181115-hdac-1bf72378-d245-417f-8ee9-0ca89d1e05f1-withdrawal-exchange,2018.11.15 10:11,UNKNOWN,,UNKNOWN-55c0f2b7-dc24-425b-9be8-6b86719f2865,2018.11.15 10:11,UNKNOWN,0,100,0,HDAC,WITHDRAWAL,,,,0,COMPLETED,0,sum-user-id,1951789.937,airdrop-20181115-hdac-sum-user-id-withdrawal,accac570-de75-11e8-bd11-2f9252c4dc2f,AIRDROP,0
airdrop-20181115-hdac-1c90272c-10f5-4b2b-af5a-1889c47b831c-withdrawal-exchange,2018.11.15 10:11,UNKNOWN,,UNKNOWN-55c0f2b7-dc24-425b-9be8-6b86719f2865,2018.11.15 10:11,UNKNOWN,0,100,0,HDAC,WITHDRAWAL,,,,0,COMPLETED,0,sum-user-id,1951689.937,airdrop-20181115-hdac-sum-user-id-withdrawal,accac570-de75-11e8-bd11-2f9252c4dc2f,AIRDROP,0
airdrop-20181115-hdac-1c90daee-5d19-4c55-aaf6-a4a237c1eeda-withdrawal-exchange,2018.11.15 10:11,UNKNOWN,,UNKNOWN-55c0f2b7-dc24-425b-9be8-6b86719f2865,2018.11.15 10:11,UNKNOWN,0,100,0,HDAC,WITHDRAWAL,,,,0,COMPLETED,0,sum-user-id,1951589.937,airdrop-20181115-hdac-sum-user-id-withdrawal,accac570-de75-11e8-bd11-2f9252c4dc2f,AIRDROP,0
airdrop-20181115-hdac-1ca31f7b-c9f3-4813-af61-e46eb089fbb3-withdrawal-exchange,2018.11.15 10:11,UNKNOWN,,UNKNOWN-55c0f2b7-dc24-425b-9be8-6b86719f2865,2018.11.15 10:11,UNKNOWN,0,100,0,HDAC,WITHDRAWAL,,,,0,COMPLETED,0,sum-user-id,1951489.937,airdrop-20181115-hdac-sum-user-id-withdrawal,accac570-de75-11e8-bd11-2f9252c4dc2f,AIRDROP,0
airdrop-20181115-hdac-1ce43a6b-36d2-468d-bdcc-9418c4ae507c-withdrawal-exchange,2018-11-15 10:11:16.008,UNKNOWN,,UNKNOWN-55c0f2b7-dc24-425b-9be8-6b86719f2865,2018-11-15 10:11:16.008,UNKNOWN,0,100,0,HDAC,WITHDRAWAL,,,,0,COMPLETED,0,sum-user-id,1951389.937,airdrop-20181115-hdac-sum-user-id-withdrawal,accac570-de75-11e8-bd11-2f9252c4dc2f,AIRDROP,0
airdrop-20181115-hdac-1d0bb1a4-ef5a-40dc-b0af-d94ce92ed414-withdrawal-exchange,2018-11-15 10:11:16.037,UNKNOWN,,UNKNOWN-55c0f2b7-dc24-425b-9be8-6b86719f2865,2018-11-15 10:11:16.037,UNKNOWN,0,100,0,HDAC,WITHDRAWAL,,,,0,COMPLETED,0,sum-user-id,1951289.937,airdrop-20181115-hdac-sum-user-id-withdrawal,accac570-de75-11e8-bd11-2f9252c4dc2f,AIRDROP,0
airdrop-20181115-hdac-1d591804-a1ca-432e-9628-3c5cbc9c9b92-withdrawal-exchange,2018-11-15 10:11:16.071,UNKNOWN,,UNKNOWN-55c0f2b7-dc24-425b-9be8-6b86719f2865,2018-11-15 10:11:16.071,UNKNOWN,0,100,0,HDAC,WITHDRAWAL,,,,0,COMPLETED,0,sum-user-id,1951189.937,airdrop-20181115-hdac-sum-user-id-withdrawal,accac570-de75-11e8-bd11-2f9252c4dc2f,AIRDROP,0
airdrop-20181115-hdac-1d6218ac-f825-4495-863d-e47bc9c0d9bb-withdrawal-exchange,2018.11.15 10:11,UNKNOWN,,UNKNOWN-55c0f2b7-dc24-425b-9be8-6b86719f2865,2018.11.15 10:11,UNKNOWN,0,100,0,HDAC,WITHDRAWAL,,,,0,COMPLETED,0,sum-user-id,1951089.937,airdrop-20181115-hdac-sum-user-id-withdrawal,accac570-de75-11e8-bd11-2f9252c4dc2f,AIRDROP,0
airdrop-20181115-hdac-1d97f7fa-ed0d-4a1f-955c-87724e0e3bc4-withdrawal-exchange,2018.11.15 10:11,UNKNOWN,,UNKNOWN-55c0f2b7-dc24-425b-9be8-6b86719f2865,2018.11.15 10:11,UNKNOWN,0,100,0,HDAC,WITHDRAWAL,,,,0,COMPLETED,0,sum-user-id,1950989.937,airdrop-20181115-hdac-sum-user-id-withdrawal,accac570-de75-11e8-bd11-2f9252c4dc2f,AIRDROP,0
airdrop-20181115-hdac-1d9e6edd-3acd-4baf-bdc0-c69983f0d252-withdrawal-exchange,2018.11.15 10:11,UNKNOWN,,UNKNOWN-55c0f2b7-dc24-425b-9be8-6b86719f2865,2018.11.15 10:11,UNKNOWN,0,100,0,HDAC,WITHDRAWAL,,,,0,COMPLETED,0,sum-user-id,1950889.937,airdrop-20181115-hdac-sum-user-id-withdrawal,accac570-de75-11e8-bd11-2f9252c4dc2f,AIRDROP,0
airdrop-20181115-hdac-1dc0eef9-889b-4567-be6c-b21fa4105b1b-withdrawal-exchange,2018.11.15 10:11,UNKNOWN,,UNKNOWN-55c0f2b7-dc24-425b-9be8-6b86719f2865,2018.11.15 10:11,UNKNOWN,0,100,0,HDAC,WITHDRAWAL,,,,0,COMPLETED,0,sum-user-id,1950789.937,airdrop-20181115-hdac-sum-user-id-withdrawal,accac570-de75-11e8-bd11-2f9252c4dc2f,AIRDROP,0
airdrop-20181115-hdac-1dc194ea-2eeb-4a33-b50e-975bc6f08c54-withdrawal-exchange,2018.11.15 10:11,UNKNOWN,,UNKNOWN-55c0f2b7-dc24-425b-9be8-6b86719f2865,2018.11.15 10:11,UNKNOWN,0,100,0,HDAC,WITHDRAWAL,,,,0,COMPLETED,0,sum-user-id,1950689.937,airdrop-20181115-hdac-sum-user-id-withdrawal,accac570-de75-11e8-bd11-2f9252c4dc2f,AIRDROP,0
airdrop-20181115-hdac-1dc75c3b-a0f2-4e2f-bc77-0fd85b0c388f-withdrawal-exchange,2018.11.15 10:11,UNKNOWN,,UNKNOWN-55c0f2b7-dc24-425b-9be8-6b86719f2865,2018.11.15 10:11,UNKNOWN,0,100,0,HDAC,WITHDRAWAL,,,,0,COMPLETED,0,sum-user-id,1950589.937,airdrop-20181115-hdac-sum-user-id-withdrawal,accac570-de75-11e8-bd11-2f9252c4dc2f,AIRDROP,0
airdrop-20181115-hdac-1dcb584c-6054-4d20-8436-0549d7acc74c-withdrawal-exchange,2018.11.15 10:11,UNKNOWN,,UNKNOWN-55c0f2b7-dc24-425b-9be8-6b86719f2865,2018.11.15 10:11,UNKNOWN,0,100,0,HDAC,WITHDRAWAL,,,,0,COMPLETED,0,sum-user-id,1950489.937,airdrop-20181115-hdac-sum-user-id-withdrawal,accac570-de75-11e8-bd11-2f9252c4dc2f,AIRDROP,0
airdrop-20181115-hdac-1dea33df-81c7-4028-994d-58ebf7049416-withdrawal-exchange,2018.11.15 10:11,UNKNOWN,,UNKNOWN-55c0f2b7-dc24-425b-9be8-6b86719f2865,2018.11.15 10:11,UNKNOWN,0,100,0,HDAC,WITHDRAWAL,,,,0,COMPLETED,0,sum-user-id,1950389.937,airdrop-20181115-hdac-sum-user-id-withdrawal,accac570-de75-11e8-bd11-2f9252c4dc2f,AIRDROP,0
airdrop-20181115-hdac-1df0b36b-d89e-4fd6-a2bf-3291ef99e6e8-withdrawal-exchange,2018.11.15 10:11,UNKNOWN,,UNKNOWN-55c0f2b7-dc24-425b-9be8-6b86719f2865,2018.11.15 10:11,UNKNOWN,0,100,0,HDAC,WITHDRAWAL,,,,0,COMPLETED,0,sum-user-id,1950289.937,airdrop-20181115-hdac-sum-user-id-withdrawal,accac570-de75-11e8-bd11-2f9252c4dc2f,AIRDROP,0
airdrop-20181115-hdac-1e03e20d-7d86-41f2-9db8-2f89410c3ed9-withdrawal-exchange,2018.11.15 10:11,UNKNOWN,,UNKNOWN-55c0f2b7-dc24-425b-9be8-6b86719f2865,2018.11.15 10:11,UNKNOWN,0,100,0,HDAC,WITHDRAWAL,,,,0,COMPLETED,0,sum-user-id,1950189.937,airdrop-20181115-hdac-sum-user-id-withdrawal,accac570-de75-11e8-bd11-2f9252c4dc2f,AIRDROP,0
airdrop-20181115-hdac-1e11e357-cedb-4caa-aaae-eb0af922ea4a-withdrawal-exchange,2018.11.15 10:11,UNKNOWN,,UNKNOWN-55c0f2b7-dc24-425b-9be8-6b86719f2865,2018.11.15 10:11,UNKNOWN,0,100,0,HDAC,WITHDRAWAL,,,,0,COMPLETED,0,sum-user-id,1950089.937,airdrop-20181115-hdac-sum-user-id-withdrawal,accac570-de75-11e8-bd11-2f9252c4dc2f,AIRDROP,0
airdrop-20181115-hdac-1e15caf0-ae3b-4819-a48d-33599e9cb93d-withdrawal-exchange,2018.11.15 10:11,UNKNOWN,,UNKNOWN-55c0f2b7-dc24-425b-9be8-6b86719f2865,2018.11.15 10:11,UNKNOWN,0,100,0,HDAC,WITHDRAWAL,,,,0,COMPLETED,0,sum-user-id,1949989.937,airdrop-20181115-hdac-sum-user-id-withdrawal,accac570-de75-11e8-bd11-2f9252c4dc2f,AIRDROP,0
airdrop-20181115-hdac-1e377dd1-0d97-4952-bec9-9930088dd945-withdrawal-exchange,2018.11.15 10:11,UNKNOWN,,UNKNOWN-55c0f2b7-dc24-425b-9be8-6b86719f2865,2018.11.15 10:11,UNKNOWN,0,100,0,HDAC,WITHDRAWAL,,,,0,COMPLETED,0,sum-user-id,1949889.937,airdrop-20181115-hdac-sum-user-id-withdrawal,accac570-de75-11e8-bd11-2f9252c4dc2f,AIRDROP,0
airdrop-20181115-hdac-1e459213-bbe4-43a0-9694-e04764930eab-withdrawal-exchange,2018.11.15 10:11,UNKNOWN,,UNKNOWN-55c0f2b7-dc24-425b-9be8-6b86719f2865,2018.11.15 10:11,UNKNOWN,0,100,0,HDAC,WITHDRAWAL,,,,0,COMPLETED,0,sum-user-id,1949789.937,airdrop-20181115-hdac-sum-user-id-withdrawal,accac570-de75-11e8-bd11-2f9252c4dc2f,AIRDROP,0
airdrop-20181115-hdac-1e55a6ca-5e63-469b-866d-9858c627f48e-withdrawal-exchange,2018.11.15 10:11,UNKNOWN,,UNKNOWN-55c0f2b7-dc24-425b-9be8-6b86719f2865,2018.11.15 10:11,UNKNOWN,0,100,0,HDAC,WITHDRAWAL,,,,0,COMPLETED,0,sum-user-id,1949689.937,airdrop-20181115-hdac-sum-user-id-withdrawal,accac570-de75-11e8-bd11-2f9252c4dc2f,AIRDROP,0
airdrop-20181115-hdac-1e6d572f-7344-41c0-824e-361d253bc13b-withdrawal-exchange,2018.11.15 10:11,UNKNOWN,,UNKNOWN-55c0f2b7-dc24-425b-9be8-6b86719f2865,2018.11.15 10:11,UNKNOWN,0,100,0,HDAC,WITHDRAWAL,,,,0,COMPLETED,0,sum-user-id,1949589.937,airdrop-20181115-hdac-sum-user-id-withdrawal,accac570-de75-11e8-bd11-2f9252c4dc2f,AIRDROP,0
airdrop-20181115-hdac-1e7e42ab-8a33-40f4-aa8f-86093a2807a4-withdrawal-exchange,2018.11.15 10:11,UNKNOWN,,UNKNOWN-55c0f2b7-dc24-425b-9be8-6b86719f2865,2018.11.15 10:11,UNKNOWN,0,100,0,HDAC,WITHDRAWAL,,,,0,COMPLETED,0,sum-user-id,1949489.937,airdrop-20181115-hdac-sum-user-id-withdrawal,accac570-de75-11e8-bd11-2f9252c4dc2f,AIRDROP,0
airdrop-20181115-hdac-1ea2fc74-0932-4911-a278-fd84207cdc21-withdrawal-exchange,2018.11.15 10:11,UNKNOWN,,UNKNOWN-55c0f2b7-dc24-425b-9be8-6b86719f2865,2018.11.15 10:11,UNKNOWN,0,100,0,HDAC,WITHDRAWAL,,,,0,COMPLETED,0,sum-user-id,1949389.937,airdrop-20181115-hdac-sum-user-id-withdrawal,accac570-de75-11e8-bd11-2f9252c4dc2f,AIRDROP,0
airdrop-20181115-hdac-1ec7b921-5bcf-4f10-93a3-976ee193f9b4-withdrawal-exchange,2018.11.15 10:11,UNKNOWN,,UNKNOWN-55c0f2b7-dc24-425b-9be8-6b86719f2865,2018.11.15 10:11,UNKNOWN,0,100,0,HDAC,WITHDRAWAL,,,,0,COMPLETED,0,sum-user-id,1949289.937,airdrop-20181115-hdac-sum-user-id-withdrawal,accac570-de75-11e8-bd11-2f9252c4dc2f,AIRDROP,0
airdrop-20181115-hdac-1ece9824-6178-4a89-8937-cac33fd198cd-withdrawal-exchange,2018.11.15 10:11,UNKNOWN,,UNKNOWN-55c0f2b7-dc24-425b-9be8-6b86719f2865,2018.11.15 10:11,UNKNOWN,0,100,0,HDAC,WITHDRAWAL,,,,0,COMPLETED,0,sum-user-id,1949189.937,airdrop-20181115-hdac-sum-user-id-withdrawal,accac570-de75-11e8-bd11-2f9252c4dc2f,AIRDROP,0
airdrop-20181115-hdac-1f089913-8cec-4f41-a648-9c785047bcfc-withdrawal-exchange,2018.11.15 10:11,UNKNOWN,,UNKNOWN-55c0f2b7-dc24-425b-9be8-6b86719f2865,2018.11.15 10:11,UNKNOWN,0,10200,0,HDAC,WITHDRAWAL,,,,0,COMPLETED,0,sum-user-id,1938989.937,airdrop-20181115-hdac-sum-user-id-withdrawal,accac570-de75-11e8-bd11-2f9252c4dc2f,AIRDROP,0
airdrop-20181115-hdac-1f0aa820-349d-4ee2-b34f-094f4f319897-withdrawal-exchange,2018.11.15 10:11,UNKNOWN,,UNKNOWN-55c0f2b7-dc24-425b-9be8-6b86719f2865,2018.11.15 10:11,UNKNOWN,0,100,0,HDAC,WITHDRAWAL,,,,0,COMPLETED,0,sum-user-id,1938889.937,airdrop-20181115-hdac-sum-user-id-withdrawal,accac570-de75-11e8-bd11-2f9252c4dc2f,AIRDROP,0
airdrop-20181115-hdac-1f4f870a-2162-4273-b0f1-6fd322368ef0-withdrawal-exchange,2018.11.15 10:11,UNKNOWN,,UNKNOWN-55c0f2b7-dc24-425b-9be8-6b86719f2865,2018.11.15 10:11,UNKNOWN,0,100,0,HDAC,WITHDRAWAL,,,,0,COMPLETED,0,sum-user-id,1938789.937,airdrop-20181115-hdac-sum-user-id-withdrawal,accac570-de75-11e8-bd11-2f9252c4dc2f,AIRDROP,0
airdrop-20181115-hdac-1f615936-6960-43ae-a7f6-49ea5914b3d7-withdrawal-exchange,2018.11.15 10:11,UNKNOWN,,UNKNOWN-55c0f2b7-dc24-425b-9be8-6b86719f2865,2018.11.15 10:11,UNKNOWN,0,100,0,HDAC,WITHDRAWAL,,,,0,COMPLETED,0,sum-user-id,1938689.937,airdrop-20181115-hdac-sum-user-id-withdrawal,accac570-de75-11e8-bd11-2f9252c4dc2f,AIRDROP,0
airdrop-20181115-hdac-1f83a70a-0ace-46b9-bb93-38ead866afdf-withdrawal-exchange,2018.11.15 10:11,UNKNOWN,,UNKNOWN-55c0f2b7-dc24-425b-9be8-6b86719f2865,2018.11.15 10:11,UNKNOWN,0,100,0,HDAC,WITHDRAWAL,,,,0,COMPLETED,0,sum-user-id,1938589.937,airdrop-20181115-hdac-sum-user-id-withdrawal,accac570-de75-11e8-bd11-2f9252c4dc2f,AIRDROP,0
airdrop-20181115-hdac-1f9589d5-72fc-401c-98cf-5ee54df32cae-withdrawal-exchange,2018.11.15 10:11,UNKNOWN,,UNKNOWN-55c0f2b7-dc24-425b-9be8-6b86719f2865,2018.11.15 10:11,UNKNOWN,0,100,0,HDAC,WITHDRAWAL,,,,0,COMPLETED,0,sum-user-id,1938489.937,airdrop-20181115-hdac-sum-user-id-withdrawal,accac570-de75-11e8-bd11-2f9252c4dc2f,AIRDROP,0
airdrop-20181115-hdac-1f98634a-72f1-482e-84ec-24294d71916b-withdrawal-exchange,2018.11.15 10:11,UNKNOWN,,UNKNOWN-55c0f2b7-dc24-425b-9be8-6b86719f2865,2018.11.15 10:11,UNKNOWN,0,100,0,HDAC,WITHDRAWAL,,,,0,COMPLETED,0,sum-user-id,1938389.937,airdrop-20181115-hdac-sum-user-id-withdrawal,accac570-de75-11e8-bd11-2f9252c4dc2f,AIRDROP,0
airdrop-20181115-hdac-1f99b7b0-5901-4a4c-a139-de37cb131c27-withdrawal-exchange,2018-11-15 10:11:17.009,UNKNOWN,,UNKNOWN-55c0f2b7-dc24-425b-9be8-6b86719f2865,2018-11-15 10:11:17.009,UNKNOWN,0,100,0,HDAC,WITHDRAWAL,,,,0,COMPLETED,0,sum-user-id,1938289.937,airdrop-20181115-hdac-sum-user-id-withdrawal,accac570-de75-11e8-bd11-2f9252c4dc2f,AIRDROP,0
airdrop-20181115-hdac-1fc575db-ab36-4af3-ba98-67b25eb514a6-withdrawal-exchange,2018-11-15 10:11:17.038,UNKNOWN,,UNKNOWN-55c0f2b7-dc24-425b-9be8-6b86719f2865,2018-11-15 10:11:17.038,UNKNOWN,0,100,0,HDAC,WITHDRAWAL,,,,0,COMPLETED,0,sum-user-id,1938189.937,airdrop-20181115-hdac-sum-user-id-withdrawal,accac570-de75-11e8-bd11-2f9252c4dc2f,AIRDROP,0
airdrop-20181115-hdac-1fc76072-5df1-4be7-bbdf-838d7025dbac-withdrawal-exchange,2018-11-15 10:11:17.072,UNKNOWN,,UNKNOWN-55c0f2b7-dc24-425b-9be8-6b86719f2865,2018-11-15 10:11:17.072,UNKNOWN,0,100,0,HDAC,WITHDRAWAL,,,,0,COMPLETED,0,sum-user-id,1938089.937,airdrop-20181115-hdac-sum-user-id-withdrawal,accac570-de75-11e8-bd11-2f9252c4dc2f,AIRDROP,0
airdrop-20181115-hdac-1fda07e0-25a2-4574-88f3-f3895ce74106-withdrawal-exchange,2018.11.15 10:11,UNKNOWN,,UNKNOWN-55c0f2b7-dc24-425b-9be8-6b86719f2865,2018.11.15 10:11,UNKNOWN,0,100,0,HDAC,WITHDRAWAL,,,,0,COMPLETED,0,sum-user-id,1937989.937,airdrop-20181115-hdac-sum-user-id-withdrawal,accac570-de75-11e8-bd11-2f9252c4dc2f,AIRDROP,0
airdrop-20181115-hdac-1fdcc87f-1e8a-4a2c-b30a-d89bdf380003-withdrawal-exchange,2018.11.15 10:11,UNKNOWN,,UNKNOWN-55c0f2b7-dc24-425b-9be8-6b86719f2865,2018.11.15 10:11,UNKNOWN,0,100,0,HDAC,WITHDRAWAL,,,,0,COMPLETED,0,sum-user-id,1937889.937,airdrop-20181115-hdac-sum-user-id-withdrawal,accac570-de75-11e8-bd11-2f9252c4dc2f,AIRDROP,0
airdrop-20181115-hdac-201df1d8-cce6-4f77-aa5a-0f8d1b883537-withdrawal-exchange,2018.11.15 10:11,UNKNOWN,,UNKNOWN-55c0f2b7-dc24-425b-9be8-6b86719f2865,2018.11.15 10:11,UNKNOWN,0,100,0,HDAC,WITHDRAWAL,,,,0,COMPLETED,0,sum-user-id,1937789.937,airdrop-20181115-hdac-sum-user-id-withdrawal,accac570-de75-11e8-bd11-2f9252c4dc2f,AIRDROP,0
airdrop-20181115-hdac-203cf20e-05ab-45cd-b87e-6d7b4c38c792-withdrawal-exchange,2018.11.15 10:11,UNKNOWN,,UNKNOWN-55c0f2b7-dc24-425b-9be8-6b86719f2865,2018.11.15 10:11,UNKNOWN,0,100,0,HDAC,WITHDRAWAL,,,,0,COMPLETED,0,sum-user-id,1937689.937,airdrop-20181115-hdac-sum-user-id-withdrawal,accac570-de75-11e8-bd11-2f9252c4dc2f,AIRDROP,0
airdrop-20181115-hdac-20446e3e-d149-4141-8a45-5f9fdefbbe46-withdrawal-exchange,2018.11.15 10:11,UNKNOWN,,UNKNOWN-55c0f2b7-dc24-425b-9be8-6b86719f2865,2018.11.15 10:11,UNKNOWN,0,100,0,HDAC,WITHDRAWAL,,,,0,COMPLETED,0,sum-user-id,1937589.937,airdrop-20181115-hdac-sum-user-id-withdrawal,accac570-de75-11e8-bd11-2f9252c4dc2f,AIRDROP,0
airdrop-20181115-hdac-207f8f8e-3131-4c30-8e09-53dfc2cffe42-withdrawal-exchange,2018.11.15 10:11,UNKNOWN,,UNKNOWN-55c0f2b7-dc24-425b-9be8-6b86719f2865,2018.11.15 10:11,UNKNOWN,0,100,0,HDAC,WITHDRAWAL,,,,0,COMPLETED,0,sum-user-id,1937489.937,airdrop-20181115-hdac-sum-user-id-withdrawal,accac570-de75-11e8-bd11-2f9252c4dc2f,AIRDROP,0
airdrop-20181115-hdac-20bc159b-a4ef-4dc4-98b6-77f45db66fba-withdrawal-exchange,2018.11.15 10:11,UNKNOWN,,UNKNOWN-55c0f2b7-dc24-425b-9be8-6b86719f2865,2018.11.15 10:11,UNKNOWN,0,100,0,HDAC,WITHDRAWAL,,,,0,COMPLETED,0,sum-user-id,1937389.937,airdrop-20181115-hdac-sum-user-id-withdrawal,accac570-de75-11e8-bd11-2f9252c4dc2f,AIRDROP,0
airdrop-20181115-hdac-20c8141a-9cbc-492b-a1d8-26014477bd79-withdrawal-exchange,2018.11.15 10:11,UNKNOWN,,UNKNOWN-55c0f2b7-dc24-425b-9be8-6b86719f2865,2018.11.15 10:11,UNKNOWN,0,100,0,HDAC,WITHDRAWAL,,,,0,COMPLETED,0,sum-user-id,1937289.937,airdrop-20181115-hdac-sum-user-id-withdrawal,accac570-de75-11e8-bd11-2f9252c4dc2f,AIRDROP,0
airdrop-20181115-hdac-20feb092-55b1-4e06-af9f-3c91127f7737-withdrawal-exchange,2018.11.15 10:11,UNKNOWN,,UNKNOWN-55c0f2b7-dc24-425b-9be8-6b86719f2865,2018.11.15 10:11,UNKNOWN,0,100,0,HDAC,WITHDRAWAL,,,,0,COMPLETED,0,sum-user-id,1937189.937,airdrop-20181115-hdac-sum-user-id-withdrawal,accac570-de75-11e8-bd11-2f9252c4dc2f,AIRDROP,0
airdrop-20181115-hdac-212eb621-6a33-44c2-a383-3125ce25ebd2-withdrawal-exchange,2018.11.15 10:11,UNKNOWN,,UNKNOWN-55c0f2b7-dc24-425b-9be8-6b86719f2865,2018.11.15 10:11,UNKNOWN,0,100,0,HDAC,WITHDRAWAL,,,,0,COMPLETED,0,sum-user-id,1937089.937,airdrop-20181115-hdac-sum-user-id-withdrawal,accac570-de75-11e8-bd11-2f9252c4dc2f,AIRDROP,0
airdrop-20181115-hdac-214be5f5-f58e-43d3-aa29-9e8d706caff6-withdrawal-exchange,2018.11.15 10:11,UNKNOWN,,UNKNOWN-55c0f2b7-dc24-425b-9be8-6b86719f2865,2018.11.15 10:11,UNKNOWN,0,100,0,HDAC,WITHDRAWAL,,,,0,COMPLETED,0,sum-user-id,1936989.937,airdrop-20181115-hdac-sum-user-id-withdrawal,accac570-de75-11e8-bd11-2f9252c4dc2f,AIRDROP,0
airdrop-20181115-hdac-215cd1dd-25d3-4bab-81b5-3c3a77fdd5d3-withdrawal-exchange,2018.11.15 10:11,UNKNOWN,,UNKNOWN-55c0f2b7-dc24-425b-9be8-6b86719f2865,2018.11.15 10:11,UNKNOWN,0,100,0,HDAC,WITHDRAWAL,,,,0,COMPLETED,0,sum-user-id,1936889.937,airdrop-20181115-hdac-sum-user-id-withdrawal,accac570-de75-11e8-bd11-2f9252c4dc2f,AIRDROP,0
airdrop-20181115-hdac-216d8f38-2783-46b6-aee4-f9b511ed22da-withdrawal-exchange,2018.11.15 10:11,UNKNOWN,,UNKNOWN-55c0f2b7-dc24-425b-9be8-6b86719f2865,2018.11.15 10:11,UNKNOWN,0,100,0,HDAC,WITHDRAWAL,,,,0,COMPLETED,0,sum-user-id,1936789.937,airdrop-20181115-hdac-sum-user-id-withdrawal,accac570-de75-11e8-bd11-2f9252c4dc2f,AIRDROP,0
airdrop-20181115-hdac-218ca89e-4f95-464b-bfc9-0861f599db56-withdrawal-exchange,2018.11.15 10:11,UNKNOWN,,UNKNOWN-55c0f2b7-dc24-425b-9be8-6b86719f2865,2018.11.15 10:11,UNKNOWN,0,100,0,HDAC,WITHDRAWAL,,,,0,COMPLETED,0,sum-user-id,1936689.937,airdrop-20181115-hdac-sum-user-id-withdrawal,accac570-de75-11e8-bd11-2f9252c4dc2f,AIRDROP,0
airdrop-20181115-hdac-219292f2-90e6-4fe0-a24b-256634ca6b07-withdrawal-exchange,2018.11.15 10:11,UNKNOWN,,UNKNOWN-55c0f2b7-dc24-425b-9be8-6b86719f2865,2018.11.15 10:11,UNKNOWN,0,100,0,HDAC,WITHDRAWAL,,,,0,COMPLETED,0,sum-user-id,1936589.937,airdrop-20181115-hdac-sum-user-id-withdrawal,accac570-de75-11e8-bd11-2f9252c4dc2f,AIRDROP,0
airdrop-20181115-hdac-21bef556-8b33-4cfa-961b-7237594693d2-withdrawal-exchange,2018.11.15 10:11,UNKNOWN,,UNKNOWN-55c0f2b7-dc24-425b-9be8-6b86719f2865,2018.11.15 10:11,UNKNOWN,0,100,0,HDAC,WITHDRAWAL,,,,0,COMPLETED,0,sum-user-id,1936489.937,airdrop-20181115-hdac-sum-user-id-withdrawal,accac570-de75-11e8-bd11-2f9252c4dc2f,AIRDROP,0
airdrop-20181115-hdac-21ccc4e6-fc38-453c-aa1e-0d588b8e4dac-withdrawal-exchange,2018.11.15 10:11,UNKNOWN,,UNKNOWN-55c0f2b7-dc24-425b-9be8-6b86719f2865,2018.11.15 10:11,UNKNOWN,0,100,0,HDAC,WITHDRAWAL,,,,0,COMPLETED,0,sum-user-id,1936389.937,airdrop-20181115-hdac-sum-user-id-withdrawal,accac570-de75-11e8-bd11-2f9252c4dc2f,AIRDROP,0
airdrop-20181115-hdac-21e6c401-67a2-4065-87e8-5df68412115a-withdrawal-exchange,2018.11.15 10:11,UNKNOWN,,UNKNOWN-55c0f2b7-dc24-425b-9be8-6b86719f2865,2018.11.15 10:11,UNKNOWN,0,100,0,HDAC,WITHDRAWAL,,,,0,COMPLETED,0,sum-user-id,1936289.937,airdrop-20181115-hdac-sum-user-id-withdrawal,accac570-de75-11e8-bd11-2f9252c4dc2f,AIRDROP,0
airdrop-20181115-hdac-21fbfe89-7d23-42cc-875a-752dd5bfe48b-withdrawal-exchange,2018.11.15 10:11,UNKNOWN,,UNKNOWN-55c0f2b7-dc24-425b-9be8-6b86719f2865,2018.11.15 10:11,UNKNOWN,0,100,0,HDAC,WITHDRAWAL,,,,0,COMPLETED,0,sum-user-id,1936189.937,airdrop-20181115-hdac-sum-user-id-withdrawal,accac570-de75-11e8-bd11-2f9252c4dc2f,AIRDROP,0
airdrop-20181115-hdac-21fdc2c7-f0a9-4926-a50a-0e83626fa97b-withdrawal-exchange,2018.11.15 10:11,UNKNOWN,,UNKNOWN-55c0f2b7-dc24-425b-9be8-6b86719f2865,2018.11.15 10:11,UNKNOWN,0,100,0,HDAC,WITHDRAWAL,,,,0,COMPLETED,0,sum-user-id,1936089.937,airdrop-20181115-hdac-sum-user-id-withdrawal,accac570-de75-11e8-bd11-2f9252c4dc2f,AIRDROP,0
airdrop-20181115-hdac-220dc141-89fd-4a29-bd38-7407886a9e51-withdrawal-exchange,2018.11.15 10:11,UNKNOWN,,UNKNOWN-55c0f2b7-dc24-425b-9be8-6b86719f2865,2018.11.15 10:11,UNKNOWN,0,100,0,HDAC,WITHDRAWAL,,,,0,COMPLETED,0,sum-user-id,1935989.937,airdrop-20181115-hdac-sum-user-id-withdrawal,accac570-de75-11e8-bd11-2f9252c4dc2f,AIRDROP,0
airdrop-20181115-hdac-222dbd34-a689-4a99-b4c5-0968f93ca4c8-withdrawal-exchange,2018.11.15 10:11,UNKNOWN,,UNKNOWN-55c0f2b7-dc24-425b-9be8-6b86719f2865,2018.11.15 10:11,UNKNOWN,0,100,0,HDAC,WITHDRAWAL,,,,0,COMPLETED,0,sum-user-id,1935889.937,airdrop-20181115-hdac-sum-user-id-withdrawal,accac570-de75-11e8-bd11-2f9252c4dc2f,AIRDROP,0
airdrop-20181115-hdac-223c11cc-98d3-4917-a409-dde88a3de26b-withdrawal-exchange,2018.11.15 10:11,UNKNOWN,,UNKNOWN-55c0f2b7-dc24-425b-9be8-6b86719f2865,2018.11.15 10:11,UNKNOWN,0,100,0,HDAC,WITHDRAWAL,,,,0,COMPLETED,0,sum-user-id,1935789.937,airdrop-20181115-hdac-sum-user-id-withdrawal,accac570-de75-11e8-bd11-2f9252c4dc2f,AIRDROP,0
airdrop-20181115-hdac-22b5ffe1-180e-4367-9b08-f7abf987fc83-withdrawal-exchange,2018.11.15 10:11,UNKNOWN,,UNKNOWN-55c0f2b7-dc24-425b-9be8-6b86719f2865,2018.11.15 10:11,UNKNOWN,0,100,0,HDAC,WITHDRAWAL,,,,0,COMPLETED,0,sum-user-id,1935689.937,airdrop-20181115-hdac-sum-user-id-withdrawal,accac570-de75-11e8-bd11-2f9252c4dc2f,AIRDROP,0
airdrop-20181115-hdac-22b762f5-c6e3-4ff7-8605-0871d15919aa-withdrawal-exchange,2018.11.15 10:11,UNKNOWN,,UNKNOWN-55c0f2b7-dc24-425b-9be8-6b86719f2865,2018.11.15 10:11,UNKNOWN,0,100,0,HDAC,WITHDRAWAL,,,,0,COMPLETED,0,sum-user-id,1935589.937,airdrop-20181115-hdac-sum-user-id-withdrawal,accac570-de75-11e8-bd11-2f9252c4dc2f,AIRDROP,0
airdrop-20181115-hdac-22bdf8db-e3ff-48c7-a587-f317e0809037-withdrawal-exchange,2018.11.15 10:11,UNKNOWN,,UNKNOWN-55c0f2b7-dc24-425b-9be8-6b86719f2865,2018.11.15 10:11,UNKNOWN,0,20732.87289,0,HDAC,WITHDRAWAL,,,,0,COMPLETED,0,sum-user-id,1914857.064,airdrop-20181115-hdac-sum-user-id-withdrawal,accac570-de75-11e8-bd11-2f9252c4dc2f,AIRDROP,0
airdrop-20181115-hdac-22feb8d0-209c-47d5-997c-74c366e4ec96-withdrawal-exchange,2018-11-15 10:11:18.018,UNKNOWN,,UNKNOWN-55c0f2b7-dc24-425b-9be8-6b86719f2865,2018-11-15 10:11:18.018,UNKNOWN,0,100,0,HDAC,WITHDRAWAL,,,,0,COMPLETED,0,sum-user-id,1914757.064,airdrop-20181115-hdac-sum-user-id-withdrawal,accac570-de75-11e8-bd11-2f9252c4dc2f,AIRDROP,0
airdrop-20181115-hdac-2302b025-9c99-457e-bd93-934279e34688-withdrawal-exchange,2018-11-15 10:11:18.053,UNKNOWN,,UNKNOWN-55c0f2b7-dc24-425b-9be8-6b86719f2865,2018-11-15 10:11:18.053,UNKNOWN,0,100,0,HDAC,WITHDRAWAL,,,,0,COMPLETED,0,sum-user-id,1914657.064,airdrop-20181115-hdac-sum-user-id-withdrawal,accac570-de75-11e8-bd11-2f9252c4dc2f,AIRDROP,0
airdrop-20181115-hdac-232901b1-0dd9-47fa-856e-9409341c0715-withdrawal-exchange,2018-11-15 10:11:18.084,UNKNOWN,,UNKNOWN-55c0f2b7-dc24-425b-9be8-6b86719f2865,2018-11-15 10:11:18.084,UNKNOWN,0,100,0,HDAC,WITHDRAWAL,,,,0,COMPLETED,0,sum-user-id,1914557.064,airdrop-20181115-hdac-sum-user-id-withdrawal,accac570-de75-11e8-bd11-2f9252c4dc2f,AIRDROP,0
airdrop-20181115-hdac-233b2eb0-a72e-4c48-a286-52bc554202fa-withdrawal-exchange,2018.11.15 10:11,UNKNOWN,,UNKNOWN-55c0f2b7-dc24-425b-9be8-6b86719f2865,2018.11.15 10:11,UNKNOWN,0,100,0,HDAC,WITHDRAWAL,,,,0,COMPLETED,0,sum-user-id,1914457.064,airdrop-20181115-hdac-sum-user-id-withdrawal,accac570-de75-11e8-bd11-2f9252c4dc2f,AIRDROP,0
airdrop-20181115-hdac-234c276d-19e6-403e-9fe4-ce91ce951319-withdrawal-exchange,2018.11.15 10:11,UNKNOWN,,UNKNOWN-55c0f2b7-dc24-425b-9be8-6b86719f2865,2018.11.15 10:11,UNKNOWN,0,100,0,HDAC,WITHDRAWAL,,,,0,COMPLETED,0,sum-user-id,1914357.064,airdrop-20181115-hdac-sum-user-id-withdrawal,accac570-de75-11e8-bd11-2f9252c4dc2f,AIRDROP,0
airdrop-20181115-hdac-235ae158-cdc6-43e7-ba6b-da867ab11c3e-withdrawal-exchange,2018.11.15 10:11,UNKNOWN,,UNKNOWN-55c0f2b7-dc24-425b-9be8-6b86719f2865,2018.11.15 10:11,UNKNOWN,0,100,0,HDAC,WITHDRAWAL,,,,0,COMPLETED,0,sum-user-id,1914257.064,airdrop-20181115-hdac-sum-user-id-withdrawal,accac570-de75-11e8-bd11-2f9252c4dc2f,AIRDROP,0
airdrop-20181115-hdac-23620881-ae38-477a-a3f5-ef876de92de2-withdrawal-exchange,2018.11.15 10:11,UNKNOWN,,UNKNOWN-55c0f2b7-dc24-425b-9be8-6b86719f2865,2018.11.15 10:11,UNKNOWN,0,100,0,HDAC,WITHDRAWAL,,,,0,COMPLETED,0,sum-user-id,1914157.064,airdrop-20181115-hdac-sum-user-id-withdrawal,accac570-de75-11e8-bd11-2f9252c4dc2f,AIRDROP,0
airdrop-20181115-hdac-236c02d6-c110-4627-bbe0-80d83bc5b77d-withdrawal-exchange,2018.11.15 10:11,UNKNOWN,,UNKNOWN-55c0f2b7-dc24-425b-9be8-6b86719f2865,2018.11.15 10:11,UNKNOWN,0,100,0,HDAC,WITHDRAWAL,,,,0,COMPLETED,0,sum-user-id,1914057.064,airdrop-20181115-hdac-sum-user-id-withdrawal,accac570-de75-11e8-bd11-2f9252c4dc2f,AIRDROP,0
airdrop-20181115-hdac-236fb116-7d96-4ab4-af38-b212cea3a985-withdrawal-exchange,2018.11.15 10:11,UNKNOWN,,UNKNOWN-55c0f2b7-dc24-425b-9be8-6b86719f2865,2018.11.15 10:11,UNKNOWN,0,100,0,HDAC,WITHDRAWAL,,,,0,COMPLETED,0,sum-user-id,1913957.064,airdrop-20181115-hdac-sum-user-id-withdrawal,accac570-de75-11e8-bd11-2f9252c4dc2f,AIRDROP,0
airdrop-20181115-hdac-23b83aac-2944-4b5b-8f9c-64c4d5c28fc7-withdrawal-exchange,2018.11.15 10:11,UNKNOWN,,UNKNOWN-55c0f2b7-dc24-425b-9be8-6b86719f2865,2018.11.15 10:11,UNKNOWN,0,100,0,HDAC,WITHDRAWAL,,,,0,COMPLETED,0,sum-user-id,1913857.064,airdrop-20181115-hdac-sum-user-id-withdrawal,accac570-de75-11e8-bd11-2f9252c4dc2f,AIRDROP,0
airdrop-20181115-hdac-23c6c878-bdbf-42cb-98b2-4757ea98cf34-withdrawal-exchange,2018.11.15 10:11,UNKNOWN,,UNKNOWN-55c0f2b7-dc24-425b-9be8-6b86719f2865,2018.11.15 10:11,UNKNOWN,0,100,0,HDAC,WITHDRAWAL,,,,0,COMPLETED,0,sum-user-id,1913757.064,airdrop-20181115-hdac-sum-user-id-withdrawal,accac570-de75-11e8-bd11-2f9252c4dc2f,AIRDROP,0
airdrop-20181115-hdac-23e01177-dc0f-4140-bf5b-e9cc5a6047f3-withdrawal-exchange,2018.11.15 10:11,UNKNOWN,,UNKNOWN-55c0f2b7-dc24-425b-9be8-6b86719f2865,2018.11.15 10:11,UNKNOWN,0,100,0,HDAC,WITHDRAWAL,,,,0,COMPLETED,0,sum-user-id,1913657.064,airdrop-20181115-hdac-sum-user-id-withdrawal,accac570-de75-11e8-bd11-2f9252c4dc2f,AIRDROP,0
airdrop-20181115-hdac-24068b67-19da-4fdc-bfd6-10bed5111e6b-withdrawal-exchange,2018.11.15 10:11,UNKNOWN,,UNKNOWN-55c0f2b7-dc24-425b-9be8-6b86719f2865,2018.11.15 10:11,UNKNOWN,0,100,0,HDAC,WITHDRAWAL,,,,0,COMPLETED,0,sum-user-id,1913557.064,airdrop-20181115-hdac-sum-user-id-withdrawal,accac570-de75-11e8-bd11-2f9252c4dc2f,AIRDROP,0
airdrop-20181115-hdac-24385a22-d1dc-4b84-a385-753e96a3ecd2-withdrawal-exchange,2018.11.15 10:11,UNKNOWN,,UNKNOWN-55c0f2b7-dc24-425b-9be8-6b86719f2865,2018.11.15 10:11,UNKNOWN,0,100,0,HDAC,WITHDRAWAL,,,,0,COMPLETED,0,sum-user-id,1913457.064,airdrop-20181115-hdac-sum-user-id-withdrawal,accac570-de75-11e8-bd11-2f9252c4dc2f,AIRDROP,0
airdrop-20181115-hdac-249eabea-28d8-4096-b79f-8c294442ab9b-withdrawal-exchange,2018.11.15 10:11,UNKNOWN,,UNKNOWN-55c0f2b7-dc24-425b-9be8-6b86719f2865,2018.11.15 10:11,UNKNOWN,0,100,0,HDAC,WITHDRAWAL,,,,0,COMPLETED,0,sum-user-id,1913357.064,airdrop-20181115-hdac-sum-user-id-withdrawal,accac570-de75-11e8-bd11-2f9252c4dc2f,AIRDROP,0
airdrop-20181115-hdac-24b35e6d-ddaa-4284-bc85-7524764838a8-withdrawal-exchange,2018.11.15 10:11,UNKNOWN,,UNKNOWN-55c0f2b7-dc24-425b-9be8-6b86719f2865,2018.11.15 10:11,UNKNOWN,0,100,0,HDAC,WITHDRAWAL,,,,0,COMPLETED,0,sum-user-id,1913257.064,airdrop-20181115-hdac-sum-user-id-withdrawal,accac570-de75-11e8-bd11-2f9252c4dc2f,AIRDROP,0
airdrop-20181115-hdac-24ddacd8-4092-465c-a289-f25fe6a90ff5-withdrawal-exchange,2018.11.15 10:11,UNKNOWN,,UNKNOWN-55c0f2b7-dc24-425b-9be8-6b86719f2865,2018.11.15 10:11,UNKNOWN,0,100,0,HDAC,WITHDRAWAL,,,,0,COMPLETED,0,sum-user-id,1913157.064,airdrop-20181115-hdac-sum-user-id-withdrawal,accac570-de75-11e8-bd11-2f9252c4dc2f,AIRDROP,0
airdrop-20181115-hdac-24f09766-ce2b-40dd-8353-7d7241a2afa7-withdrawal-exchange,2018.11.15 10:11,UNKNOWN,,UNKNOWN-55c0f2b7-dc24-425b-9be8-6b86719f2865,2018.11.15 10:11,UNKNOWN,0,100,0,HDAC,WITHDRAWAL,,,,0,COMPLETED,0,sum-user-id,1913057.064,airdrop-20181115-hdac-sum-user-id-withdrawal,accac570-de75-11e8-bd11-2f9252c4dc2f,AIRDROP,0
airdrop-20181115-hdac-252088f9-1ffe-4db8-bb03-c939754b4ae8-withdrawal-exchange,2018.11.15 10:11,UNKNOWN,,UNKNOWN-55c0f2b7-dc24-425b-9be8-6b86719f2865,2018.11.15 10:11,UNKNOWN,0,100,0,HDAC,WITHDRAWAL,,,,0,COMPLETED,0,sum-user-id,1912957.064,airdrop-20181115-hdac-sum-user-id-withdrawal,accac570-de75-11e8-bd11-2f9252c4dc2f,AIRDROP,0
airdrop-20181115-hdac-257f6aa4-00ca-496d-98bb-9b651173666c-withdrawal-exchange,2018.11.15 10:11,UNKNOWN,,UNKNOWN-55c0f2b7-dc24-425b-9be8-6b86719f2865,2018.11.15 10:11,UNKNOWN,0,100,0,HDAC,WITHDRAWAL,,,,0,COMPLETED,0,sum-user-id,1912857.064,airdrop-20181115-hdac-sum-user-id-withdrawal,accac570-de75-11e8-bd11-2f9252c4dc2f,AIRDROP,0
airdrop-20181115-hdac-25991777-fac4-4890-bab9-43d1aa4c6ea9-withdrawal-exchange,2018.11.15 10:11,UNKNOWN,,UNKNOWN-55c0f2b7-dc24-425b-9be8-6b86719f2865,2018.11.15 10:11,UNKNOWN,0,100,0,HDAC,WITHDRAWAL,,,,0,COMPLETED,0,sum-user-id,1912757.064,airdrop-20181115-hdac-sum-user-id-withdrawal,accac570-de75-11e8-bd11-2f9252c4dc2f,AIRDROP,0
airdrop-20181115-hdac-25eee75b-358a-42a5-becb-62577e3904b9-withdrawal-exchange,2018.11.15 10:11,UNKNOWN,,UNKNOWN-55c0f2b7-dc24-425b-9be8-6b86719f2865,2018.11.15 10:11,UNKNOWN,0,100,0,HDAC,WITHDRAWAL,,,,0,COMPLETED,0,sum-user-id,1912657.064,airdrop-20181115-hdac-sum-user-id-withdrawal,accac570-de75-11e8-bd11-2f9252c4dc2f,AIRDROP,0
airdrop-20181115-hdac-261e849f-2391-428d-9017-4ee8bb954bd5-withdrawal-exchange,2018.11.15 10:11,UNKNOWN,,UNKNOWN-55c0f2b7-dc24-425b-9be8-6b86719f2865,2018.11.15 10:11,UNKNOWN,0,100,0,HDAC,WITHDRAWAL,,,,0,COMPLETED,0,sum-user-id,1912557.064,airdrop-20181115-hdac-sum-user-id-withdrawal,accac570-de75-11e8-bd11-2f9252c4dc2f,AIRDROP,0
airdrop-20181115-hdac-262cd433-98c0-4855-9a7c-df4542f4f10a-withdrawal-exchange,2018.11.15 10:11,UNKNOWN,,UNKNOWN-55c0f2b7-dc24-425b-9be8-6b86719f2865,2018.11.15 10:11,UNKNOWN,0,100,0,HDAC,WITHDRAWAL,,,,0,COMPLETED,0,sum-user-id,1912457.064,airdrop-20181115-hdac-sum-user-id-withdrawal,accac570-de75-11e8-bd11-2f9252c4dc2f,AIRDROP,0
airdrop-20181115-hdac-2643c68a-c96b-42a1-9e77-81ec7b938b19-withdrawal-exchange,2018.11.15 10:11,UNKNOWN,,UNKNOWN-55c0f2b7-dc24-425b-9be8-6b86719f2865,2018.11.15 10:11,UNKNOWN,0,100,0,HDAC,WITHDRAWAL,,,,0,COMPLETED,0,sum-user-id,1912357.064,airdrop-20181115-hdac-sum-user-id-withdrawal,accac570-de75-11e8-bd11-2f9252c4dc2f,AIRDROP,0
airdrop-20181115-hdac-265a4952-9616-482f-a48c-d2e09e4099dd-withdrawal-exchange,2018.11.15 10:11,UNKNOWN,,UNKNOWN-55c0f2b7-dc24-425b-9be8-6b86719f2865,2018.11.15 10:11,UNKNOWN,0,100,0,HDAC,WITHDRAWAL,,,,0,COMPLETED,0,sum-user-id,1912257.064,airdrop-20181115-hdac-sum-user-id-withdrawal,accac570-de75-11e8-bd11-2f9252c4dc2f,AIRDROP,0
airdrop-20181115-hdac-26b2871b-c946-478d-9dde-fc91b71b658c-withdrawal-exchange,2018.11.15 10:11,UNKNOWN,,UNKNOWN-55c0f2b7-dc24-425b-9be8-6b86719f2865,2018.11.15 10:11,UNKNOWN,0,100,0,HDAC,WITHDRAWAL,,,,0,COMPLETED,0,sum-user-id,1912157.064,airdrop-20181115-hdac-sum-user-id-withdrawal,accac570-de75-11e8-bd11-2f9252c4dc2f,AIRDROP,0
airdrop-20181115-hdac-26b9a12d-8974-4898-b4e9-68e6b753ac3a-withdrawal-exchange,2018.11.15 10:11,UNKNOWN,,UNKNOWN-55c0f2b7-dc24-425b-9be8-6b86719f2865,2018.11.15 10:11,UNKNOWN,0,100,0,HDAC,WITHDRAWAL,,,,0,COMPLETED,0,sum-user-id,1912057.064,airdrop-20181115-hdac-sum-user-id-withdrawal,accac570-de75-11e8-bd11-2f9252c4dc2f,AIRDROP,0
airdrop-20181115-hdac-26b9e871-b967-424c-ba10-683b06a812ed-withdrawal-exchange,2018.11.15 10:11,UNKNOWN,,UNKNOWN-55c0f2b7-dc24-425b-9be8-6b86719f2865,2018.11.15 10:11,UNKNOWN,0,100,0,HDAC,WITHDRAWAL,,,,0,COMPLETED,0,sum-user-id,1911957.064,airdrop-20181115-hdac-sum-user-id-withdrawal,accac570-de75-11e8-bd11-2f9252c4dc2f,AIRDROP,0
airdrop-20181115-hdac-26f4f1ab-b150-475a-82e9-4bdc7d197e8f-withdrawal-exchange,2018.11.15 10:11,UNKNOWN,,UNKNOWN-55c0f2b7-dc24-425b-9be8-6b86719f2865,2018.11.15 10:11,UNKNOWN,0,100,0,HDAC,WITHDRAWAL,,,,0,COMPLETED,0,sum-user-id,1911857.064,airdrop-20181115-hdac-sum-user-id-withdrawal,accac570-de75-11e8-bd11-2f9252c4dc2f,AIRDROP,0
airdrop-20181115-hdac-2715d031-72c0-42a6-97ae-c144c59dc6b7-withdrawal-exchange,2018.11.15 10:11,UNKNOWN,,UNKNOWN-55c0f2b7-dc24-425b-9be8-6b86719f2865,2018.11.15 10:11,UNKNOWN,0,100,0,HDAC,WITHDRAWAL,,,,0,COMPLETED,0,sum-user-id,1911757.064,airdrop-20181115-hdac-sum-user-id-withdrawal,accac570-de75-11e8-bd11-2f9252c4dc2f,AIRDROP,0
airdrop-20181115-hdac-272694a4-c7c7-4749-a18c-e62e8626a96d-withdrawal-exchange,2018-11-15 10:11:19.025,UNKNOWN,,UNKNOWN-55c0f2b7-dc24-425b-9be8-6b86719f2865,2018-11-15 10:11:19.025,UNKNOWN,0,100,0,HDAC,WITHDRAWAL,,,,0,COMPLETED,0,sum-user-id,1911657.064,airdrop-20181115-hdac-sum-user-id-withdrawal,accac570-de75-11e8-bd11-2f9252c4dc2f,AIRDROP,0
airdrop-20181115-hdac-272ccda1-4143-4301-95d1-d400fd55cf10-withdrawal-exchange,2018-11-15 10:11:19.053,UNKNOWN,,UNKNOWN-55c0f2b7-dc24-425b-9be8-6b86719f2865,2018-11-15 10:11:19.053,UNKNOWN,0,100,0,HDAC,WITHDRAWAL,,,,0,COMPLETED,0,sum-user-id,1911557.064,airdrop-20181115-hdac-sum-user-id-withdrawal,accac570-de75-11e8-bd11-2f9252c4dc2f,AIRDROP,0
airdrop-20181115-hdac-273fe909-59cc-41ec-b1d6-48c95e3efd98-withdrawal-exchange,2018-11-15 10:11:19.088,UNKNOWN,,UNKNOWN-55c0f2b7-dc24-425b-9be8-6b86719f2865,2018-11-15 10:11:19.088,UNKNOWN,0,100,0,HDAC,WITHDRAWAL,,,,0,COMPLETED,0,sum-user-id,1911457.064,airdrop-20181115-hdac-sum-user-id-withdrawal,accac570-de75-11e8-bd11-2f9252c4dc2f,AIRDROP,0
airdrop-20181115-hdac-27450ea0-864a-4c57-be2a-bdb1cce968d4-withdrawal-exchange,2018.11.15 10:11,UNKNOWN,,UNKNOWN-55c0f2b7-dc24-425b-9be8-6b86719f2865,2018.11.15 10:11,UNKNOWN,0,100,0,HDAC,WITHDRAWAL,,,,0,COMPLETED,0,sum-user-id,1911357.064,airdrop-20181115-hdac-sum-user-id-withdrawal,accac570-de75-11e8-bd11-2f9252c4dc2f,AIRDROP,0
airdrop-20181115-hdac-279948d9-1434-4140-b103-fb3a8617ddba-withdrawal-exchange,2018.11.15 10:11,UNKNOWN,,UNKNOWN-55c0f2b7-dc24-425b-9be8-6b86719f2865,2018.11.15 10:11,UNKNOWN,0,100,0,HDAC,WITHDRAWAL,,,,0,COMPLETED,0,sum-user-id,1911257.064,airdrop-20181115-hdac-sum-user-id-withdrawal,accac570-de75-11e8-bd11-2f9252c4dc2f,AIRDROP,0
airdrop-20181115-hdac-27ce1e44-27c5-42c4-bebf-ca8384c3e09f-withdrawal-exchange,2018.11.15 10:11,UNKNOWN,,UNKNOWN-55c0f2b7-dc24-425b-9be8-6b86719f2865,2018.11.15 10:11,UNKNOWN,0,100,0,HDAC,WITHDRAWAL,,,,0,COMPLETED,0,sum-user-id,1911157.064,airdrop-20181115-hdac-sum-user-id-withdrawal,accac570-de75-11e8-bd11-2f9252c4dc2f,AIRDROP,0
airdrop-20181115-hdac-27d2eef1-cb3c-40ba-abd7-69ac9dd8702d-withdrawal-exchange,2018.11.15 10:11,UNKNOWN,,UNKNOWN-55c0f2b7-dc24-425b-9be8-6b86719f2865,2018.11.15 10:11,UNKNOWN,0,100,0,HDAC,WITHDRAWAL,,,,0,COMPLETED,0,sum-user-id,1911057.064,airdrop-20181115-hdac-sum-user-id-withdrawal,accac570-de75-11e8-bd11-2f9252c4dc2f,AIRDROP,0
airdrop-20181115-hdac-284ff7c0-def8-4244-8a7e-e4ea0e0f880f-withdrawal-exchange,2018.11.15 10:12,UNKNOWN,,UNKNOWN-55c0f2b7-dc24-425b-9be8-6b86719f2865,2018.11.15 10:12,UNKNOWN,0,2777.717854,0,HDAC,WITHDRAWAL,,,,0,COMPLETED,0,sum-user-id,1342798.403,airdrop-20181115-hdac-sum-user-id-withdrawal,accac570-de75-11e8-bd11-2f9252c4dc2f,AIRDROP,0
airdrop-20181115-hdac-286e34e1-4bd8-46a1-8c69-539f7e9530b1-withdrawal-exchange,2018.11.15 10:11,UNKNOWN,,UNKNOWN-55c0f2b7-dc24-425b-9be8-6b86719f2865,2018.11.15 10:11,UNKNOWN,0,100,0,HDAC,WITHDRAWAL,,,,0,COMPLETED,0,sum-user-id,1910957.064,airdrop-20181115-hdac-sum-user-id-withdrawal,accac570-de75-11e8-bd11-2f9252c4dc2f,AIRDROP,0
airdrop-20181115-hdac-287344bc-7c3a-4b0c-a611-0f4d91629f26-withdrawal-exchange,2018.11.15 10:11,UNKNOWN,,UNKNOWN-55c0f2b7-dc24-425b-9be8-6b86719f2865,2018.11.15 10:11,UNKNOWN,0,100,0,HDAC,WITHDRAWAL,,,,0,COMPLETED,0,sum-user-id,1910857.064,airdrop-20181115-hdac-sum-user-id-withdrawal,accac570-de75-11e8-bd11-2f9252c4dc2f,AIRDROP,0
airdrop-20181115-hdac-287639ea-5914-4270-a148-15f836ccced7-withdrawal-exchange,2018.11.15 10:11,UNKNOWN,,UNKNOWN-55c0f2b7-dc24-425b-9be8-6b86719f2865,2018.11.15 10:11,UNKNOWN,0,100,0,HDAC,WITHDRAWAL,,,,0,COMPLETED,0,sum-user-id,1910757.064,airdrop-20181115-hdac-sum-user-id-withdrawal,accac570-de75-11e8-bd11-2f9252c4dc2f,AIRDROP,0
airdrop-20181115-hdac-2895cf94-4fd5-4488-86bb-19cb84bf2312-withdrawal-exchange,2018.11.15 10:11,UNKNOWN,,UNKNOWN-55c0f2b7-dc24-425b-9be8-6b86719f2865,2018.11.15 10:11,UNKNOWN,0,100,0,HDAC,WITHDRAWAL,,,,0,COMPLETED,0,sum-user-id,1910657.064,airdrop-20181115-hdac-sum-user-id-withdrawal,accac570-de75-11e8-bd11-2f9252c4dc2f,AIRDROP,0
airdrop-20181115-hdac-28c0371a-1a59-4360-bfdb-1ee8e0aabb37-withdrawal-exchange,2018.11.15 10:11,UNKNOWN,,UNKNOWN-55c0f2b7-dc24-425b-9be8-6b86719f2865,2018.11.15 10:11,UNKNOWN,0,100,0,HDAC,WITHDRAWAL,,,,0,COMPLETED,0,sum-user-id,1910557.064,airdrop-20181115-hdac-sum-user-id-withdrawal,accac570-de75-11e8-bd11-2f9252c4dc2f,AIRDROP,0
airdrop-20181115-hdac-28cf30ee-eed8-490f-a1c2-3a5c0238360b-withdrawal-exchange,2018.11.15 10:11,UNKNOWN,,UNKNOWN-55c0f2b7-dc24-425b-9be8-6b86719f2865,2018.11.15 10:11,UNKNOWN,0,100,0,HDAC,WITHDRAWAL,,,,0,COMPLETED,0,sum-user-id,1910457.064,airdrop-20181115-hdac-sum-user-id-withdrawal,accac570-de75-11e8-bd11-2f9252c4dc2f,AIRDROP,0
airdrop-20181115-hdac-28d54cb8-e292-4536-bc9c-0761e41a2af3-withdrawal-exchange,2018.11.15 10:11,UNKNOWN,,UNKNOWN-55c0f2b7-dc24-425b-9be8-6b86719f2865,2018.11.15 10:11,UNKNOWN,0,100,0,HDAC,WITHDRAWAL,,,,0,COMPLETED,0,sum-user-id,1910357.064,airdrop-20181115-hdac-sum-user-id-withdrawal,accac570-de75-11e8-bd11-2f9252c4dc2f,AIRDROP,0
airdrop-20181115-hdac-28e5fe24-2280-4673-aaaa-56eca596e31b-withdrawal-exchange,2018.11.15 10:11,UNKNOWN,,UNKNOWN-55c0f2b7-dc24-425b-9be8-6b86719f2865,2018.11.15 10:11,UNKNOWN,0,100,0,HDAC,WITHDRAWAL,,,,0,COMPLETED,0,sum-user-id,1910257.064,airdrop-20181115-hdac-sum-user-id-withdrawal,accac570-de75-11e8-bd11-2f9252c4dc2f,AIRDROP,0
airdrop-20181115-hdac-28ece555-3b1b-4686-ba25-b75b980c20df-withdrawal-exchange,2018.11.15 10:11,UNKNOWN,,UNKNOWN-55c0f2b7-dc24-425b-9be8-6b86719f2865,2018.11.15 10:11,UNKNOWN,0,100,0,HDAC,WITHDRAWAL,,,,0,COMPLETED,0,sum-user-id,1910157.064,airdrop-20181115-hdac-sum-user-id-withdrawal,accac570-de75-11e8-bd11-2f9252c4dc2f,AIRDROP,0
airdrop-20181115-hdac-28f803f5-d989-405d-b98f-3ef4a7f8724b-withdrawal-exchange,2018.11.15 10:11,UNKNOWN,,UNKNOWN-55c0f2b7-dc24-425b-9be8-6b86719f2865,2018.11.15 10:11,UNKNOWN,0,100,0,HDAC,WITHDRAWAL,,,,0,COMPLETED,0,sum-user-id,1910057.064,airdrop-20181115-hdac-sum-user-id-withdrawal,accac570-de75-11e8-bd11-2f9252c4dc2f,AIRDROP,0
airdrop-20181115-hdac-28fcb615-4fe3-47d6-bcf9-37d7e5ce5b7c-withdrawal-exchange,2018.11.15 10:11,UNKNOWN,,UNKNOWN-55c0f2b7-dc24-425b-9be8-6b86719f2865,2018.11.15 10:11,UNKNOWN,0,100,0,HDAC,WITHDRAWAL,,,,0,COMPLETED,0,sum-user-id,1909957.064,airdrop-20181115-hdac-sum-user-id-withdrawal,accac570-de75-11e8-bd11-2f9252c4dc2f,AIRDROP,0
airdrop-20181115-hdac-2901411e-4a47-402c-b038-d24989a7e484-withdrawal-exchange,2018.11.15 10:11,UNKNOWN,,UNKNOWN-55c0f2b7-dc24-425b-9be8-6b86719f2865,2018.11.15 10:11,UNKNOWN,0,100,0,HDAC,WITHDRAWAL,,,,0,COMPLETED,0,sum-user-id,1909857.064,airdrop-20181115-hdac-sum-user-id-withdrawal,accac570-de75-11e8-bd11-2f9252c4dc2f,AIRDROP,0
airdrop-20181115-hdac-290232bf-54b8-43b1-9823-bdac5a716733-withdrawal-exchange,2018.11.15 10:11,UNKNOWN,,UNKNOWN-55c0f2b7-dc24-425b-9be8-6b86719f2865,2018.11.15 10:11,UNKNOWN,0,100,0,HDAC,WITHDRAWAL,,,,0,COMPLETED,0,sum-user-id,1909757.064,airdrop-20181115-hdac-sum-user-id-withdrawal,accac570-de75-11e8-bd11-2f9252c4dc2f,AIRDROP,0
airdrop-20181115-hdac-292241f5-f9d0-4edb-a298-7baa0d4afff5-withdrawal-exchange,2018.11.15 10:11,UNKNOWN,,UNKNOWN-55c0f2b7-dc24-425b-9be8-6b86719f2865,2018.11.15 10:11,UNKNOWN,0,88.191176,0,HDAC,WITHDRAWAL,,,,0,COMPLETED,0,sum-user-id,1909668.873,airdrop-20181115-hdac-sum-user-id-withdrawal,accac570-de75-11e8-bd11-2f9252c4dc2f,AIRDROP,0
airdrop-20181115-hdac-2926a872-92c1-47fe-befd-c72e187019a4-withdrawal-exchange,2018.11.15 10:11,UNKNOWN,,UNKNOWN-55c0f2b7-dc24-425b-9be8-6b86719f2865,2018.11.15 10:11,UNKNOWN,0,100,0,HDAC,WITHDRAWAL,,,,0,COMPLETED,0,sum-user-id,1909568.873,airdrop-20181115-hdac-sum-user-id-withdrawal,accac570-de75-11e8-bd11-2f9252c4dc2f,AIRDROP,0
airdrop-20181115-hdac-292c0391-f265-432e-94b2-774e983faf77-withdrawal-exchange,2018.11.15 10:11,UNKNOWN,,UNKNOWN-55c0f2b7-dc24-425b-9be8-6b86719f2865,2018.11.15 10:11,UNKNOWN,0,100,0,HDAC,WITHDRAWAL,,,,0,COMPLETED,0,sum-user-id,1909468.873,airdrop-20181115-hdac-sum-user-id-withdrawal,accac570-de75-11e8-bd11-2f9252c4dc2f,AIRDROP,0
airdrop-20181115-hdac-292c7045-4550-4316-b239-7a997bb13cfb-withdrawal-exchange,2018.11.15 10:11,UNKNOWN,,UNKNOWN-55c0f2b7-dc24-425b-9be8-6b86719f2865,2018.11.15 10:11,UNKNOWN,0,100,0,HDAC,WITHDRAWAL,,,,0,COMPLETED,0,sum-user-id,1909368.873,airdrop-20181115-hdac-sum-user-id-withdrawal,accac570-de75-11e8-bd11-2f9252c4dc2f,AIRDROP,0
airdrop-20181115-hdac-29416ffa-6870-492c-b392-196ff08c7f2e-withdrawal-exchange,2018.11.15 10:11,UNKNOWN,,UNKNOWN-55c0f2b7-dc24-425b-9be8-6b86719f2865,2018.11.15 10:11,UNKNOWN,0,100,0,HDAC,WITHDRAWAL,,,,0,COMPLETED,0,sum-user-id,1909268.873,airdrop-20181115-hdac-sum-user-id-withdrawal,accac570-de75-11e8-bd11-2f9252c4dc2f,AIRDROP,0
airdrop-20181115-hdac-29565434-98e0-4730-8cd6-521648b6966d-withdrawal-exchange,2018-11-15 10:11:20.031,UNKNOWN,,UNKNOWN-55c0f2b7-dc24-425b-9be8-6b86719f2865,2018-11-15 10:11:20.031,UNKNOWN,0,100,0,HDAC,WITHDRAWAL,,,,0,COMPLETED,0,sum-user-id,1909168.873,airdrop-20181115-hdac-sum-user-id-withdrawal,accac570-de75-11e8-bd11-2f9252c4dc2f,AIRDROP,0
airdrop-20181115-hdac-297e152c-7563-4eca-bd97-9d962f4746d5-withdrawal-exchange,2018-11-15 10:11:20.064,UNKNOWN,,UNKNOWN-55c0f2b7-dc24-425b-9be8-6b86719f2865,2018-11-15 10:11:20.064,UNKNOWN,0,100,0,HDAC,WITHDRAWAL,,,,0,COMPLETED,0,sum-user-id,1909068.873,airdrop-20181115-hdac-sum-user-id-withdrawal,accac570-de75-11e8-bd11-2f9252c4dc2f,AIRDROP,0
airdrop-20181115-hdac-298e2bf8-2b67-4ee5-885c-b01f325277c8-withdrawal-exchange,2018-11-15 10:11:20.093,UNKNOWN,,UNKNOWN-55c0f2b7-dc24-425b-9be8-6b86719f2865,2018-11-15 10:11:20.093,UNKNOWN,0,100,0,HDAC,WITHDRAWAL,,,,0,COMPLETED,0,sum-user-id,1908968.873,airdrop-20181115-hdac-sum-user-id-withdrawal,accac570-de75-11e8-bd11-2f9252c4dc2f,AIRDROP,0
airdrop-20181115-hdac-29962854-6b99-4d1c-97bc-1ec177a0912b-withdrawal-exchange,2018.11.15 10:11,UNKNOWN,,UNKNOWN-55c0f2b7-dc24-425b-9be8-6b86719f2865,2018.11.15 10:11,UNKNOWN,0,100,0,HDAC,WITHDRAWAL,,,,0,COMPLETED,0,sum-user-id,1908868.873,airdrop-20181115-hdac-sum-user-id-withdrawal,accac570-de75-11e8-bd11-2f9252c4dc2f,AIRDROP,0
airdrop-20181115-hdac-299b7083-7687-4dd9-82af-625110573eec-withdrawal-exchange,2018.11.15 10:11,UNKNOWN,,UNKNOWN-55c0f2b7-dc24-425b-9be8-6b86719f2865,2018.11.15 10:11,UNKNOWN,0,100,0,HDAC,WITHDRAWAL,,,,0,COMPLETED,0,sum-user-id,1908768.873,airdrop-20181115-hdac-sum-user-id-withdrawal,accac570-de75-11e8-bd11-2f9252c4dc2f,AIRDROP,0
airdrop-20181115-hdac-29a2e12b-cf4d-4b85-8f2a-13a5874c7eea-withdrawal-exchange,2018.11.15 10:11,UNKNOWN,,UNKNOWN-55c0f2b7-dc24-425b-9be8-6b86719f2865,2018.11.15 10:11,UNKNOWN,0,100,0,HDAC,WITHDRAWAL,,,,0,COMPLETED,0,sum-user-id,1908668.873,airdrop-20181115-hdac-sum-user-id-withdrawal,accac570-de75-11e8-bd11-2f9252c4dc2f,AIRDROP,0
airdrop-20181115-hdac-29c31e06-47f7-45a7-be3a-fe6ee084a621-withdrawal-exchange,2018.11.15 10:11,UNKNOWN,,UNKNOWN-55c0f2b7-dc24-425b-9be8-6b86719f2865,2018.11.15 10:11,UNKNOWN,0,100,0,HDAC,WITHDRAWAL,,,,0,COMPLETED,0,sum-user-id,1908568.873,airdrop-20181115-hdac-sum-user-id-withdrawal,accac570-de75-11e8-bd11-2f9252c4dc2f,AIRDROP,0
airdrop-20181115-hdac-2a4737ff-9e64-4838-8679-769483f5e271-withdrawal-exchange,2018.11.15 10:11,UNKNOWN,,UNKNOWN-55c0f2b7-dc24-425b-9be8-6b86719f2865,2018.11.15 10:11,UNKNOWN,0,100,0,HDAC,WITHDRAWAL,,,,0,COMPLETED,0,sum-user-id,1908468.873,airdrop-20181115-hdac-sum-user-id-withdrawal,accac570-de75-11e8-bd11-2f9252c4dc2f,AIRDROP,0
airdrop-20181115-hdac-2a63b5b4-793b-4c41-8ec7-a0a240c47026-withdrawal-exchange,2018.11.15 10:11,UNKNOWN,,UNKNOWN-55c0f2b7-dc24-425b-9be8-6b86719f2865,2018.11.15 10:11,UNKNOWN,0,100,0,HDAC,WITHDRAWAL,,,,0,COMPLETED,0,sum-user-id,1908368.873,airdrop-20181115-hdac-sum-user-id-withdrawal,accac570-de75-11e8-bd11-2f9252c4dc2f,AIRDROP,0
airdrop-20181115-hdac-2a770ce9-34a7-438b-80a9-f8b7e63dcf79-withdrawal-exchange,2018.11.15 10:11,UNKNOWN,,UNKNOWN-55c0f2b7-dc24-425b-9be8-6b86719f2865,2018.11.15 10:11,UNKNOWN,0,100,0,HDAC,WITHDRAWAL,,,,0,COMPLETED,0,sum-user-id,1908268.873,airdrop-20181115-hdac-sum-user-id-withdrawal,accac570-de75-11e8-bd11-2f9252c4dc2f,AIRDROP,0
airdrop-20181115-hdac-2a7ab163-f14e-48f4-bf06-0ae33bb197c2-withdrawal-exchange,2018.11.15 10:12,UNKNOWN,,UNKNOWN-55c0f2b7-dc24-425b-9be8-6b86719f2865,2018.11.15 10:12,UNKNOWN,0,302.435431,0,HDAC,WITHDRAWAL,,,,0,COMPLETED,0,sum-user-id,1342495.968,airdrop-20181115-hdac-sum-user-id-withdrawal,accac570-de75-11e8-bd11-2f9252c4dc2f,AIRDROP,0
airdrop-20181115-hdac-2a8eabc5-a180-4b66-a60e-3aaa2af1f427-withdrawal-exchange,2018.11.15 10:11,UNKNOWN,,UNKNOWN-55c0f2b7-dc24-425b-9be8-6b86719f2865,2018.11.15 10:11,UNKNOWN,0,100,0,HDAC,WITHDRAWAL,,,,0,COMPLETED,0,sum-user-id,1908168.873,airdrop-20181115-hdac-sum-user-id-withdrawal,accac570-de75-11e8-bd11-2f9252c4dc2f,AIRDROP,0
airdrop-20181115-hdac-2a947567-7177-41ab-8652-b0944f2a5e07-withdrawal-exchange,2018-11-15 10:12:28.016,UNKNOWN,,UNKNOWN-55c0f2b7-dc24-425b-9be8-6b86719f2865,2018-11-15 10:12:28.016,UNKNOWN,0,10100,0,HDAC,WITHDRAWAL,,,,0,COMPLETED,0,sum-user-id,1332395.968,airdrop-20181115-hdac-sum-user-id-withdrawal,accac570-de75-11e8-bd11-2f9252c4dc2f,AIRDROP,0
airdrop-20181115-hdac-2acf809f-45f1-4af2-8aa2-5cb4f7403064-withdrawal-exchange,2018.11.15 10:11,UNKNOWN,,UNKNOWN-55c0f2b7-dc24-425b-9be8-6b86719f2865,2018.11.15 10:11,UNKNOWN,0,10.12427,0,HDAC,WITHDRAWAL,,,,0,COMPLETED,0,sum-user-id,1908158.749,airdrop-20181115-hdac-sum-user-id-withdrawal,accac570-de75-11e8-bd11-2f9252c4dc2f,AIRDROP,0
airdrop-20181115-hdac-2ae43322-8aad-429d-95ff-e6a84ad1441e-withdrawal-exchange,2018.11.15 10:11,UNKNOWN,,UNKNOWN-55c0f2b7-dc24-425b-9be8-6b86719f2865,2018.11.15 10:11,UNKNOWN,0,100,0,HDAC,WITHDRAWAL,,,,0,COMPLETED,0,sum-user-id,1908058.749,airdrop-20181115-hdac-sum-user-id-withdrawal,accac570-de75-11e8-bd11-2f9252c4dc2f,AIRDROP,0
airdrop-20181115-hdac-2ae7cbc5-9ad7-43cd-9893-7af5b7847398-withdrawal-exchange,2018.11.15 10:11,UNKNOWN,,UNKNOWN-55c0f2b7-dc24-425b-9be8-6b86719f2865,2018.11.15 10:11,UNKNOWN,0,100,0,HDAC,WITHDRAWAL,,,,0,COMPLETED,0,sum-user-id,1907958.749,airdrop-20181115-hdac-sum-user-id-withdrawal,accac570-de75-11e8-bd11-2f9252c4dc2f,AIRDROP,0
airdrop-20181115-hdac-2af1538b-2aed-4127-805d-1922855dc567-withdrawal-exchange,2018.11.15 10:11,UNKNOWN,,UNKNOWN-55c0f2b7-dc24-425b-9be8-6b86719f2865,2018.11.15 10:11,UNKNOWN,0,100,0,HDAC,WITHDRAWAL,,,,0,COMPLETED,0,sum-user-id,1907858.749,airdrop-20181115-hdac-sum-user-id-withdrawal,accac570-de75-11e8-bd11-2f9252c4dc2f,AIRDROP,0
airdrop-20181115-hdac-2b14af05-b8f0-403d-8a5e-bb6d227f9671-withdrawal-exchange,2018-11-15 10:12:28.045,UNKNOWN,,UNKNOWN-55c0f2b7-dc24-425b-9be8-6b86719f2865,2018-11-15 10:12:28.045,UNKNOWN,0,132.303422,0,HDAC,WITHDRAWAL,,,,0,COMPLETED,0,sum-user-id,1332263.664,airdrop-20181115-hdac-sum-user-id-withdrawal,accac570-de75-11e8-bd11-2f9252c4dc2f,AIRDROP,0
airdrop-20181115-hdac-2b1bf009-b465-42a2-8791-3cc7b71ac05a-withdrawal-exchange,2018.11.15 10:11,UNKNOWN,,UNKNOWN-55c0f2b7-dc24-425b-9be8-6b86719f2865,2018.11.15 10:11,UNKNOWN,0,100,0,HDAC,WITHDRAWAL,,,,0,COMPLETED,0,sum-user-id,1907758.749,airdrop-20181115-hdac-sum-user-id-withdrawal,accac570-de75-11e8-bd11-2f9252c4dc2f,AIRDROP,0
airdrop-20181115-hdac-2b346106-e2dd-43ea-b171-f95dc17281d3-withdrawal-exchange,2018.11.15 10:11,UNKNOWN,,UNKNOWN-55c0f2b7-dc24-425b-9be8-6b86719f2865,2018.11.15 10:11,UNKNOWN,0,100,0,HDAC,WITHDRAWAL,,,,0,COMPLETED,0,sum-user-id,1907658.749,airdrop-20181115-hdac-sum-user-id-withdrawal,accac570-de75-11e8-bd11-2f9252c4dc2f,AIRDROP,0
airdrop-20181115-hdac-2b451b82-14d5-42a1-970b-d4afae0a59cd-withdrawal-exchange,2018-11-15 10:12:28.072,UNKNOWN,,UNKNOWN-55c0f2b7-dc24-425b-9be8-6b86719f2865,2018-11-15 10:12:28.072,UNKNOWN,0,10100,0,HDAC,WITHDRAWAL,,,,0,COMPLETED,0,sum-user-id,1322163.664,airdrop-20181115-hdac-sum-user-id-withdrawal,accac570-de75-11e8-bd11-2f9252c4dc2f,AIRDROP,0
airdrop-20181115-hdac-2b489bab-19b1-48aa-ba67-667272dfb54d-withdrawal-exchange,2018.11.15 10:11,UNKNOWN,,UNKNOWN-55c0f2b7-dc24-425b-9be8-6b86719f2865,2018.11.15 10:11,UNKNOWN,0,100,0,HDAC,WITHDRAWAL,,,,0,COMPLETED,0,sum-user-id,1907558.749,airdrop-20181115-hdac-sum-user-id-withdrawal,accac570-de75-11e8-bd11-2f9252c4dc2f,AIRDROP,0
airdrop-20181115-hdac-2b72271f-972f-433d-b8a3-e3cff1e403d9-withdrawal-exchange,2018.11.15 10:11,UNKNOWN,,UNKNOWN-55c0f2b7-dc24-425b-9be8-6b86719f2865,2018.11.15 10:11,UNKNOWN,0,100,0,HDAC,WITHDRAWAL,,,,0,COMPLETED,0,sum-user-id,1907458.749,airdrop-20181115-hdac-sum-user-id-withdrawal,accac570-de75-11e8-bd11-2f9252c4dc2f,AIRDROP,0
airdrop-20181115-hdac-2bb303e8-e2f0-476b-85f8-ed2610a31a13-withdrawal-exchange,2018.11.15 10:11,UNKNOWN,,UNKNOWN-55c0f2b7-dc24-425b-9be8-6b86719f2865,2018.11.15 10:11,UNKNOWN,0,100,0,HDAC,WITHDRAWAL,,,,0,COMPLETED,0,sum-user-id,1907358.749,airdrop-20181115-hdac-sum-user-id-withdrawal,accac570-de75-11e8-bd11-2f9252c4dc2f,AIRDROP,0
airdrop-20181115-hdac-2bc07d40-db7c-4c04-9e0c-96c9708db7e0-withdrawal-exchange,2018.11.15 10:11,UNKNOWN,,UNKNOWN-55c0f2b7-dc24-425b-9be8-6b86719f2865,2018.11.15 10:11,UNKNOWN,0,100,0,HDAC,WITHDRAWAL,,,,0,COMPLETED,0,sum-user-id,1907258.749,airdrop-20181115-hdac-sum-user-id-withdrawal,accac570-de75-11e8-bd11-2f9252c4dc2f,AIRDROP,0
airdrop-20181115-hdac-2bcbc015-eff5-4d47-ad5c-d742422e8a6c-withdrawal-exchange,2018.11.15 10:11,UNKNOWN,,UNKNOWN-55c0f2b7-dc24-425b-9be8-6b86719f2865,2018.11.15 10:11,UNKNOWN,0,100,0,HDAC,WITHDRAWAL,,,,0,COMPLETED,0,sum-user-id,1907158.749,airdrop-20181115-hdac-sum-user-id-withdrawal,accac570-de75-11e8-bd11-2f9252c4dc2f,AIRDROP,0
airdrop-20181115-hdac-2bd3e53d-6177-4fe1-94d6-d9d264e2bc4d-withdrawal-exchange,2018.11.15 10:11,UNKNOWN,,UNKNOWN-55c0f2b7-dc24-425b-9be8-6b86719f2865,2018.11.15 10:11,UNKNOWN,0,100,0,HDAC,WITHDRAWAL,,,,0,COMPLETED,0,sum-user-id,1907058.749,airdrop-20181115-hdac-sum-user-id-withdrawal,accac570-de75-11e8-bd11-2f9252c4dc2f,AIRDROP,0
airdrop-20181115-hdac-2be9f00a-9246-41f2-936e-2ada9c35977f-withdrawal-exchange,2018.11.15 10:11,UNKNOWN,,UNKNOWN-55c0f2b7-dc24-425b-9be8-6b86719f2865,2018.11.15 10:11,UNKNOWN,0,100,0,HDAC,WITHDRAWAL,,,,0,COMPLETED,0,sum-user-id,1906958.749,airdrop-20181115-hdac-sum-user-id-withdrawal,accac570-de75-11e8-bd11-2f9252c4dc2f,AIRDROP,0
airdrop-20181115-hdac-2bec488f-ceda-4634-a3ca-6bf374bfec76-withdrawal-exchange,2018.11.15 10:11,UNKNOWN,,UNKNOWN-55c0f2b7-dc24-425b-9be8-6b86719f2865,2018.11.15 10:11,UNKNOWN,0,100,0,HDAC,WITHDRAWAL,,,,0,COMPLETED,0,sum-user-id,1906858.749,airdrop-20181115-hdac-sum-user-id-withdrawal,accac570-de75-11e8-bd11-2f9252c4dc2f,AIRDROP,0
airdrop-20181115-hdac-2c0ae488-1b70-4521-84c1-b2bcbb2a9016-withdrawal-exchange,2018.11.15 10:11,UNKNOWN,,UNKNOWN-55c0f2b7-dc24-425b-9be8-6b86719f2865,2018.11.15 10:11,UNKNOWN,0,100,0,HDAC,WITHDRAWAL,,,,0,COMPLETED,0,sum-user-id,1906758.749,airdrop-20181115-hdac-sum-user-id-withdrawal,accac570-de75-11e8-bd11-2f9252c4dc2f,AIRDROP,0
airdrop-20181115-hdac-2c163218-b736-444c-af74-c32764384004-withdrawal-exchange,2018.11.15 10:11,UNKNOWN,,UNKNOWN-55c0f2b7-dc24-425b-9be8-6b86719f2865,2018.11.15 10:11,UNKNOWN,0,100,0,HDAC,WITHDRAWAL,,,,0,COMPLETED,0,sum-user-id,1906658.749,airdrop-20181115-hdac-sum-user-id-withdrawal,accac570-de75-11e8-bd11-2f9252c4dc2f,AIRDROP,0
airdrop-20181115-hdac-2c30a39a-fe66-4e58-b23e-77439120adf5-withdrawal-exchange,2018.11.15 10:11,UNKNOWN,,UNKNOWN-55c0f2b7-dc24-425b-9be8-6b86719f2865,2018.11.15 10:11,UNKNOWN,0,100,0,HDAC,WITHDRAWAL,,,,0,COMPLETED,0,sum-user-id,1906558.749,airdrop-20181115-hdac-sum-user-id-withdrawal,accac570-de75-11e8-bd11-2f9252c4dc2f,AIRDROP,0
airdrop-20181115-hdac-2c30c313-3151-4104-818e-d9742d1aad31-withdrawal-exchange,2018.11.15 10:11,UNKNOWN,,UNKNOWN-55c0f2b7-dc24-425b-9be8-6b86719f2865,2018.11.15 10:11,UNKNOWN,0,100,0,HDAC,WITHDRAWAL,,,,0,COMPLETED,0,sum-user-id,1906458.749,airdrop-20181115-hdac-sum-user-id-withdrawal,accac570-de75-11e8-bd11-2f9252c4dc2f,AIRDROP,0
airdrop-20181115-hdac-2c4cbe03-1d39-4aa8-86f5-67583cca6e6c-withdrawal-exchange,2018.11.15 10:11,UNKNOWN,,UNKNOWN-55c0f2b7-dc24-425b-9be8-6b86719f2865,2018.11.15 10:11,UNKNOWN,0,100,0,HDAC,WITHDRAWAL,,,,0,COMPLETED,0,sum-user-id,1906358.749,airdrop-20181115-hdac-sum-user-id-withdrawal,accac570-de75-11e8-bd11-2f9252c4dc2f,AIRDROP,0
airdrop-20181115-hdac-2cb78848-aed3-4f2c-ac13-c6602e93cc45-withdrawal-exchange,2018.11.15 10:11,UNKNOWN,,UNKNOWN-55c0f2b7-dc24-425b-9be8-6b86719f2865,2018.11.15 10:11,UNKNOWN,0,100,0,HDAC,WITHDRAWAL,,,,0,COMPLETED,0,sum-user-id,1906258.749,airdrop-20181115-hdac-sum-user-id-withdrawal,accac570-de75-11e8-bd11-2f9252c4dc2f,AIRDROP,0
airdrop-20181115-hdac-2cba72ef-36a7-413e-b64b-d75fc55ed51e-withdrawal-exchange,2018-11-15 10:11:21.032,UNKNOWN,,UNKNOWN-55c0f2b7-dc24-425b-9be8-6b86719f2865,2018-11-15 10:11:21.032,UNKNOWN,0,100,0,HDAC,WITHDRAWAL,,,,0,COMPLETED,0,sum-user-id,1906158.749,airdrop-20181115-hdac-sum-user-id-withdrawal,accac570-de75-11e8-bd11-2f9252c4dc2f,AIRDROP,0
airdrop-20181115-hdac-2d04dd92-0cb1-4c30-80f0-9e6e0175c57c-withdrawal-exchange,2018-11-15 10:11:21.066,UNKNOWN,,UNKNOWN-55c0f2b7-dc24-425b-9be8-6b86719f2865,2018-11-15 10:11:21.066,UNKNOWN,0,100,0,HDAC,WITHDRAWAL,,,,0,COMPLETED,0,sum-user-id,1906058.749,airdrop-20181115-hdac-sum-user-id-withdrawal,accac570-de75-11e8-bd11-2f9252c4dc2f,AIRDROP,0
airdrop-20181115-hdac-2d4f9158-3b65-45f0-a913-8eafea35a41e-withdrawal-exchange,2018-11-15 10:11:21.098,UNKNOWN,,UNKNOWN-55c0f2b7-dc24-425b-9be8-6b86719f2865,2018-11-15 10:11:21.098,UNKNOWN,0,100,0,HDAC,WITHDRAWAL,,,,0,COMPLETED,0,sum-user-id,1905958.749,airdrop-20181115-hdac-sum-user-id-withdrawal,accac570-de75-11e8-bd11-2f9252c4dc2f,AIRDROP,0
airdrop-20181115-hdac-2d53ef6a-5858-442b-80ed-bfe4f1d5434a-withdrawal-exchange,2018.11.15 10:11,UNKNOWN,,UNKNOWN-55c0f2b7-dc24-425b-9be8-6b86719f2865,2018.11.15 10:11,UNKNOWN,0,100,0,HDAC,WITHDRAWAL,,,,0,COMPLETED,0,sum-user-id,1905858.749,airdrop-20181115-hdac-sum-user-id-withdrawal,accac570-de75-11e8-bd11-2f9252c4dc2f,AIRDROP,0
airdrop-20181115-hdac-2d72fe09-cf64-4616-929b-620807645ebb-withdrawal-exchange,2018.11.15 10:11,UNKNOWN,,UNKNOWN-55c0f2b7-dc24-425b-9be8-6b86719f2865,2018.11.15 10:11,UNKNOWN,0,100,0,HDAC,WITHDRAWAL,,,,0,COMPLETED,0,sum-user-id,1905758.749,airdrop-20181115-hdac-sum-user-id-withdrawal,accac570-de75-11e8-bd11-2f9252c4dc2f,AIRDROP,0
airdrop-20181115-hdac-2d7f2fc1-90ec-4493-99de-80f352c7c619-withdrawal-exchange,2018.11.15 10:11,UNKNOWN,,UNKNOWN-55c0f2b7-dc24-425b-9be8-6b86719f2865,2018.11.15 10:11,UNKNOWN,0,100,0,HDAC,WITHDRAWAL,,,,0,COMPLETED,0,sum-user-id,1905658.749,airdrop-20181115-hdac-sum-user-id-withdrawal,accac570-de75-11e8-bd11-2f9252c4dc2f,AIRDROP,0
airdrop-20181115-hdac-2dae9613-9772-42d7-9585-8ce4e8df3aea-withdrawal-exchange,2018.11.15 10:12,UNKNOWN,,UNKNOWN-55c0f2b7-dc24-425b-9be8-6b86719f2865,2018.11.15 10:12,UNKNOWN,0,111.56,0,HDAC,WITHDRAWAL,,,,0,COMPLETED,0,sum-user-id,1322052.104,airdrop-20181115-hdac-sum-user-id-withdrawal,accac570-de75-11e8-bd11-2f9252c4dc2f,AIRDROP,0
airdrop-20181115-hdac-2db37331-f441-4837-8b41-121d9bd62727-withdrawal-exchange,2018.11.15 10:11,UNKNOWN,,UNKNOWN-55c0f2b7-dc24-425b-9be8-6b86719f2865,2018.11.15 10:11,UNKNOWN,0,100,0,HDAC,WITHDRAWAL,,,,0,COMPLETED,0,sum-user-id,1905558.749,airdrop-20181115-hdac-sum-user-id-withdrawal,accac570-de75-11e8-bd11-2f9252c4dc2f,AIRDROP,0
airdrop-20181115-hdac-2dc4930f-bfc8-460e-b031-3f37b636471b-withdrawal-exchange,2018.11.15 10:11,UNKNOWN,,UNKNOWN-55c0f2b7-dc24-425b-9be8-6b86719f2865,2018.11.15 10:11,UNKNOWN,0,100,0,HDAC,WITHDRAWAL,,,,0,COMPLETED,0,sum-user-id,1905458.749,airdrop-20181115-hdac-sum-user-id-withdrawal,accac570-de75-11e8-bd11-2f9252c4dc2f,AIRDROP,0
airdrop-20181115-hdac-2dd037ab-d6f2-4fbd-a054-2d3639c83408-withdrawal-exchange,2018.11.15 10:11,UNKNOWN,,UNKNOWN-55c0f2b7-dc24-425b-9be8-6b86719f2865,2018.11.15 10:11,UNKNOWN,0,100,0,HDAC,WITHDRAWAL,,,,0,COMPLETED,0,sum-user-id,1905358.749,airdrop-20181115-hdac-sum-user-id-withdrawal,accac570-de75-11e8-bd11-2f9252c4dc2f,AIRDROP,0
airdrop-20181115-hdac-2dd78c7b-ea84-4c30-9080-38cad82c58ed-withdrawal-exchange,2018.11.15 10:11,UNKNOWN,,UNKNOWN-55c0f2b7-dc24-425b-9be8-6b86719f2865,2018.11.15 10:11,UNKNOWN,0,100,0,HDAC,WITHDRAWAL,,,,0,COMPLETED,0,sum-user-id,1905258.749,airdrop-20181115-hdac-sum-user-id-withdrawal,accac570-de75-11e8-bd11-2f9252c4dc2f,AIRDROP,0
airdrop-20181115-hdac-2de03a2b-28b4-46ce-bde7-41f76db842e0-withdrawal-exchange,2018.11.15 10:11,UNKNOWN,,UNKNOWN-55c0f2b7-dc24-425b-9be8-6b86719f2865,2018.11.15 10:11,UNKNOWN,0,100,0,HDAC,WITHDRAWAL,,,,0,COMPLETED,0,sum-user-id,1905158.749,airdrop-20181115-hdac-sum-user-id-withdrawal,accac570-de75-11e8-bd11-2f9252c4dc2f,AIRDROP,0
airdrop-20181115-hdac-2e2b81ae-6474-4528-b12c-89c73823801d-withdrawal-exchange,2018.11.15 10:11,UNKNOWN,,UNKNOWN-55c0f2b7-dc24-425b-9be8-6b86719f2865,2018.11.15 10:11,UNKNOWN,0,100,0,HDAC,WITHDRAWAL,,,,0,COMPLETED,0,sum-user-id,1905058.749,airdrop-20181115-hdac-sum-user-id-withdrawal,accac570-de75-11e8-bd11-2f9252c4dc2f,AIRDROP,0
airdrop-20181115-hdac-2e5ab0bb-ddae-4baf-95bc-49a9f40f99a0-withdrawal-exchange,2018.11.15 10:11,UNKNOWN,,UNKNOWN-55c0f2b7-dc24-425b-9be8-6b86719f2865,2018.11.15 10:11,UNKNOWN,0,100,0,HDAC,WITHDRAWAL,,,,0,COMPLETED,0,sum-user-id,1904958.749,airdrop-20181115-hdac-sum-user-id-withdrawal,accac570-de75-11e8-bd11-2f9252c4dc2f,AIRDROP,0
airdrop-20181115-hdac-2e8f770c-740c-447f-aaa5-7732f6019c78-withdrawal-exchange,2018.11.15 10:11,UNKNOWN,,UNKNOWN-55c0f2b7-dc24-425b-9be8-6b86719f2865,2018.11.15 10:11,UNKNOWN,0,100,0,HDAC,WITHDRAWAL,,,,0,COMPLETED,0,sum-user-id,1904858.749,airdrop-20181115-hdac-sum-user-id-withdrawal,accac570-de75-11e8-bd11-2f9252c4dc2f,AIRDROP,0
airdrop-20181115-hdac-2e9f677a-ffd6-4380-9f05-2240492da287-withdrawal-exchange,2018.11.15 10:11,UNKNOWN,,UNKNOWN-55c0f2b7-dc24-425b-9be8-6b86719f2865,2018.11.15 10:11,UNKNOWN,0,100,0,HDAC,WITHDRAWAL,,,,0,COMPLETED,0,sum-user-id,1904758.749,airdrop-20181115-hdac-sum-user-id-withdrawal,accac570-de75-11e8-bd11-2f9252c4dc2f,AIRDROP,0
airdrop-20181115-hdac-2ea71476-d7f0-4f94-ab61-c6484e5c2172-withdrawal-exchange,2018.11.15 10:11,UNKNOWN,,UNKNOWN-55c0f2b7-dc24-425b-9be8-6b86719f2865,2018.11.15 10:11,UNKNOWN,0,100,0,HDAC,WITHDRAWAL,,,,0,COMPLETED,0,sum-user-id,1904658.749,airdrop-20181115-hdac-sum-user-id-withdrawal,accac570-de75-11e8-bd11-2f9252c4dc2f,AIRDROP,0
airdrop-20181115-hdac-2eae1da8-3172-424f-8c5f-c372c9d5219c-withdrawal-exchange,2018.11.15 10:11,UNKNOWN,,UNKNOWN-55c0f2b7-dc24-425b-9be8-6b86719f2865,2018.11.15 10:11,UNKNOWN,0,100,0,HDAC,WITHDRAWAL,,,,0,COMPLETED,0,sum-user-id,1904558.749,airdrop-20181115-hdac-sum-user-id-withdrawal,accac570-de75-11e8-bd11-2f9252c4dc2f,AIRDROP,0
airdrop-20181115-hdac-2eb71cf8-6a60-481d-b08d-7001511674b6-withdrawal-exchange,2018.11.15 10:11,UNKNOWN,,UNKNOWN-55c0f2b7-dc24-425b-9be8-6b86719f2865,2018.11.15 10:11,UNKNOWN,0,100,0,HDAC,WITHDRAWAL,,,,0,COMPLETED,0,sum-user-id,1904458.749,airdrop-20181115-hdac-sum-user-id-withdrawal,accac570-de75-11e8-bd11-2f9252c4dc2f,AIRDROP,0
airdrop-20181115-hdac-2ec9c701-4325-42a1-a92d-a2237adb72f8-withdrawal-exchange,2018.11.15 10:11,UNKNOWN,,UNKNOWN-55c0f2b7-dc24-425b-9be8-6b86719f2865,2018.11.15 10:11,UNKNOWN,0,100,0,HDAC,WITHDRAWAL,,,,0,COMPLETED,0,sum-user-id,1904358.749,airdrop-20181115-hdac-sum-user-id-withdrawal,accac570-de75-11e8-bd11-2f9252c4dc2f,AIRDROP,0
airdrop-20181115-hdac-2edee504-c4b2-4954-bf77-350f34c200be-withdrawal-exchange,2018.11.15 10:11,UNKNOWN,,UNKNOWN-55c0f2b7-dc24-425b-9be8-6b86719f2865,2018.11.15 10:11,UNKNOWN,0,100,0,HDAC,WITHDRAWAL,,,,0,COMPLETED,0,sum-user-id,1904258.749,airdrop-20181115-hdac-sum-user-id-withdrawal,accac570-de75-11e8-bd11-2f9252c4dc2f,AIRDROP,0
airdrop-20181115-hdac-2f18243d-9d7c-4885-8939-b6488a5fd98e-withdrawal-exchange,2018.11.15 10:11,UNKNOWN,,UNKNOWN-55c0f2b7-dc24-425b-9be8-6b86719f2865,2018.11.15 10:11,UNKNOWN,0,100,0,HDAC,WITHDRAWAL,,,,0,COMPLETED,0,sum-user-id,1904158.749,airdrop-20181115-hdac-sum-user-id-withdrawal,accac570-de75-11e8-bd11-2f9252c4dc2f,AIRDROP,0
airdrop-20181115-hdac-2f201566-512c-476a-8a38-79093bb1e6e5-withdrawal-exchange,2018.11.15 10:11,UNKNOWN,,UNKNOWN-55c0f2b7-dc24-425b-9be8-6b86719f2865,2018.11.15 10:11,UNKNOWN,0,100,0,HDAC,WITHDRAWAL,,,,0,COMPLETED,0,sum-user-id,1904058.749,airdrop-20181115-hdac-sum-user-id-withdrawal,accac570-de75-11e8-bd11-2f9252c4dc2f,AIRDROP,0
airdrop-20181115-hdac-2f295989-41f6-4719-bfc1-a8ecca76101b-withdrawal-exchange,2018.11.15 10:11,UNKNOWN,,UNKNOWN-55c0f2b7-dc24-425b-9be8-6b86719f2865,2018.11.15 10:11,UNKNOWN,0,100,0,HDAC,WITHDRAWAL,,,,0,COMPLETED,0,sum-user-id,1903958.749,airdrop-20181115-hdac-sum-user-id-withdrawal,accac570-de75-11e8-bd11-2f9252c4dc2f,AIRDROP,0
airdrop-20181115-hdac-2f312e74-6f93-45ba-91f0-c857f5d6b402-withdrawal-exchange,2018.11.15 10:11,UNKNOWN,,UNKNOWN-55c0f2b7-dc24-425b-9be8-6b86719f2865,2018.11.15 10:11,UNKNOWN,0,100,0,HDAC,WITHDRAWAL,,,,0,COMPLETED,0,sum-user-id,1903858.749,airdrop-20181115-hdac-sum-user-id-withdrawal,accac570-de75-11e8-bd11-2f9252c4dc2f,AIRDROP,0
airdrop-20181115-hdac-2f347660-6b8f-41b0-91e2-9fea1dd4a347-withdrawal-exchange,2018.11.15 10:11,UNKNOWN,,UNKNOWN-55c0f2b7-dc24-425b-9be8-6b86719f2865,2018.11.15 10:11,UNKNOWN,0,100,0,HDAC,WITHDRAWAL,,,,0,COMPLETED,0,sum-user-id,1903758.749,airdrop-20181115-hdac-sum-user-id-withdrawal,accac570-de75-11e8-bd11-2f9252c4dc2f,AIRDROP,0
airdrop-20181115-hdac-2f3eccf3-6230-4e1f-a368-19c011c71d92-withdrawal-exchange,2018.11.15 10:11,UNKNOWN,,UNKNOWN-55c0f2b7-dc24-425b-9be8-6b86719f2865,2018.11.15 10:11,UNKNOWN,0,100,0,HDAC,WITHDRAWAL,,,,0,COMPLETED,0,sum-user-id,1903658.749,airdrop-20181115-hdac-sum-user-id-withdrawal,accac570-de75-11e8-bd11-2f9252c4dc2f,AIRDROP,0
airdrop-20181115-hdac-2f47fa57-dce8-4d46-bb50-00f6db378623-withdrawal-exchange,2018.11.15 10:11,UNKNOWN,,UNKNOWN-55c0f2b7-dc24-425b-9be8-6b86719f2865,2018.11.15 10:11,UNKNOWN,0,100,0,HDAC,WITHDRAWAL,,,,0,COMPLETED,0,sum-user-id,1903558.749,airdrop-20181115-hdac-sum-user-id-withdrawal,accac570-de75-11e8-bd11-2f9252c4dc2f,AIRDROP,0
airdrop-20181115-hdac-2f6e3422-fb42-472e-8ce3-1cfb9ccc27ab-withdrawal-exchange,2018.11.15 10:11,UNKNOWN,,UNKNOWN-55c0f2b7-dc24-425b-9be8-6b86719f2865,2018.11.15 10:11,UNKNOWN,0,100,0,HDAC,WITHDRAWAL,,,,0,COMPLETED,0,sum-user-id,1903458.749,airdrop-20181115-hdac-sum-user-id-withdrawal,accac570-de75-11e8-bd11-2f9252c4dc2f,AIRDROP,0
airdrop-20181115-hdac-2fb06e7c-9432-408c-9429-0bc910586ad1-withdrawal-exchange,2018.11.15 10:11,UNKNOWN,,UNKNOWN-55c0f2b7-dc24-425b-9be8-6b86719f2865,2018.11.15 10:11,UNKNOWN,0,100,0,HDAC,WITHDRAWAL,,,,0,COMPLETED,0,sum-user-id,1903358.749,airdrop-20181115-hdac-sum-user-id-withdrawal,accac570-de75-11e8-bd11-2f9252c4dc2f,AIRDROP,0
airdrop-20181115-hdac-2fb16151-c1c9-4e54-9773-1e5873e3848b-withdrawal-exchange,2018.11.15 10:11,UNKNOWN,,UNKNOWN-55c0f2b7-dc24-425b-9be8-6b86719f2865,2018.11.15 10:11,UNKNOWN,0,100,0,HDAC,WITHDRAWAL,,,,0,COMPLETED,0,sum-user-id,1903258.749,airdrop-20181115-hdac-sum-user-id-withdrawal,accac570-de75-11e8-bd11-2f9252c4dc2f,AIRDROP,0
airdrop-20181115-hdac-2fb8eab5-0dd5-4ddc-b43f-1f7ac8be6521-withdrawal-exchange,2018-11-15 10:11:22.020,UNKNOWN,,UNKNOWN-55c0f2b7-dc24-425b-9be8-6b86719f2865,2018-11-15 10:11:22.020,UNKNOWN,0,100,0,HDAC,WITHDRAWAL,,,,0,COMPLETED,0,sum-user-id,1903158.749,airdrop-20181115-hdac-sum-user-id-withdrawal,accac570-de75-11e8-bd11-2f9252c4dc2f,AIRDROP,0
airdrop-20181115-hdac-2fc2dbd2-c046-420b-abff-005518125a49-withdrawal-exchange,2018-11-15 10:11:22.053,UNKNOWN,,UNKNOWN-55c0f2b7-dc24-425b-9be8-6b86719f2865,2018-11-15 10:11:22.053,UNKNOWN,0,100,0,HDAC,WITHDRAWAL,,,,0,COMPLETED,0,sum-user-id,1903058.749,airdrop-20181115-hdac-sum-user-id-withdrawal,accac570-de75-11e8-bd11-2f9252c4dc2f,AIRDROP,0
airdrop-20181115-hdac-2fcbb517-80fa-4d78-9a5c-ee2044d19696-withdrawal-exchange,2018-11-15 10:11:22.084,UNKNOWN,,UNKNOWN-55c0f2b7-dc24-425b-9be8-6b86719f2865,2018-11-15 10:11:22.084,UNKNOWN,0,100,0,HDAC,WITHDRAWAL,,,,0,COMPLETED,0,sum-user-id,1902958.749,airdrop-20181115-hdac-sum-user-id-withdrawal,accac570-de75-11e8-bd11-2f9252c4dc2f,AIRDROP,0
airdrop-20181115-hdac-2fd11b89-bcb1-41bd-88aa-c7b33382cf5d-withdrawal-exchange,2018.11.15 10:11,UNKNOWN,,UNKNOWN-55c0f2b7-dc24-425b-9be8-6b86719f2865,2018.11.15 10:11,UNKNOWN,0,100,0,HDAC,WITHDRAWAL,,,,0,COMPLETED,0,sum-user-id,1902858.749,airdrop-20181115-hdac-sum-user-id-withdrawal,accac570-de75-11e8-bd11-2f9252c4dc2f,AIRDROP,0
airdrop-20181115-hdac-2fd25460-5c95-43c2-be76-95a6cb900f51-withdrawal-exchange,2018.11.15 10:11,UNKNOWN,,UNKNOWN-55c0f2b7-dc24-425b-9be8-6b86719f2865,2018.11.15 10:11,UNKNOWN,0,100,0,HDAC,WITHDRAWAL,,,,0,COMPLETED,0,sum-user-id,1902758.749,airdrop-20181115-hdac-sum-user-id-withdrawal,accac570-de75-11e8-bd11-2f9252c4dc2f,AIRDROP,0
airdrop-20181115-hdac-2fd37fd7-27ee-42d7-8e33-ae2f4b89471c-withdrawal-exchange,2018.11.15 10:11,UNKNOWN,,UNKNOWN-55c0f2b7-dc24-425b-9be8-6b86719f2865,2018.11.15 10:11,UNKNOWN,0,100,0,HDAC,WITHDRAWAL,,,,0,COMPLETED,0,sum-user-id,1902658.749,airdrop-20181115-hdac-sum-user-id-withdrawal,accac570-de75-11e8-bd11-2f9252c4dc2f,AIRDROP,0
airdrop-20181115-hdac-2fd5f5e2-56bb-40d8-bb52-9f4d4371f7de-withdrawal-exchange,2018.11.15 10:11,UNKNOWN,,UNKNOWN-55c0f2b7-dc24-425b-9be8-6b86719f2865,2018.11.15 10:11,UNKNOWN,0,100,0,HDAC,WITHDRAWAL,,,,0,COMPLETED,0,sum-user-id,1902558.749,airdrop-20181115-hdac-sum-user-id-withdrawal,accac570-de75-11e8-bd11-2f9252c4dc2f,AIRDROP,0
airdrop-20181115-hdac-2fe8c68a-c795-4544-b8cb-fc58b864b0ca-withdrawal-exchange,2018.11.15 10:11,UNKNOWN,,UNKNOWN-55c0f2b7-dc24-425b-9be8-6b86719f2865,2018.11.15 10:11,UNKNOWN,0,100,0,HDAC,WITHDRAWAL,,,,0,COMPLETED,0,sum-user-id,1902458.749,airdrop-20181115-hdac-sum-user-id-withdrawal,accac570-de75-11e8-bd11-2f9252c4dc2f,AIRDROP,0
airdrop-20181115-hdac-2ffb7a31-bce0-45de-beac-b89b31b57a73-withdrawal-exchange,2018.11.15 10:11,UNKNOWN,,UNKNOWN-55c0f2b7-dc24-425b-9be8-6b86719f2865,2018.11.15 10:11,UNKNOWN,0,100,0,HDAC,WITHDRAWAL,,,,0,COMPLETED,0,sum-user-id,1902358.749,airdrop-20181115-hdac-sum-user-id-withdrawal,accac570-de75-11e8-bd11-2f9252c4dc2f,AIRDROP,0
airdrop-20181115-hdac-2fff81cd-a5ae-48e0-9be9-6743cf43d145-withdrawal-exchange,2018.11.15 10:11,UNKNOWN,,UNKNOWN-55c0f2b7-dc24-425b-9be8-6b86719f2865,2018.11.15 10:11,UNKNOWN,0,100,0,HDAC,WITHDRAWAL,,,,0,COMPLETED,0,sum-user-id,1902258.749,airdrop-20181115-hdac-sum-user-id-withdrawal,accac570-de75-11e8-bd11-2f9252c4dc2f,AIRDROP,0
airdrop-20181115-hdac-300e415a-cdf2-458a-9355-88380b0e3246-withdrawal-exchange,2018.11.15 10:11,UNKNOWN,,UNKNOWN-55c0f2b7-dc24-425b-9be8-6b86719f2865,2018.11.15 10:11,UNKNOWN,0,100,0,HDAC,WITHDRAWAL,,,,0,COMPLETED,0,sum-user-id,1902158.749,airdrop-20181115-hdac-sum-user-id-withdrawal,accac570-de75-11e8-bd11-2f9252c4dc2f,AIRDROP,0
airdrop-20181115-hdac-3019282f-b3da-4151-afc5-563b0766a835-withdrawal-exchange,2018.11.15 10:11,UNKNOWN,,UNKNOWN-55c0f2b7-dc24-425b-9be8-6b86719f2865,2018.11.15 10:11,UNKNOWN,0,100,0,HDAC,WITHDRAWAL,,,,0,COMPLETED,0,sum-user-id,1902058.749,airdrop-20181115-hdac-sum-user-id-withdrawal,accac570-de75-11e8-bd11-2f9252c4dc2f,AIRDROP,0
airdrop-20181115-hdac-30348fe6-e969-496a-b9bf-87b89a7761ce-withdrawal-exchange,2018.11.15 10:11,UNKNOWN,,UNKNOWN-55c0f2b7-dc24-425b-9be8-6b86719f2865,2018.11.15 10:11,UNKNOWN,0,100,0,HDAC,WITHDRAWAL,,,,0,COMPLETED,0,sum-user-id,1901958.749,airdrop-20181115-hdac-sum-user-id-withdrawal,accac570-de75-11e8-bd11-2f9252c4dc2f,AIRDROP,0
airdrop-20181115-hdac-303b08b5-e9c7-4814-9877-8352753e410c-withdrawal-exchange,2018.11.15 10:11,UNKNOWN,,UNKNOWN-55c0f2b7-dc24-425b-9be8-6b86719f2865,2018.11.15 10:11,UNKNOWN,0,100,0,HDAC,WITHDRAWAL,,,,0,COMPLETED,0,sum-user-id,1901858.749,airdrop-20181115-hdac-sum-user-id-withdrawal,accac570-de75-11e8-bd11-2f9252c4dc2f,AIRDROP,0
airdrop-20181115-hdac-305107cc-d420-4c00-af1d-2180ca4011f2-withdrawal-exchange,2018.11.15 10:11,UNKNOWN,,UNKNOWN-55c0f2b7-dc24-425b-9be8-6b86719f2865,2018.11.15 10:11,UNKNOWN,0,30116.05993,0,HDAC,WITHDRAWAL,,,,0,COMPLETED,0,sum-user-id,1871742.689,airdrop-20181115-hdac-sum-user-id-withdrawal,accac570-de75-11e8-bd11-2f9252c4dc2f,AIRDROP,0
airdrop-20181115-hdac-3059fb54-23cc-4ed2-9a1d-79f1da0359d4-withdrawal-exchange,2018.11.15 10:11,UNKNOWN,,UNKNOWN-55c0f2b7-dc24-425b-9be8-6b86719f2865,2018.11.15 10:11,UNKNOWN,0,100,0,HDAC,WITHDRAWAL,,,,0,COMPLETED,0,sum-user-id,1871642.689,airdrop-20181115-hdac-sum-user-id-withdrawal,accac570-de75-11e8-bd11-2f9252c4dc2f,AIRDROP,0
airdrop-20181115-hdac-306fcbf0-7ba5-40fe-9e3a-02e58a47a0ab-withdrawal-exchange,2018.11.15 10:11,UNKNOWN,,UNKNOWN-55c0f2b7-dc24-425b-9be8-6b86719f2865,2018.11.15 10:11,UNKNOWN,0,100,0,HDAC,WITHDRAWAL,,,,0,COMPLETED,0,sum-user-id,1871542.689,airdrop-20181115-hdac-sum-user-id-withdrawal,accac570-de75-11e8-bd11-2f9252c4dc2f,AIRDROP,0
airdrop-20181115-hdac-30bef4e9-56b9-4829-9209-2bcf58a3a341-withdrawal-exchange,2018.11.15 10:11,UNKNOWN,,UNKNOWN-55c0f2b7-dc24-425b-9be8-6b86719f2865,2018.11.15 10:11,UNKNOWN,0,100,0,HDAC,WITHDRAWAL,,,,0,COMPLETED,0,sum-user-id,1871442.689,airdrop-20181115-hdac-sum-user-id-withdrawal,accac570-de75-11e8-bd11-2f9252c4dc2f,AIRDROP,0
airdrop-20181115-hdac-30c199ad-fed7-4d0e-872a-8f26f82aca43-withdrawal-exchange,2018.11.15 10:11,UNKNOWN,,UNKNOWN-55c0f2b7-dc24-425b-9be8-6b86719f2865,2018.11.15 10:11,UNKNOWN,0,100,0,HDAC,WITHDRAWAL,,,,0,COMPLETED,0,sum-user-id,1871342.689,airdrop-20181115-hdac-sum-user-id-withdrawal,accac570-de75-11e8-bd11-2f9252c4dc2f,AIRDROP,0
airdrop-20181115-hdac-30e5e90b-1558-44f6-a6fe-0463a2df019d-withdrawal-exchange,2018.11.15 10:11,UNKNOWN,,UNKNOWN-55c0f2b7-dc24-425b-9be8-6b86719f2865,2018.11.15 10:11,UNKNOWN,0,100,0,HDAC,WITHDRAWAL,,,,0,COMPLETED,0,sum-user-id,1871242.689,airdrop-20181115-hdac-sum-user-id-withdrawal,accac570-de75-11e8-bd11-2f9252c4dc2f,AIRDROP,0
airdrop-20181115-hdac-30f0b108-2ffa-4dfb-af98-7b4d82666738-withdrawal-exchange,2018.11.15 10:11,UNKNOWN,,UNKNOWN-55c0f2b7-dc24-425b-9be8-6b86719f2865,2018.11.15 10:11,UNKNOWN,0,100,0,HDAC,WITHDRAWAL,,,,0,COMPLETED,0,sum-user-id,1871142.689,airdrop-20181115-hdac-sum-user-id-withdrawal,accac570-de75-11e8-bd11-2f9252c4dc2f,AIRDROP,0
airdrop-20181115-hdac-30f0dd30-e7fd-4d18-83d6-b85592178d55-withdrawal-exchange,2018.11.15 10:11,UNKNOWN,,UNKNOWN-55c0f2b7-dc24-425b-9be8-6b86719f2865,2018.11.15 10:11,UNKNOWN,0,100,0,HDAC,WITHDRAWAL,,,,0,COMPLETED,0,sum-user-id,1871042.689,airdrop-20181115-hdac-sum-user-id-withdrawal,accac570-de75-11e8-bd11-2f9252c4dc2f,AIRDROP,0
airdrop-20181115-hdac-30f8754b-2b64-4a64-82f2-19df0bfe4fcd-withdrawal-exchange,2018.11.15 10:11,UNKNOWN,,UNKNOWN-55c0f2b7-dc24-425b-9be8-6b86719f2865,2018.11.15 10:11,UNKNOWN,0,100,0,HDAC,WITHDRAWAL,,,,0,COMPLETED,0,sum-user-id,1870942.689,airdrop-20181115-hdac-sum-user-id-withdrawal,accac570-de75-11e8-bd11-2f9252c4dc2f,AIRDROP,0
airdrop-20181115-hdac-31011d9d-452b-48ae-b1b1-a23c548461cb-withdrawal-exchange,2018.11.15 10:11,UNKNOWN,,UNKNOWN-55c0f2b7-dc24-425b-9be8-6b86719f2865,2018.11.15 10:11,UNKNOWN,0,100,0,HDAC,WITHDRAWAL,,,,0,COMPLETED,0,sum-user-id,1870842.689,airdrop-20181115-hdac-sum-user-id-withdrawal,accac570-de75-11e8-bd11-2f9252c4dc2f,AIRDROP,0
airdrop-20181115-hdac-312965c8-bf64-4b85-b39d-470de6e9bb55-withdrawal-exchange,2018.11.15 10:11,UNKNOWN,,UNKNOWN-55c0f2b7-dc24-425b-9be8-6b86719f2865,2018.11.15 10:11,UNKNOWN,0,100,0,HDAC,WITHDRAWAL,,,,0,COMPLETED,0,sum-user-id,1870742.689,airdrop-20181115-hdac-sum-user-id-withdrawal,accac570-de75-11e8-bd11-2f9252c4dc2f,AIRDROP,0
airdrop-20181115-hdac-31433808-1e62-4dd8-97e1-4e5d647d6282-withdrawal-exchange,2018.11.15 10:11,UNKNOWN,,UNKNOWN-55c0f2b7-dc24-425b-9be8-6b86719f2865,2018.11.15 10:11,UNKNOWN,0,100,0,HDAC,WITHDRAWAL,,,,0,COMPLETED,0,sum-user-id,1870642.689,airdrop-20181115-hdac-sum-user-id-withdrawal,accac570-de75-11e8-bd11-2f9252c4dc2f,AIRDROP,0
airdrop-20181115-hdac-3184d1f3-133a-45ce-b936-bcc339c192e9-withdrawal-exchange,2018.11.15 10:11,UNKNOWN,,UNKNOWN-55c0f2b7-dc24-425b-9be8-6b86719f2865,2018.11.15 10:11,UNKNOWN,0,26.79448,0,HDAC,WITHDRAWAL,,,,0,COMPLETED,0,sum-user-id,1870615.894,airdrop-20181115-hdac-sum-user-id-withdrawal,accac570-de75-11e8-bd11-2f9252c4dc2f,AIRDROP,0
airdrop-20181115-hdac-31a2dc09-077f-4859-9cf9-a71a4d3b5976-withdrawal-exchange,2018.11.15 10:11,UNKNOWN,,UNKNOWN-55c0f2b7-dc24-425b-9be8-6b86719f2865,2018.11.15 10:11,UNKNOWN,0,100,0,HDAC,WITHDRAWAL,,,,0,COMPLETED,0,sum-user-id,1870515.894,airdrop-20181115-hdac-sum-user-id-withdrawal,accac570-de75-11e8-bd11-2f9252c4dc2f,AIRDROP,0
airdrop-20181115-hdac-31b387ff-22d3-44a8-928f-5f667b80ba14-withdrawal-exchange,2018.11.15 10:11,UNKNOWN,,UNKNOWN-55c0f2b7-dc24-425b-9be8-6b86719f2865,2018.11.15 10:11,UNKNOWN,0,100,0,HDAC,WITHDRAWAL,,,,0,COMPLETED,0,sum-user-id,1870415.894,airdrop-20181115-hdac-sum-user-id-withdrawal,accac570-de75-11e8-bd11-2f9252c4dc2f,AIRDROP,0
airdrop-20181115-hdac-31ba644c-3caf-4811-9bd8-ae75dd9f0a50-withdrawal-exchange,2018-11-15 10:11:23.024,UNKNOWN,,UNKNOWN-55c0f2b7-dc24-425b-9be8-6b86719f2865,2018-11-15 10:11:23.024,UNKNOWN,0,100,0,HDAC,WITHDRAWAL,,,,0,COMPLETED,0,sum-user-id,1870315.894,airdrop-20181115-hdac-sum-user-id-withdrawal,accac570-de75-11e8-bd11-2f9252c4dc2f,AIRDROP,0
airdrop-20181115-hdac-31d63e58-d760-4ffa-bef9-5eed71925120-withdrawal-exchange,2018-11-15 10:11:23.054,UNKNOWN,,UNKNOWN-55c0f2b7-dc24-425b-9be8-6b86719f2865,2018-11-15 10:11:23.054,UNKNOWN,0,100,0,HDAC,WITHDRAWAL,,,,0,COMPLETED,0,sum-user-id,1870215.894,airdrop-20181115-hdac-sum-user-id-withdrawal,accac570-de75-11e8-bd11-2f9252c4dc2f,AIRDROP,0
airdrop-20181115-hdac-31ef8dcf-c3b0-410b-9698-9161d8c49e41-withdrawal-exchange,2018-11-15 10:11:23.087,UNKNOWN,,UNKNOWN-55c0f2b7-dc24-425b-9be8-6b86719f2865,2018-11-15 10:11:23.087,UNKNOWN,0,100,0,HDAC,WITHDRAWAL,,,,0,COMPLETED,0,sum-user-id,1870115.894,airdrop-20181115-hdac-sum-user-id-withdrawal,accac570-de75-11e8-bd11-2f9252c4dc2f,AIRDROP,0
airdrop-20181115-hdac-32407666-0bb6-46d0-8128-dab9f74c5386-withdrawal-exchange,2018.11.15 10:11,UNKNOWN,,UNKNOWN-55c0f2b7-dc24-425b-9be8-6b86719f2865,2018.11.15 10:11,UNKNOWN,0,100,0,HDAC,WITHDRAWAL,,,,0,COMPLETED,0,sum-user-id,1870015.894,airdrop-20181115-hdac-sum-user-id-withdrawal,accac570-de75-11e8-bd11-2f9252c4dc2f,AIRDROP,0
airdrop-20181115-hdac-32438d7d-13b8-4d05-8c59-36901f2716f9-withdrawal-exchange,2018.11.15 10:11,UNKNOWN,,UNKNOWN-55c0f2b7-dc24-425b-9be8-6b86719f2865,2018.11.15 10:11,UNKNOWN,0,100,0,HDAC,WITHDRAWAL,,,,0,COMPLETED,0,sum-user-id,1869915.894,airdrop-20181115-hdac-sum-user-id-withdrawal,accac570-de75-11e8-bd11-2f9252c4dc2f,AIRDROP,0
airdrop-20181115-hdac-32467312-6057-4828-a488-3de70f56ea06-withdrawal-exchange,2018.11.15 10:11,UNKNOWN,,UNKNOWN-55c0f2b7-dc24-425b-9be8-6b86719f2865,2018.11.15 10:11,UNKNOWN,0,100,0,HDAC,WITHDRAWAL,,,,0,COMPLETED,0,sum-user-id,1869815.894,airdrop-20181115-hdac-sum-user-id-withdrawal,accac570-de75-11e8-bd11-2f9252c4dc2f,AIRDROP,0
airdrop-20181115-hdac-324c2426-b982-42a1-87fc-56ea3fc50a5b-withdrawal-exchange,2018.11.15 10:11,UNKNOWN,,UNKNOWN-55c0f2b7-dc24-425b-9be8-6b86719f2865,2018.11.15 10:11,UNKNOWN,0,100,0,HDAC,WITHDRAWAL,,,,0,COMPLETED,0,sum-user-id,1869715.894,airdrop-20181115-hdac-sum-user-id-withdrawal,accac570-de75-11e8-bd11-2f9252c4dc2f,AIRDROP,0
airdrop-20181115-hdac-32552bd2-5e14-4df9-b51c-3a702245924b-withdrawal-exchange,2018.11.15 10:11,UNKNOWN,,UNKNOWN-55c0f2b7-dc24-425b-9be8-6b86719f2865,2018.11.15 10:11,UNKNOWN,0,100,0,HDAC,WITHDRAWAL,,,,0,COMPLETED,0,sum-user-id,1869615.894,airdrop-20181115-hdac-sum-user-id-withdrawal,accac570-de75-11e8-bd11-2f9252c4dc2f,AIRDROP,0
airdrop-20181115-hdac-3273ad4f-5d9b-4459-9f2a-8bbb37600885-withdrawal-exchange,2018.11.15 10:11,UNKNOWN,,UNKNOWN-55c0f2b7-dc24-425b-9be8-6b86719f2865,2018.11.15 10:11,UNKNOWN,0,100,0,HDAC,WITHDRAWAL,,,,0,COMPLETED,0,sum-user-id,1869515.894,airdrop-20181115-hdac-sum-user-id-withdrawal,accac570-de75-11e8-bd11-2f9252c4dc2f,AIRDROP,0
airdrop-20181115-hdac-32a2cae3-7e95-4fd1-bb64-89653323d2ba-withdrawal-exchange,2018.11.15 10:11,UNKNOWN,,UNKNOWN-55c0f2b7-dc24-425b-9be8-6b86719f2865,2018.11.15 10:11,UNKNOWN,0,100,0,HDAC,WITHDRAWAL,,,,0,COMPLETED,0,sum-user-id,1869415.894,airdrop-20181115-hdac-sum-user-id-withdrawal,accac570-de75-11e8-bd11-2f9252c4dc2f,AIRDROP,0
airdrop-20181115-hdac-32d3508a-9aaf-471b-96fc-413ace01955c-withdrawal-exchange,2018.11.15 10:11,UNKNOWN,,UNKNOWN-55c0f2b7-dc24-425b-9be8-6b86719f2865,2018.11.15 10:11,UNKNOWN,0,100,0,HDAC,WITHDRAWAL,,,,0,COMPLETED,0,sum-user-id,1869315.894,airdrop-20181115-hdac-sum-user-id-withdrawal,accac570-de75-11e8-bd11-2f9252c4dc2f,AIRDROP,0
airdrop-20181115-hdac-32e83e09-35aa-44f5-b210-77a62ef692c0-withdrawal-exchange,2018.11.15 10:11,UNKNOWN,,UNKNOWN-55c0f2b7-dc24-425b-9be8-6b86719f2865,2018.11.15 10:11,UNKNOWN,0,100,0,HDAC,WITHDRAWAL,,,,0,COMPLETED,0,sum-user-id,1869215.894,airdrop-20181115-hdac-sum-user-id-withdrawal,accac570-de75-11e8-bd11-2f9252c4dc2f,AIRDROP,0
airdrop-20181115-hdac-32fa13c0-a7e1-4cf3-8bcf-63a6008e0d23-withdrawal-exchange,2018.11.15 10:11,UNKNOWN,,UNKNOWN-55c0f2b7-dc24-425b-9be8-6b86719f2865,2018.11.15 10:11,UNKNOWN,0,100,0,HDAC,WITHDRAWAL,,,,0,COMPLETED,0,sum-user-id,1869115.894,airdrop-20181115-hdac-sum-user-id-withdrawal,accac570-de75-11e8-bd11-2f9252c4dc2f,AIRDROP,0
airdrop-20181115-hdac-32fae7c4-e47b-446a-9f24-eece22b97b1c-withdrawal-exchange,2018.11.15 10:11,UNKNOWN,,UNKNOWN-55c0f2b7-dc24-425b-9be8-6b86719f2865,2018.11.15 10:11,UNKNOWN,0,100,0,HDAC,WITHDRAWAL,,,,0,COMPLETED,0,sum-user-id,1869015.894,airdrop-20181115-hdac-sum-user-id-withdrawal,accac570-de75-11e8-bd11-2f9252c4dc2f,AIRDROP,0
airdrop-20181115-hdac-32fecee6-9ce9-4197-be34-469b223c8d3a-withdrawal-exchange,2018.11.15 10:11,UNKNOWN,,UNKNOWN-55c0f2b7-dc24-425b-9be8-6b86719f2865,2018.11.15 10:11,UNKNOWN,0,100,0,HDAC,WITHDRAWAL,,,,0,COMPLETED,0,sum-user-id,1868915.894,airdrop-20181115-hdac-sum-user-id-withdrawal,accac570-de75-11e8-bd11-2f9252c4dc2f,AIRDROP,0
airdrop-20181115-hdac-3312d0e9-59d0-4a25-a251-40ff99e7cdfb-withdrawal-exchange,2018.11.15 10:11,UNKNOWN,,UNKNOWN-55c0f2b7-dc24-425b-9be8-6b86719f2865,2018.11.15 10:11,UNKNOWN,0,100,0,HDAC,WITHDRAWAL,,,,0,COMPLETED,0,sum-user-id,1868815.894,airdrop-20181115-hdac-sum-user-id-withdrawal,accac570-de75-11e8-bd11-2f9252c4dc2f,AIRDROP,0
airdrop-20181115-hdac-336739be-3144-4c03-b490-1eb7436f3d3c-withdrawal-exchange,2018.11.15 10:11,UNKNOWN,,UNKNOWN-55c0f2b7-dc24-425b-9be8-6b86719f2865,2018.11.15 10:11,UNKNOWN,0,100,0,HDAC,WITHDRAWAL,,,,0,COMPLETED,0,sum-user-id,1868715.894,airdrop-20181115-hdac-sum-user-id-withdrawal,accac570-de75-11e8-bd11-2f9252c4dc2f,AIRDROP,0
airdrop-20181115-hdac-33681477-5be6-4ed8-a9a0-17f44bfe7315-withdrawal-exchange,2018.11.15 10:11,UNKNOWN,,UNKNOWN-55c0f2b7-dc24-425b-9be8-6b86719f2865,2018.11.15 10:11,UNKNOWN,0,100,0,HDAC,WITHDRAWAL,,,,0,COMPLETED,0,sum-user-id,1868615.894,airdrop-20181115-hdac-sum-user-id-withdrawal,accac570-de75-11e8-bd11-2f9252c4dc2f,AIRDROP,0
airdrop-20181115-hdac-33ac3274-4710-4d44-95e1-1928f86c8067-withdrawal-exchange,2018.11.15 10:11,UNKNOWN,,UNKNOWN-55c0f2b7-dc24-425b-9be8-6b86719f2865,2018.11.15 10:11,UNKNOWN,0,100,0,HDAC,WITHDRAWAL,,,,0,COMPLETED,0,sum-user-id,1868515.894,airdrop-20181115-hdac-sum-user-id-withdrawal,accac570-de75-11e8-bd11-2f9252c4dc2f,AIRDROP,0
airdrop-20181115-hdac-33d3c616-6b27-4300-87d2-f1a7a691f194-withdrawal-exchange,2018.11.15 10:11,UNKNOWN,,UNKNOWN-55c0f2b7-dc24-425b-9be8-6b86719f2865,2018.11.15 10:11,UNKNOWN,0,100,0,HDAC,WITHDRAWAL,,,,0,COMPLETED,0,sum-user-id,1868415.894,airdrop-20181115-hdac-sum-user-id-withdrawal,accac570-de75-11e8-bd11-2f9252c4dc2f,AIRDROP,0
airdrop-20181115-hdac-33d58da9-eba6-4351-a734-a5812b5574ce-withdrawal-exchange,2018.11.15 10:11,UNKNOWN,,UNKNOWN-55c0f2b7-dc24-425b-9be8-6b86719f2865,2018.11.15 10:11,UNKNOWN,0,100,0,HDAC,WITHDRAWAL,,,,0,COMPLETED,0,sum-user-id,1868315.894,airdrop-20181115-hdac-sum-user-id-withdrawal,accac570-de75-11e8-bd11-2f9252c4dc2f,AIRDROP,0
airdrop-20181115-hdac-33d8c6bf-77df-4b8d-9149-9615402f8846-withdrawal-exchange,2018.11.15 10:11,UNKNOWN,,UNKNOWN-55c0f2b7-dc24-425b-9be8-6b86719f2865,2018.11.15 10:11,UNKNOWN,0,100,0,HDAC,WITHDRAWAL,,,,0,COMPLETED,0,sum-user-id,1868215.894,airdrop-20181115-hdac-sum-user-id-withdrawal,accac570-de75-11e8-bd11-2f9252c4dc2f,AIRDROP,0
airdrop-20181115-hdac-34051853-1b12-4e62-b20f-f8a351391c86-withdrawal-exchange,2018.11.15 10:11,UNKNOWN,,UNKNOWN-55c0f2b7-dc24-425b-9be8-6b86719f2865,2018.11.15 10:11,UNKNOWN,0,100,0,HDAC,WITHDRAWAL,,,,0,COMPLETED,0,sum-user-id,1868115.894,airdrop-20181115-hdac-sum-user-id-withdrawal,accac570-de75-11e8-bd11-2f9252c4dc2f,AIRDROP,0
airdrop-20181115-hdac-34055b1d-25d2-4bd1-9735-2e9e058f240a-withdrawal-exchange,2018.11.15 10:11,UNKNOWN,,UNKNOWN-55c0f2b7-dc24-425b-9be8-6b86719f2865,2018.11.15 10:11,UNKNOWN,0,100,0,HDAC,WITHDRAWAL,,,,0,COMPLETED,0,sum-user-id,1868015.894,airdrop-20181115-hdac-sum-user-id-withdrawal,accac570-de75-11e8-bd11-2f9252c4dc2f,AIRDROP,0
airdrop-20181115-hdac-3408df03-02b2-40ce-9e5a-aa8203d7d51c-withdrawal-exchange,2018.11.15 10:11,UNKNOWN,,UNKNOWN-55c0f2b7-dc24-425b-9be8-6b86719f2865,2018.11.15 10:11,UNKNOWN,0,100,0,HDAC,WITHDRAWAL,,,,0,COMPLETED,0,sum-user-id,1867915.894,airdrop-20181115-hdac-sum-user-id-withdrawal,accac570-de75-11e8-bd11-2f9252c4dc2f,AIRDROP,0
airdrop-20181115-hdac-341aba0a-e624-4ed1-b9f6-451c86d5d413-withdrawal-exchange,2018.11.15 10:11,UNKNOWN,,UNKNOWN-55c0f2b7-dc24-425b-9be8-6b86719f2865,2018.11.15 10:11,UNKNOWN,0,100,0,HDAC,WITHDRAWAL,,,,0,COMPLETED,0,sum-user-id,1867815.894,airdrop-20181115-hdac-sum-user-id-withdrawal,accac570-de75-11e8-bd11-2f9252c4dc2f,AIRDROP,0
airdrop-20181115-hdac-342bc5dd-dd49-4250-98c5-b0e8a8299f77-withdrawal-exchange,2018.11.15 10:11,UNKNOWN,,UNKNOWN-55c0f2b7-dc24-425b-9be8-6b86719f2865,2018.11.15 10:11,UNKNOWN,0,100,0,HDAC,WITHDRAWAL,,,,0,COMPLETED,0,sum-user-id,1867715.894,airdrop-20181115-hdac-sum-user-id-withdrawal,accac570-de75-11e8-bd11-2f9252c4dc2f,AIRDROP,0
airdrop-20181115-hdac-343e35a9-edc4-4d29-b3b8-2d706391675b-withdrawal-exchange,2018.11.15 10:11,UNKNOWN,,UNKNOWN-55c0f2b7-dc24-425b-9be8-6b86719f2865,2018.11.15 10:11,UNKNOWN,0,100,0,HDAC,WITHDRAWAL,,,,0,COMPLETED,0,sum-user-id,1867615.894,airdrop-20181115-hdac-sum-user-id-withdrawal,accac570-de75-11e8-bd11-2f9252c4dc2f,AIRDROP,0
airdrop-20181115-hdac-345e6172-1a70-4ac2-9bfa-c7558c759ef4-withdrawal-exchange,2018.11.15 10:11,UNKNOWN,,UNKNOWN-55c0f2b7-dc24-425b-9be8-6b86719f2865,2018.11.15 10:11,UNKNOWN,0,100,0,HDAC,WITHDRAWAL,,,,0,COMPLETED,0,sum-user-id,1867515.894,airdrop-20181115-hdac-sum-user-id-withdrawal,accac570-de75-11e8-bd11-2f9252c4dc2f,AIRDROP,0
airdrop-20181115-hdac-3470fbd3-b65b-4ea1-a8f7-44a9b999033c-withdrawal-exchange,2018.11.15 10:11,UNKNOWN,,UNKNOWN-55c0f2b7-dc24-425b-9be8-6b86719f2865,2018.11.15 10:11,UNKNOWN,0,100,0,HDAC,WITHDRAWAL,,,,0,COMPLETED,0,sum-user-id,1867415.894,airdrop-20181115-hdac-sum-user-id-withdrawal,accac570-de75-11e8-bd11-2f9252c4dc2f,AIRDROP,0
airdrop-20181115-hdac-3499c796-fd4a-4d5e-82ee-2d2f2f6d2e0a-withdrawal-exchange,2018-11-15 10:11:24.001,UNKNOWN,,UNKNOWN-55c0f2b7-dc24-425b-9be8-6b86719f2865,2018-11-15 10:11:24.001,UNKNOWN,0,100,0,HDAC,WITHDRAWAL,,,,0,COMPLETED,0,sum-user-id,1867315.894,airdrop-20181115-hdac-sum-user-id-withdrawal,accac570-de75-11e8-bd11-2f9252c4dc2f,AIRDROP,0
airdrop-20181115-hdac-34be77d6-285b-464d-918a-396952f7c77b-withdrawal-exchange,2018-11-15 10:11:24.031,UNKNOWN,,UNKNOWN-55c0f2b7-dc24-425b-9be8-6b86719f2865,2018-11-15 10:11:24.031,UNKNOWN,0,100,0,HDAC,WITHDRAWAL,,,,0,COMPLETED,0,sum-user-id,1867215.894,airdrop-20181115-hdac-sum-user-id-withdrawal,accac570-de75-11e8-bd11-2f9252c4dc2f,AIRDROP,0
airdrop-20181115-hdac-34d6f129-e6f3-4a31-b92b-69176f062f28-withdrawal-exchange,2018-11-15 10:11:24.060,UNKNOWN,,UNKNOWN-55c0f2b7-dc24-425b-9be8-6b86719f2865,2018-11-15 10:11:24.060,UNKNOWN,0,100,0,HDAC,WITHDRAWAL,,,,0,COMPLETED,0,sum-user-id,1867115.894,airdrop-20181115-hdac-sum-user-id-withdrawal,accac570-de75-11e8-bd11-2f9252c4dc2f,AIRDROP,0
airdrop-20181115-hdac-34de898d-05f2-463e-87cd-3f865a655e81-withdrawal-exchange,2018-11-15 10:11:24.097,UNKNOWN,,UNKNOWN-55c0f2b7-dc24-425b-9be8-6b86719f2865,2018-11-15 10:11:24.097,UNKNOWN,0,100,0,HDAC,WITHDRAWAL,,,,0,COMPLETED,0,sum-user-id,1867015.894,airdrop-20181115-hdac-sum-user-id-withdrawal,accac570-de75-11e8-bd11-2f9252c4dc2f,AIRDROP,0
airdrop-20181115-hdac-3537f6be-5885-493f-a1ce-28c916bc5391-withdrawal-exchange,2018.11.15 10:11,UNKNOWN,,UNKNOWN-55c0f2b7-dc24-425b-9be8-6b86719f2865,2018.11.15 10:11,UNKNOWN,0,100,0,HDAC,WITHDRAWAL,,,,0,COMPLETED,0,sum-user-id,1866915.894,airdrop-20181115-hdac-sum-user-id-withdrawal,accac570-de75-11e8-bd11-2f9252c4dc2f,AIRDROP,0
airdrop-20181115-hdac-353dca14-2ff2-4ae4-bb8c-d48096141ce2-withdrawal-exchange,2018.11.15 10:11,UNKNOWN,,UNKNOWN-55c0f2b7-dc24-425b-9be8-6b86719f2865,2018.11.15 10:11,UNKNOWN,0,100,0,HDAC,WITHDRAWAL,,,,0,COMPLETED,0,sum-user-id,1866815.894,airdrop-20181115-hdac-sum-user-id-withdrawal,accac570-de75-11e8-bd11-2f9252c4dc2f,AIRDROP,0
airdrop-20181115-hdac-356f4e9b-122d-4834-ab44-77298a8c7886-withdrawal-exchange,2018.11.15 10:11,UNKNOWN,,UNKNOWN-55c0f2b7-dc24-425b-9be8-6b86719f2865,2018.11.15 10:11,UNKNOWN,0,100,0,HDAC,WITHDRAWAL,,,,0,COMPLETED,0,sum-user-id,1866715.894,airdrop-20181115-hdac-sum-user-id-withdrawal,accac570-de75-11e8-bd11-2f9252c4dc2f,AIRDROP,0
airdrop-20181115-hdac-3578ae7a-04d9-43d4-9b17-cf7f441d4e8e-withdrawal-exchange,2018.11.15 10:11,UNKNOWN,,UNKNOWN-55c0f2b7-dc24-425b-9be8-6b86719f2865,2018.11.15 10:11,UNKNOWN,0,100,0,HDAC,WITHDRAWAL,,,,0,COMPLETED,0,sum-user-id,1866615.894,airdrop-20181115-hdac-sum-user-id-withdrawal,accac570-de75-11e8-bd11-2f9252c4dc2f,AIRDROP,0
airdrop-20181115-hdac-35ce904c-28bf-4122-900b-aea1c9a9e72f-withdrawal-exchange,2018.11.15 10:11,UNKNOWN,,UNKNOWN-55c0f2b7-dc24-425b-9be8-6b86719f2865,2018.11.15 10:11,UNKNOWN,0,100,0,HDAC,WITHDRAWAL,,,,0,COMPLETED,0,sum-user-id,1866515.894,airdrop-20181115-hdac-sum-user-id-withdrawal,accac570-de75-11e8-bd11-2f9252c4dc2f,AIRDROP,0
airdrop-20181115-hdac-35ff1e80-e3bb-4db3-a6ab-ad9fd147f1de-withdrawal-exchange,2018.11.15 10:11,UNKNOWN,,UNKNOWN-55c0f2b7-dc24-425b-9be8-6b86719f2865,2018.11.15 10:11,UNKNOWN,0,100,0,HDAC,WITHDRAWAL,,,,0,COMPLETED,0,sum-user-id,1866415.894,airdrop-20181115-hdac-sum-user-id-withdrawal,accac570-de75-11e8-bd11-2f9252c4dc2f,AIRDROP,0
airdrop-20181115-hdac-361ee5f9-e926-42e0-b8bd-5b462f45473c-withdrawal-exchange,2018.11.15 10:11,UNKNOWN,,UNKNOWN-55c0f2b7-dc24-425b-9be8-6b86719f2865,2018.11.15 10:11,UNKNOWN,0,100,0,HDAC,WITHDRAWAL,,,,0,COMPLETED,0,sum-user-id,1866315.894,airdrop-20181115-hdac-sum-user-id-withdrawal,accac570-de75-11e8-bd11-2f9252c4dc2f,AIRDROP,0
airdrop-20181115-hdac-367a22e3-f523-4b62-93cb-d3d3bdbea697-withdrawal-exchange,2018.11.15 10:11,UNKNOWN,,UNKNOWN-55c0f2b7-dc24-425b-9be8-6b86719f2865,2018.11.15 10:11,UNKNOWN,0,100,0,HDAC,WITHDRAWAL,,,,0,COMPLETED,0,sum-user-id,1866215.894,airdrop-20181115-hdac-sum-user-id-withdrawal,accac570-de75-11e8-bd11-2f9252c4dc2f,AIRDROP,0
airdrop-20181115-hdac-3689e135-6fa5-4e42-b7e8-b74197049765-withdrawal-exchange,2018.11.15 10:11,UNKNOWN,,UNKNOWN-55c0f2b7-dc24-425b-9be8-6b86719f2865,2018.11.15 10:11,UNKNOWN,0,100,0,HDAC,WITHDRAWAL,,,,0,COMPLETED,0,sum-user-id,1866115.894,airdrop-20181115-hdac-sum-user-id-withdrawal,accac570-de75-11e8-bd11-2f9252c4dc2f,AIRDROP,0
airdrop-20181115-hdac-36a1c384-7bf9-4883-a06c-73529f7a9b68-withdrawal-exchange,2018.11.15 10:11,UNKNOWN,,UNKNOWN-55c0f2b7-dc24-425b-9be8-6b86719f2865,2018.11.15 10:11,UNKNOWN,0,100,0,HDAC,WITHDRAWAL,,,,0,COMPLETED,0,sum-user-id,1866015.894,airdrop-20181115-hdac-sum-user-id-withdrawal,accac570-de75-11e8-bd11-2f9252c4dc2f,AIRDROP,0
airdrop-20181115-hdac-36a86f43-718c-4766-9586-f071b8ea50af-withdrawal-exchange,2018.11.15 10:11,UNKNOWN,,UNKNOWN-55c0f2b7-dc24-425b-9be8-6b86719f2865,2018.11.15 10:11,UNKNOWN,0,100,0,HDAC,WITHDRAWAL,,,,0,COMPLETED,0,sum-user-id,1865915.894,airdrop-20181115-hdac-sum-user-id-withdrawal,accac570-de75-11e8-bd11-2f9252c4dc2f,AIRDROP,0
airdrop-20181115-hdac-36b50110-f86e-4a82-a8f9-4d1b99827e5d-withdrawal-exchange,2018.11.15 10:11,UNKNOWN,,UNKNOWN-55c0f2b7-dc24-425b-9be8-6b86719f2865,2018.11.15 10:11,UNKNOWN,0,100,0,HDAC,WITHDRAWAL,,,,0,COMPLETED,0,sum-user-id,1865815.894,airdrop-20181115-hdac-sum-user-id-withdrawal,accac570-de75-11e8-bd11-2f9252c4dc2f,AIRDROP,0
airdrop-20181115-hdac-36c7b19e-a2ab-4cba-82b4-158c71f6a587-withdrawal-exchange,2018.11.15 10:11,UNKNOWN,,UNKNOWN-55c0f2b7-dc24-425b-9be8-6b86719f2865,2018.11.15 10:11,UNKNOWN,0,100,0,HDAC,WITHDRAWAL,,,,0,COMPLETED,0,sum-user-id,1865715.894,airdrop-20181115-hdac-sum-user-id-withdrawal,accac570-de75-11e8-bd11-2f9252c4dc2f,AIRDROP,0
airdrop-20181115-hdac-3708f8f4-1c2b-48c7-9a71-2d994fe46dc9-withdrawal-exchange,2018.11.15 10:11,UNKNOWN,,UNKNOWN-55c0f2b7-dc24-425b-9be8-6b86719f2865,2018.11.15 10:11,UNKNOWN,0,100,0,HDAC,WITHDRAWAL,,,,0,COMPLETED,0,sum-user-id,1865615.894,airdrop-20181115-hdac-sum-user-id-withdrawal,accac570-de75-11e8-bd11-2f9252c4dc2f,AIRDROP,0
airdrop-20181115-hdac-374255cd-1e1b-4312-95f6-d5ea84ab5b2b-withdrawal-exchange,2018.11.15 10:11,UNKNOWN,,UNKNOWN-55c0f2b7-dc24-425b-9be8-6b86719f2865,2018.11.15 10:11,UNKNOWN,0,100,0,HDAC,WITHDRAWAL,,,,0,COMPLETED,0,sum-user-id,1865515.894,airdrop-20181115-hdac-sum-user-id-withdrawal,accac570-de75-11e8-bd11-2f9252c4dc2f,AIRDROP,0
airdrop-20181115-hdac-3743ed79-d6a0-4a89-a88d-a21fac302e43-withdrawal-exchange,2018.11.15 10:11,UNKNOWN,,UNKNOWN-55c0f2b7-dc24-425b-9be8-6b86719f2865,2018.11.15 10:11,UNKNOWN,0,100,0,HDAC,WITHDRAWAL,,,,0,COMPLETED,0,sum-user-id,1865415.894,airdrop-20181115-hdac-sum-user-id-withdrawal,accac570-de75-11e8-bd11-2f9252c4dc2f,AIRDROP,0
airdrop-20181115-hdac-3758bed4-7118-4496-a3d9-b3fb926082ed-withdrawal-exchange,2018.11.15 10:11,UNKNOWN,,UNKNOWN-55c0f2b7-dc24-425b-9be8-6b86719f2865,2018.11.15 10:11,UNKNOWN,0,100,0,HDAC,WITHDRAWAL,,,,0,COMPLETED,0,sum-user-id,1865315.894,airdrop-20181115-hdac-sum-user-id-withdrawal,accac570-de75-11e8-bd11-2f9252c4dc2f,AIRDROP,0
airdrop-20181115-hdac-377d9906-0ac8-47c0-b3af-7ae48442b415-withdrawal-exchange,2018.11.15 10:11,UNKNOWN,,UNKNOWN-55c0f2b7-dc24-425b-9be8-6b86719f2865,2018.11.15 10:11,UNKNOWN,0,100,0,HDAC,WITHDRAWAL,,,,0,COMPLETED,0,sum-user-id,1865215.894,airdrop-20181115-hdac-sum-user-id-withdrawal,accac570-de75-11e8-bd11-2f9252c4dc2f,AIRDROP,0
airdrop-20181115-hdac-3787c675-36b4-4375-b3a3-020c9103800a-withdrawal-exchange,2018.11.15 10:11,UNKNOWN,,UNKNOWN-55c0f2b7-dc24-425b-9be8-6b86719f2865,2018.11.15 10:11,UNKNOWN,0,100,0,HDAC,WITHDRAWAL,,,,0,COMPLETED,0,sum-user-id,1865115.894,airdrop-20181115-hdac-sum-user-id-withdrawal,accac570-de75-11e8-bd11-2f9252c4dc2f,AIRDROP,0
airdrop-20181115-hdac-3790e3a7-d446-4c9f-bd36-83ae32fd9fda-withdrawal-exchange,2018.11.15 10:11,UNKNOWN,,UNKNOWN-55c0f2b7-dc24-425b-9be8-6b86719f2865,2018.11.15 10:11,UNKNOWN,0,100,0,HDAC,WITHDRAWAL,,,,0,COMPLETED,0,sum-user-id,1865015.894,airdrop-20181115-hdac-sum-user-id-withdrawal,accac570-de75-11e8-bd11-2f9252c4dc2f,AIRDROP,0
airdrop-20181115-hdac-37a5e53f-bf16-4a82-8416-0d5d6026b07e-withdrawal-exchange,2018.11.15 10:11,UNKNOWN,,UNKNOWN-55c0f2b7-dc24-425b-9be8-6b86719f2865,2018.11.15 10:11,UNKNOWN,0,100,0,HDAC,WITHDRAWAL,,,,0,COMPLETED,0,sum-user-id,1864915.894,airdrop-20181115-hdac-sum-user-id-withdrawal,accac570-de75-11e8-bd11-2f9252c4dc2f,AIRDROP,0
airdrop-20181115-hdac-37ad76b6-b965-474f-afff-af8379524a4a-withdrawal-exchange,2018.11.15 10:11,UNKNOWN,,UNKNOWN-55c0f2b7-dc24-425b-9be8-6b86719f2865,2018.11.15 10:11,UNKNOWN,0,100,0,HDAC,WITHDRAWAL,,,,0,COMPLETED,0,sum-user-id,1864815.894,airdrop-20181115-hdac-sum-user-id-withdrawal,accac570-de75-11e8-bd11-2f9252c4dc2f,AIRDROP,0
airdrop-20181115-hdac-37ae6878-a643-49e1-8303-1e3627ee3e14-withdrawal-exchange,2018.11.15 10:11,UNKNOWN,,UNKNOWN-55c0f2b7-dc24-425b-9be8-6b86719f2865,2018.11.15 10:11,UNKNOWN,0,100,0,HDAC,WITHDRAWAL,,,,0,COMPLETED,0,sum-user-id,1864715.894,airdrop-20181115-hdac-sum-user-id-withdrawal,accac570-de75-11e8-bd11-2f9252c4dc2f,AIRDROP,0
airdrop-20181115-hdac-3800dea2-f403-4823-b3e8-d4e1cb4992f1-withdrawal-exchange,2018.11.15 10:11,UNKNOWN,,UNKNOWN-55c0f2b7-dc24-425b-9be8-6b86719f2865,2018.11.15 10:11,UNKNOWN,0,100,0,HDAC,WITHDRAWAL,,,,0,COMPLETED,0,sum-user-id,1864615.894,airdrop-20181115-hdac-sum-user-id-withdrawal,accac570-de75-11e8-bd11-2f9252c4dc2f,AIRDROP,0
airdrop-20181115-hdac-383e220f-786e-42de-9aaa-c877a04955ae-withdrawal-exchange,2018.11.15 10:11,UNKNOWN,,UNKNOWN-55c0f2b7-dc24-425b-9be8-6b86719f2865,2018.11.15 10:11,UNKNOWN,0,100,0,HDAC,WITHDRAWAL,,,,0,COMPLETED,0,sum-user-id,1864515.894,airdrop-20181115-hdac-sum-user-id-withdrawal,accac570-de75-11e8-bd11-2f9252c4dc2f,AIRDROP,0
airdrop-20181115-hdac-38432c6f-b627-42fd-b5ad-c33ae8002b56-withdrawal-exchange,2018.11.15 10:11,UNKNOWN,,UNKNOWN-55c0f2b7-dc24-425b-9be8-6b86719f2865,2018.11.15 10:11,UNKNOWN,0,100,0,HDAC,WITHDRAWAL,,,,0,COMPLETED,0,sum-user-id,1864415.894,airdrop-20181115-hdac-sum-user-id-withdrawal,accac570-de75-11e8-bd11-2f9252c4dc2f,AIRDROP,0
airdrop-20181115-hdac-387b8bd1-5ded-4e52-ad46-3e446e977af5-withdrawal-exchange,2018.11.15 10:11,UNKNOWN,,UNKNOWN-55c0f2b7-dc24-425b-9be8-6b86719f2865,2018.11.15 10:11,UNKNOWN,0,100,0,HDAC,WITHDRAWAL,,,,0,COMPLETED,0,sum-user-id,1864315.894,airdrop-20181115-hdac-sum-user-id-withdrawal,accac570-de75-11e8-bd11-2f9252c4dc2f,AIRDROP,0
airdrop-20181115-hdac-38809345-c796-4303-bdae-61a40d90bcf9-withdrawal-exchange,2018-11-15 10:11:25.051,UNKNOWN,,UNKNOWN-55c0f2b7-dc24-425b-9be8-6b86719f2865,2018-11-15 10:11:25.051,UNKNOWN,0,100,0,HDAC,WITHDRAWAL,,,,0,COMPLETED,0,sum-user-id,1864215.894,airdrop-20181115-hdac-sum-user-id-withdrawal,accac570-de75-11e8-bd11-2f9252c4dc2f,AIRDROP,0
airdrop-20181115-hdac-38810b15-500c-4623-b41c-fde35660afa1-withdrawal-exchange,2018-11-15 10:11:25.082,UNKNOWN,,UNKNOWN-55c0f2b7-dc24-425b-9be8-6b86719f2865,2018-11-15 10:11:25.082,UNKNOWN,0,100,0,HDAC,WITHDRAWAL,,,,0,COMPLETED,0,sum-user-id,1864115.894,airdrop-20181115-hdac-sum-user-id-withdrawal,accac570-de75-11e8-bd11-2f9252c4dc2f,AIRDROP,0
airdrop-20181115-hdac-3881b36b-607c-4b45-84af-880d86b9013c-withdrawal-exchange,2018.11.15 10:11,UNKNOWN,,UNKNOWN-55c0f2b7-dc24-425b-9be8-6b86719f2865,2018.11.15 10:11,UNKNOWN,0,100,0,HDAC,WITHDRAWAL,,,,0,COMPLETED,0,sum-user-id,1864015.894,airdrop-20181115-hdac-sum-user-id-withdrawal,accac570-de75-11e8-bd11-2f9252c4dc2f,AIRDROP,0
airdrop-20181115-hdac-388b6b18-d89d-4d66-965f-1cc1a0a49cd7-withdrawal-exchange,2018.11.15 10:11,UNKNOWN,,UNKNOWN-55c0f2b7-dc24-425b-9be8-6b86719f2865,2018.11.15 10:11,UNKNOWN,0,100,0,HDAC,WITHDRAWAL,,,,0,COMPLETED,0,sum-user-id,1863915.894,airdrop-20181115-hdac-sum-user-id-withdrawal,accac570-de75-11e8-bd11-2f9252c4dc2f,AIRDROP,0
airdrop-20181115-hdac-389f24c3-c590-4a00-85d4-1e96661c2252-withdrawal-exchange,2018.11.15 10:11,UNKNOWN,,UNKNOWN-55c0f2b7-dc24-425b-9be8-6b86719f2865,2018.11.15 10:11,UNKNOWN,0,100,0,HDAC,WITHDRAWAL,,,,0,COMPLETED,0,sum-user-id,1863815.894,airdrop-20181115-hdac-sum-user-id-withdrawal,accac570-de75-11e8-bd11-2f9252c4dc2f,AIRDROP,0
airdrop-20181115-hdac-38b3c786-9e94-4b95-b014-d96f5d8fc052-withdrawal-exchange,2018.11.15 10:11,UNKNOWN,,UNKNOWN-55c0f2b7-dc24-425b-9be8-6b86719f2865,2018.11.15 10:11,UNKNOWN,0,100,0,HDAC,WITHDRAWAL,,,,0,COMPLETED,0,sum-user-id,1863715.894,airdrop-20181115-hdac-sum-user-id-withdrawal,accac570-de75-11e8-bd11-2f9252c4dc2f,AIRDROP,0
airdrop-20181115-hdac-38c182e1-0449-4dda-869e-8e637015f2bc-withdrawal-exchange,2018.11.15 10:11,UNKNOWN,,UNKNOWN-55c0f2b7-dc24-425b-9be8-6b86719f2865,2018.11.15 10:11,UNKNOWN,0,100,0,HDAC,WITHDRAWAL,,,,0,COMPLETED,0,sum-user-id,1863615.894,airdrop-20181115-hdac-sum-user-id-withdrawal,accac570-de75-11e8-bd11-2f9252c4dc2f,AIRDROP,0
airdrop-20181115-hdac-38cc82b6-bcbd-47e2-b5ec-4626de7d7a99-withdrawal-exchange,2018.11.15 10:11,UNKNOWN,,UNKNOWN-55c0f2b7-dc24-425b-9be8-6b86719f2865,2018.11.15 10:11,UNKNOWN,0,100,0,HDAC,WITHDRAWAL,,,,0,COMPLETED,0,sum-user-id,1863515.894,airdrop-20181115-hdac-sum-user-id-withdrawal,accac570-de75-11e8-bd11-2f9252c4dc2f,AIRDROP,0
airdrop-20181115-hdac-38d394f5-7da8-499c-ad56-4a16e8c73c4a-withdrawal-exchange,2018.11.15 10:11,UNKNOWN,,UNKNOWN-55c0f2b7-dc24-425b-9be8-6b86719f2865,2018.11.15 10:11,UNKNOWN,0,100,0,HDAC,WITHDRAWAL,,,,0,COMPLETED,0,sum-user-id,1863415.894,airdrop-20181115-hdac-sum-user-id-withdrawal,accac570-de75-11e8-bd11-2f9252c4dc2f,AIRDROP,0
airdrop-20181115-hdac-38ef7027-893e-4d7f-a88c-536041209cda-withdrawal-exchange,2018.11.15 10:11,UNKNOWN,,UNKNOWN-55c0f2b7-dc24-425b-9be8-6b86719f2865,2018.11.15 10:11,UNKNOWN,0,100,0,HDAC,WITHDRAWAL,,,,0,COMPLETED,0,sum-user-id,1863315.894,airdrop-20181115-hdac-sum-user-id-withdrawal,accac570-de75-11e8-bd11-2f9252c4dc2f,AIRDROP,0
airdrop-20181115-hdac-390ed517-0444-4ac8-8550-67d321be9c9c-withdrawal-exchange,2018.11.15 10:11,UNKNOWN,,UNKNOWN-55c0f2b7-dc24-425b-9be8-6b86719f2865,2018.11.15 10:11,UNKNOWN,0,100,0,HDAC,WITHDRAWAL,,,,0,COMPLETED,0,sum-user-id,1863215.894,airdrop-20181115-hdac-sum-user-id-withdrawal,accac570-de75-11e8-bd11-2f9252c4dc2f,AIRDROP,0
airdrop-20181115-hdac-391b066b-085c-4738-81f6-c5580acf0f6b-withdrawal-exchange,2018.11.15 10:11,UNKNOWN,,UNKNOWN-55c0f2b7-dc24-425b-9be8-6b86719f2865,2018.11.15 10:11,UNKNOWN,0,100,0,HDAC,WITHDRAWAL,,,,0,COMPLETED,0,sum-user-id,1863115.894,airdrop-20181115-hdac-sum-user-id-withdrawal,accac570-de75-11e8-bd11-2f9252c4dc2f,AIRDROP,0
airdrop-20181115-hdac-39497a55-d0b0-49df-82f7-ead4bab6058b-withdrawal-exchange,2018.11.15 10:11,UNKNOWN,,UNKNOWN-55c0f2b7-dc24-425b-9be8-6b86719f2865,2018.11.15 10:11,UNKNOWN,0,100,0,HDAC,WITHDRAWAL,,,,0,COMPLETED,0,sum-user-id,1863015.894,airdrop-20181115-hdac-sum-user-id-withdrawal,accac570-de75-11e8-bd11-2f9252c4dc2f,AIRDROP,0
airdrop-20181115-hdac-395d57cf-0288-4896-a7c5-1c105d960c75-withdrawal-exchange,2018.11.15 10:11,UNKNOWN,,UNKNOWN-55c0f2b7-dc24-425b-9be8-6b86719f2865,2018.11.15 10:11,UNKNOWN,0,100,0,HDAC,WITHDRAWAL,,,,0,COMPLETED,0,sum-user-id,1862915.894,airdrop-20181115-hdac-sum-user-id-withdrawal,accac570-de75-11e8-bd11-2f9252c4dc2f,AIRDROP,0
airdrop-20181115-hdac-395d90e3-200f-4701-a338-4d944bb20911-withdrawal-exchange,2018.11.15 10:11,UNKNOWN,,UNKNOWN-55c0f2b7-dc24-425b-9be8-6b86719f2865,2018.11.15 10:11,UNKNOWN,0,100,0,HDAC,WITHDRAWAL,,,,0,COMPLETED,0,sum-user-id,1862815.894,airdrop-20181115-hdac-sum-user-id-withdrawal,accac570-de75-11e8-bd11-2f9252c4dc2f,AIRDROP,0
airdrop-20181115-hdac-397b376d-9327-4a6c-bc52-5c5f179a1d5c-withdrawal-exchange,2018.11.15 10:11,UNKNOWN,,UNKNOWN-55c0f2b7-dc24-425b-9be8-6b86719f2865,2018.11.15 10:11,UNKNOWN,0,100,0,HDAC,WITHDRAWAL,,,,0,COMPLETED,0,sum-user-id,1862715.894,airdrop-20181115-hdac-sum-user-id-withdrawal,accac570-de75-11e8-bd11-2f9252c4dc2f,AIRDROP,0
airdrop-20181115-hdac-398f5b71-2dfb-4d8a-a02a-603381be4b4f-withdrawal-exchange,2018.11.15 10:11,UNKNOWN,,UNKNOWN-55c0f2b7-dc24-425b-9be8-6b86719f2865,2018.11.15 10:11,UNKNOWN,0,100,0,HDAC,WITHDRAWAL,,,,0,COMPLETED,0,sum-user-id,1862615.894,airdrop-20181115-hdac-sum-user-id-withdrawal,accac570-de75-11e8-bd11-2f9252c4dc2f,AIRDROP,0
airdrop-20181115-hdac-399e64ea-404f-43f1-a21c-6ebce1b1807b-withdrawal-exchange,2018.11.15 10:11,UNKNOWN,,UNKNOWN-55c0f2b7-dc24-425b-9be8-6b86719f2865,2018.11.15 10:11,UNKNOWN,0,100,0,HDAC,WITHDRAWAL,,,,0,COMPLETED,0,sum-user-id,1862515.894,airdrop-20181115-hdac-sum-user-id-withdrawal,accac570-de75-11e8-bd11-2f9252c4dc2f,AIRDROP,0
airdrop-20181115-hdac-39abc5fe-767f-4156-8186-3dad063096f7-withdrawal-exchange,2018.11.15 10:11,UNKNOWN,,UNKNOWN-55c0f2b7-dc24-425b-9be8-6b86719f2865,2018.11.15 10:11,UNKNOWN,0,100,0,HDAC,WITHDRAWAL,,,,0,COMPLETED,0,sum-user-id,1862415.894,airdrop-20181115-hdac-sum-user-id-withdrawal,accac570-de75-11e8-bd11-2f9252c4dc2f,AIRDROP,0
airdrop-20181115-hdac-39d7ab06-040a-43f1-aa30-a02cd442d428-withdrawal-exchange,2018.11.15 10:11,UNKNOWN,,UNKNOWN-55c0f2b7-dc24-425b-9be8-6b86719f2865,2018.11.15 10:11,UNKNOWN,0,100,0,HDAC,WITHDRAWAL,,,,0,COMPLETED,0,sum-user-id,1862315.894,airdrop-20181115-hdac-sum-user-id-withdrawal,accac570-de75-11e8-bd11-2f9252c4dc2f,AIRDROP,0
airdrop-20181115-hdac-39e71c13-5199-425b-8b3c-49b71e8793ed-withdrawal-exchange,2018.11.15 10:11,UNKNOWN,,UNKNOWN-55c0f2b7-dc24-425b-9be8-6b86719f2865,2018.11.15 10:11,UNKNOWN,0,100,0,HDAC,WITHDRAWAL,,,,0,COMPLETED,0,sum-user-id,1862215.894,airdrop-20181115-hdac-sum-user-id-withdrawal,accac570-de75-11e8-bd11-2f9252c4dc2f,AIRDROP,0
airdrop-20181115-hdac-3a14c316-7a59-4e6a-b4f7-5a69aa1ab21d-withdrawal-exchange,2018.11.15 10:11,UNKNOWN,,UNKNOWN-55c0f2b7-dc24-425b-9be8-6b86719f2865,2018.11.15 10:11,UNKNOWN,0,49,0,HDAC,WITHDRAWAL,,,,0,COMPLETED,0,sum-user-id,1862166.894,airdrop-20181115-hdac-sum-user-id-withdrawal,accac570-de75-11e8-bd11-2f9252c4dc2f,AIRDROP,0
airdrop-20181115-hdac-3a504532-1397-48fd-8ab3-c98a0f73c356-withdrawal-exchange,2018.11.15 10:11,UNKNOWN,,UNKNOWN-55c0f2b7-dc24-425b-9be8-6b86719f2865,2018.11.15 10:11,UNKNOWN,0,100,0,HDAC,WITHDRAWAL,,,,0,COMPLETED,0,sum-user-id,1862066.894,airdrop-20181115-hdac-sum-user-id-withdrawal,accac570-de75-11e8-bd11-2f9252c4dc2f,AIRDROP,0
airdrop-20181115-hdac-3a572c0c-6b42-45de-93ad-32724bf86189-withdrawal-exchange,2018.11.15 10:11,UNKNOWN,,UNKNOWN-55c0f2b7-dc24-425b-9be8-6b86719f2865,2018.11.15 10:11,UNKNOWN,0,100,0,HDAC,WITHDRAWAL,,,,0,COMPLETED,0,sum-user-id,1861966.894,airdrop-20181115-hdac-sum-user-id-withdrawal,accac570-de75-11e8-bd11-2f9252c4dc2f,AIRDROP,0
airdrop-20181115-hdac-3a63cde5-fa6e-4375-8b03-c1ac02c1c600-withdrawal-exchange,2018.11.15 10:12,UNKNOWN,,UNKNOWN-55c0f2b7-dc24-425b-9be8-6b86719f2865,2018.11.15 10:12,UNKNOWN,0,7421.144511,0,HDAC,WITHDRAWAL,,,,0,COMPLETED,0,sum-user-id,1314630.96,airdrop-20181115-hdac-sum-user-id-withdrawal,accac570-de75-11e8-bd11-2f9252c4dc2f,AIRDROP,0
airdrop-20181115-hdac-3a6c35a3-8869-4f55-80b0-c4ef746aa12e-withdrawal-exchange,2018.11.15 10:11,UNKNOWN,,UNKNOWN-55c0f2b7-dc24-425b-9be8-6b86719f2865,2018.11.15 10:11,UNKNOWN,0,100,0,HDAC,WITHDRAWAL,,,,0,COMPLETED,0,sum-user-id,1861866.894,airdrop-20181115-hdac-sum-user-id-withdrawal,accac570-de75-11e8-bd11-2f9252c4dc2f,AIRDROP,0
airdrop-20181115-hdac-3a8757e9-8882-4570-b69d-a11671a4dfbb-withdrawal-exchange,2018.11.15 10:11,UNKNOWN,,UNKNOWN-55c0f2b7-dc24-425b-9be8-6b86719f2865,2018.11.15 10:11,UNKNOWN,0,100,0,HDAC,WITHDRAWAL,,,,0,COMPLETED,0,sum-user-id,1861766.894,airdrop-20181115-hdac-sum-user-id-withdrawal,accac570-de75-11e8-bd11-2f9252c4dc2f,AIRDROP,0
airdrop-20181115-hdac-3a8aa4bd-7f28-4417-8335-488f76516a10-withdrawal-exchange,2018.11.15 10:11,UNKNOWN,,UNKNOWN-55c0f2b7-dc24-425b-9be8-6b86719f2865,2018.11.15 10:11,UNKNOWN,0,100,0,HDAC,WITHDRAWAL,,,,0,COMPLETED,0,sum-user-id,1861666.894,airdrop-20181115-hdac-sum-user-id-withdrawal,accac570-de75-11e8-bd11-2f9252c4dc2f,AIRDROP,0
airdrop-20181115-hdac-3a957e29-1664-41b9-b508-0807c9928f45-withdrawal-exchange,2018.11.15 10:11,UNKNOWN,,UNKNOWN-55c0f2b7-dc24-425b-9be8-6b86719f2865,2018.11.15 10:11,UNKNOWN,0,100,0,HDAC,WITHDRAWAL,,,,0,COMPLETED,0,sum-user-id,1861566.894,airdrop-20181115-hdac-sum-user-id-withdrawal,accac570-de75-11e8-bd11-2f9252c4dc2f,AIRDROP,0
airdrop-20181115-hdac-3aa1eda5-815f-4a18-bdfb-e0b9fcd95f10-withdrawal-exchange,2018.11.15 10:11,UNKNOWN,,UNKNOWN-55c0f2b7-dc24-425b-9be8-6b86719f2865,2018.11.15 10:11,UNKNOWN,0,100,0,HDAC,WITHDRAWAL,,,,0,COMPLETED,0,sum-user-id,1861466.894,airdrop-20181115-hdac-sum-user-id-withdrawal,accac570-de75-11e8-bd11-2f9252c4dc2f,AIRDROP,0
airdrop-20181115-hdac-3aa88f3c-8973-4af3-8025-8c0c163c6f66-withdrawal-exchange,2018.11.15 10:11,UNKNOWN,,UNKNOWN-55c0f2b7-dc24-425b-9be8-6b86719f2865,2018.11.15 10:11,UNKNOWN,0,100,0,HDAC,WITHDRAWAL,,,,0,COMPLETED,0,sum-user-id,1861366.894,airdrop-20181115-hdac-sum-user-id-withdrawal,accac570-de75-11e8-bd11-2f9252c4dc2f,AIRDROP,0
airdrop-20181115-hdac-3ac3b0dd-a5f8-4e91-9f62-d6b7e9ab9451-withdrawal-exchange,2018.11.15 10:11,UNKNOWN,,UNKNOWN-55c0f2b7-dc24-425b-9be8-6b86719f2865,2018.11.15 10:11,UNKNOWN,0,100,0,HDAC,WITHDRAWAL,,,,0,COMPLETED,0,sum-user-id,1861266.894,airdrop-20181115-hdac-sum-user-id-withdrawal,accac570-de75-11e8-bd11-2f9252c4dc2f,AIRDROP,0
airdrop-20181115-hdac-3acef184-7b27-4c8c-a83b-cc9b7e3ff6e8-withdrawal-exchange,2018.11.15 10:12,UNKNOWN,,UNKNOWN-55c0f2b7-dc24-425b-9be8-6b86719f2865,2018.11.15 10:12,UNKNOWN,0,10100,0,HDAC,WITHDRAWAL,,,,0,COMPLETED,0,sum-user-id,1304530.96,airdrop-20181115-hdac-sum-user-id-withdrawal,accac570-de75-11e8-bd11-2f9252c4dc2f,AIRDROP,0
airdrop-20181115-hdac-3b0ba4e2-842b-4e04-82c6-e23c4b0f98e5-withdrawal-exchange,2018-11-15 10:11:26.031,UNKNOWN,,UNKNOWN-55c0f2b7-dc24-425b-9be8-6b86719f2865,2018-11-15 10:11:26.031,UNKNOWN,0,100,0,HDAC,WITHDRAWAL,,,,0,COMPLETED,0,sum-user-id,1861166.894,airdrop-20181115-hdac-sum-user-id-withdrawal,accac570-de75-11e8-bd11-2f9252c4dc2f,AIRDROP,0
airdrop-20181115-hdac-3b13c971-e4fa-46d4-b011-aabb232ad7db-withdrawal-exchange,2018-11-15 10:11:26.063,UNKNOWN,,UNKNOWN-55c0f2b7-dc24-425b-9be8-6b86719f2865,2018-11-15 10:11:26.063,UNKNOWN,0,100,0,HDAC,WITHDRAWAL,,,,0,COMPLETED,0,sum-user-id,1861066.894,airdrop-20181115-hdac-sum-user-id-withdrawal,accac570-de75-11e8-bd11-2f9252c4dc2f,AIRDROP,0
airdrop-20181115-hdac-3b2bba5c-8131-44d8-aedc-3b9c56cc27c3-withdrawal-exchange,2018-11-15 10:11:26.097,UNKNOWN,,UNKNOWN-55c0f2b7-dc24-425b-9be8-6b86719f2865,2018-11-15 10:11:26.097,UNKNOWN,0,100,0,HDAC,WITHDRAWAL,,,,0,COMPLETED,0,sum-user-id,1860966.894,airdrop-20181115-hdac-sum-user-id-withdrawal,accac570-de75-11e8-bd11-2f9252c4dc2f,AIRDROP,0
airdrop-20181115-hdac-3b2cdc0f-4c87-466c-a666-20ea6abd9615-withdrawal-exchange,2018.11.15 10:11,UNKNOWN,,UNKNOWN-55c0f2b7-dc24-425b-9be8-6b86719f2865,2018.11.15 10:11,UNKNOWN,0,100,0,HDAC,WITHDRAWAL,,,,0,COMPLETED,0,sum-user-id,1860866.894,airdrop-20181115-hdac-sum-user-id-withdrawal,accac570-de75-11e8-bd11-2f9252c4dc2f,AIRDROP,0
airdrop-20181115-hdac-3b4296dc-d0d9-4c35-80ff-875011923ef6-withdrawal-exchange,2018.11.15 10:11,UNKNOWN,,UNKNOWN-55c0f2b7-dc24-425b-9be8-6b86719f2865,2018.11.15 10:11,UNKNOWN,0,100,0,HDAC,WITHDRAWAL,,,,0,COMPLETED,0,sum-user-id,1860766.894,airdrop-20181115-hdac-sum-user-id-withdrawal,accac570-de75-11e8-bd11-2f9252c4dc2f,AIRDROP,0
airdrop-20181115-hdac-3b58f23c-8079-482f-a8b6-067f25868f03-withdrawal-exchange,2018.11.15 10:11,UNKNOWN,,UNKNOWN-55c0f2b7-dc24-425b-9be8-6b86719f2865,2018.11.15 10:11,UNKNOWN,0,100,0,HDAC,WITHDRAWAL,,,,0,COMPLETED,0,sum-user-id,1860666.894,airdrop-20181115-hdac-sum-user-id-withdrawal,accac570-de75-11e8-bd11-2f9252c4dc2f,AIRDROP,0
airdrop-20181115-hdac-3b63de01-638d-479e-b950-545f78c311a4-withdrawal-exchange,2018.11.15 10:11,UNKNOWN,,UNKNOWN-55c0f2b7-dc24-425b-9be8-6b86719f2865,2018.11.15 10:11,UNKNOWN,0,100,0,HDAC,WITHDRAWAL,,,,0,COMPLETED,0,sum-user-id,1860566.894,airdrop-20181115-hdac-sum-user-id-withdrawal,accac570-de75-11e8-bd11-2f9252c4dc2f,AIRDROP,0
airdrop-20181115-hdac-3b8363fe-5e8c-4658-a6a6-7dd6c1e5d4ed-withdrawal-exchange,2018.11.15 10:11,UNKNOWN,,UNKNOWN-55c0f2b7-dc24-425b-9be8-6b86719f2865,2018.11.15 10:11,UNKNOWN,0,100,0,HDAC,WITHDRAWAL,,,,0,COMPLETED,0,sum-user-id,1860466.894,airdrop-20181115-hdac-sum-user-id-withdrawal,accac570-de75-11e8-bd11-2f9252c4dc2f,AIRDROP,0
airdrop-20181115-hdac-3b920b10-85e8-4826-b5cc-db0bb02c8951-withdrawal-exchange,2018.11.15 10:11,UNKNOWN,,UNKNOWN-55c0f2b7-dc24-425b-9be8-6b86719f2865,2018.11.15 10:11,UNKNOWN,0,100,0,HDAC,WITHDRAWAL,,,,0,COMPLETED,0,sum-user-id,1860366.894,airdrop-20181115-hdac-sum-user-id-withdrawal,accac570-de75-11e8-bd11-2f9252c4dc2f,AIRDROP,0
airdrop-20181115-hdac-3c1559f4-3a07-4377-8748-349401b5460e-withdrawal-exchange,2018.11.15 10:11,UNKNOWN,,UNKNOWN-55c0f2b7-dc24-425b-9be8-6b86719f2865,2018.11.15 10:11,UNKNOWN,0,100,0,HDAC,WITHDRAWAL,,,,0,COMPLETED,0,sum-user-id,1860266.894,airdrop-20181115-hdac-sum-user-id-withdrawal,accac570-de75-11e8-bd11-2f9252c4dc2f,AIRDROP,0
airdrop-20181115-hdac-3c2a426a-18e8-439a-8f41-3346fdf966b4-withdrawal-exchange,2018.11.15 10:11,UNKNOWN,,UNKNOWN-55c0f2b7-dc24-425b-9be8-6b86719f2865,2018.11.15 10:11,UNKNOWN,0,100,0,HDAC,WITHDRAWAL,,,,0,COMPLETED,0,sum-user-id,1860166.894,airdrop-20181115-hdac-sum-user-id-withdrawal,accac570-de75-11e8-bd11-2f9252c4dc2f,AIRDROP,0
airdrop-20181115-hdac-3c352ad2-34c1-4cde-aad1-742b26304377-withdrawal-exchange,2018.11.15 10:11,UNKNOWN,,UNKNOWN-55c0f2b7-dc24-425b-9be8-6b86719f2865,2018.11.15 10:11,UNKNOWN,0,100,0,HDAC,WITHDRAWAL,,,,0,COMPLETED,0,sum-user-id,1860066.894,airdrop-20181115-hdac-sum-user-id-withdrawal,accac570-de75-11e8-bd11-2f9252c4dc2f,AIRDROP,0
airdrop-20181115-hdac-3c9f0901-8102-4f08-8125-6b0100cae2b3-withdrawal-exchange,2018.11.15 10:11,UNKNOWN,,UNKNOWN-55c0f2b7-dc24-425b-9be8-6b86719f2865,2018.11.15 10:11,UNKNOWN,0,100,0,HDAC,WITHDRAWAL,,,,0,COMPLETED,0,sum-user-id,1859966.894,airdrop-20181115-hdac-sum-user-id-withdrawal,accac570-de75-11e8-bd11-2f9252c4dc2f,AIRDROP,0
airdrop-20181115-hdac-3d0d43e5-5fa5-4b30-ad21-9f7a026ec3e0-withdrawal-exchange,2018.11.15 10:11,UNKNOWN,,UNKNOWN-55c0f2b7-dc24-425b-9be8-6b86719f2865,2018.11.15 10:11,UNKNOWN,0,100,0,HDAC,WITHDRAWAL,,,,0,COMPLETED,0,sum-user-id,1859866.894,airdrop-20181115-hdac-sum-user-id-withdrawal,accac570-de75-11e8-bd11-2f9252c4dc2f,AIRDROP,0
airdrop-20181115-hdac-3d189207-f713-49b7-a5f1-7a59aefa8f6b-withdrawal-exchange,2018.11.15 10:11,UNKNOWN,,UNKNOWN-55c0f2b7-dc24-425b-9be8-6b86719f2865,2018.11.15 10:11,UNKNOWN,0,100,0,HDAC,WITHDRAWAL,,,,0,COMPLETED,0,sum-user-id,1859766.894,airdrop-20181115-hdac-sum-user-id-withdrawal,accac570-de75-11e8-bd11-2f9252c4dc2f,AIRDROP,0
airdrop-20181115-hdac-3d1c3723-cb3e-4c9d-8239-f87165dbb28b-withdrawal-exchange,2018.11.15 10:11,UNKNOWN,,UNKNOWN-55c0f2b7-dc24-425b-9be8-6b86719f2865,2018.11.15 10:11,UNKNOWN,0,100,0,HDAC,WITHDRAWAL,,,,0,COMPLETED,0,sum-user-id,1859666.894,airdrop-20181115-hdac-sum-user-id-withdrawal,accac570-de75-11e8-bd11-2f9252c4dc2f,AIRDROP,0
airdrop-20181115-hdac-3d6bd38a-8c0d-4ded-a338-2419e686d0df-withdrawal-exchange,2018.11.15 10:11,UNKNOWN,,UNKNOWN-55c0f2b7-dc24-425b-9be8-6b86719f2865,2018.11.15 10:11,UNKNOWN,0,100,0,HDAC,WITHDRAWAL,,,,0,COMPLETED,0,sum-user-id,1859566.894,airdrop-20181115-hdac-sum-user-id-withdrawal,accac570-de75-11e8-bd11-2f9252c4dc2f,AIRDROP,0
airdrop-20181115-hdac-3daeafe1-ef2c-43e2-b511-afda044af5b8-withdrawal-exchange,2018.11.15 10:11,UNKNOWN,,UNKNOWN-55c0f2b7-dc24-425b-9be8-6b86719f2865,2018.11.15 10:11,UNKNOWN,0,100,0,HDAC,WITHDRAWAL,,,,0,COMPLETED,0,sum-user-id,1859466.894,airdrop-20181115-hdac-sum-user-id-withdrawal,accac570-de75-11e8-bd11-2f9252c4dc2f,AIRDROP,0
airdrop-20181115-hdac-3dcf04da-7257-4fe8-9b9f-0d61bd18870a-withdrawal-exchange,2018.11.15 10:11,UNKNOWN,,UNKNOWN-55c0f2b7-dc24-425b-9be8-6b86719f2865,2018.11.15 10:11,UNKNOWN,0,100,0,HDAC,WITHDRAWAL,,,,0,COMPLETED,0,sum-user-id,1859366.894,airdrop-20181115-hdac-sum-user-id-withdrawal,accac570-de75-11e8-bd11-2f9252c4dc2f,AIRDROP,0
airdrop-20181115-hdac-3e00d7ee-44e6-4494-b383-a4c89801a557-withdrawal-exchange,2018.11.15 10:11,UNKNOWN,,UNKNOWN-55c0f2b7-dc24-425b-9be8-6b86719f2865,2018.11.15 10:11,UNKNOWN,0,100,0,HDAC,WITHDRAWAL,,,,0,COMPLETED,0,sum-user-id,1859266.894,airdrop-20181115-hdac-sum-user-id-withdrawal,accac570-de75-11e8-bd11-2f9252c4dc2f,AIRDROP,0
airdrop-20181115-hdac-3e18c1cf-0d79-4066-9c96-4eee79f95cfd-withdrawal-exchange,2018.11.15 10:11,UNKNOWN,,UNKNOWN-55c0f2b7-dc24-425b-9be8-6b86719f2865,2018.11.15 10:11,UNKNOWN,0,100,0,HDAC,WITHDRAWAL,,,,0,COMPLETED,0,sum-user-id,1859166.894,airdrop-20181115-hdac-sum-user-id-withdrawal,accac570-de75-11e8-bd11-2f9252c4dc2f,AIRDROP,0
airdrop-20181115-hdac-3e45926b-0358-4a0d-99ae-0a4e4ed9d2be-withdrawal-exchange,2018.11.15 10:11,UNKNOWN,,UNKNOWN-55c0f2b7-dc24-425b-9be8-6b86719f2865,2018.11.15 10:11,UNKNOWN,0,100,0,HDAC,WITHDRAWAL,,,,0,COMPLETED,0,sum-user-id,1859066.894,airdrop-20181115-hdac-sum-user-id-withdrawal,accac570-de75-11e8-bd11-2f9252c4dc2f,AIRDROP,0
airdrop-20181115-hdac-3e50b5c6-1300-4391-8e25-ce87dda86a85-withdrawal-exchange,2018.11.15 10:11,UNKNOWN,,UNKNOWN-55c0f2b7-dc24-425b-9be8-6b86719f2865,2018.11.15 10:11,UNKNOWN,0,100,0,HDAC,WITHDRAWAL,,,,0,COMPLETED,0,sum-user-id,1858966.894,airdrop-20181115-hdac-sum-user-id-withdrawal,accac570-de75-11e8-bd11-2f9252c4dc2f,AIRDROP,0
airdrop-20181115-hdac-3e5cb938-ef27-4c93-b9a0-7474bd275153-withdrawal-exchange,2018.11.15 10:11,UNKNOWN,,UNKNOWN-55c0f2b7-dc24-425b-9be8-6b86719f2865,2018.11.15 10:11,UNKNOWN,0,100,0,HDAC,WITHDRAWAL,,,,0,COMPLETED,0,sum-user-id,1858866.894,airdrop-20181115-hdac-sum-user-id-withdrawal,accac570-de75-11e8-bd11-2f9252c4dc2f,AIRDROP,0
airdrop-20181115-hdac-3e8449d5-50a8-4952-931f-aa5fcc351a5f-withdrawal-exchange,2018.11.15 10:11,UNKNOWN,,UNKNOWN-55c0f2b7-dc24-425b-9be8-6b86719f2865,2018.11.15 10:11,UNKNOWN,0,100,0,HDAC,WITHDRAWAL,,,,0,COMPLETED,0,sum-user-id,1858766.894,airdrop-20181115-hdac-sum-user-id-withdrawal,accac570-de75-11e8-bd11-2f9252c4dc2f,AIRDROP,0
airdrop-20181115-hdac-3e85c8ec-077e-4d3c-b01b-e4ef145c69a0-withdrawal-exchange,2018.11.15 10:11,UNKNOWN,,UNKNOWN-55c0f2b7-dc24-425b-9be8-6b86719f2865,2018.11.15 10:11,UNKNOWN,0,100,0,HDAC,WITHDRAWAL,,,,0,COMPLETED,0,sum-user-id,1858666.894,airdrop-20181115-hdac-sum-user-id-withdrawal,accac570-de75-11e8-bd11-2f9252c4dc2f,AIRDROP,0
airdrop-20181115-hdac-3ea5b1ba-4f9e-4dbc-acac-061c1a58489f-withdrawal-exchange,2018.11.15 10:11,UNKNOWN,,UNKNOWN-55c0f2b7-dc24-425b-9be8-6b86719f2865,2018.11.15 10:11,UNKNOWN,0,100,0,HDAC,WITHDRAWAL,,,,0,COMPLETED,0,sum-user-id,1858566.894,airdrop-20181115-hdac-sum-user-id-withdrawal,accac570-de75-11e8-bd11-2f9252c4dc2f,AIRDROP,0
airdrop-20181115-hdac-3ec9df29-bae9-4f7f-960e-6eba94c663d4-withdrawal-exchange,2018.11.15 10:11,UNKNOWN,,UNKNOWN-55c0f2b7-dc24-425b-9be8-6b86719f2865,2018.11.15 10:11,UNKNOWN,0,100,0,HDAC,WITHDRAWAL,,,,0,COMPLETED,0,sum-user-id,1858466.894,airdrop-20181115-hdac-sum-user-id-withdrawal,accac570-de75-11e8-bd11-2f9252c4dc2f,AIRDROP,0
airdrop-20181115-hdac-3ed75e3b-7b21-4bc7-aa42-4d330175dbba-withdrawal-exchange,2018.11.15 10:11,UNKNOWN,,UNKNOWN-55c0f2b7-dc24-425b-9be8-6b86719f2865,2018.11.15 10:11,UNKNOWN,0,2995.624011,0,HDAC,WITHDRAWAL,,,,0,COMPLETED,0,sum-user-id,1855471.27,airdrop-20181115-hdac-sum-user-id-withdrawal,accac570-de75-11e8-bd11-2f9252c4dc2f,AIRDROP,0
airdrop-20181115-hdac-3ee01f81-b5f0-418f-8a3a-a0999e9268f0-withdrawal-exchange,2018.11.15 10:11,UNKNOWN,,UNKNOWN-55c0f2b7-dc24-425b-9be8-6b86719f2865,2018.11.15 10:11,UNKNOWN,0,100,0,HDAC,WITHDRAWAL,,,,0,COMPLETED,0,sum-user-id,1855371.27,airdrop-20181115-hdac-sum-user-id-withdrawal,accac570-de75-11e8-bd11-2f9252c4dc2f,AIRDROP,0
airdrop-20181115-hdac-3eff9d42-69ae-4afe-ba1c-462b2796c4d7-withdrawal-exchange,2018-11-15 10:11:27.004,UNKNOWN,,UNKNOWN-55c0f2b7-dc24-425b-9be8-6b86719f2865,2018-11-15 10:11:27.004,UNKNOWN,0,100,0,HDAC,WITHDRAWAL,,,,0,COMPLETED,0,sum-user-id,1855271.27,airdrop-20181115-hdac-sum-user-id-withdrawal,accac570-de75-11e8-bd11-2f9252c4dc2f,AIRDROP,0
airdrop-20181115-hdac-3f0679cc-570e-4118-b2b9-87213ca7cbb8-withdrawal-exchange,2018-11-15 10:11:27.037,UNKNOWN,,UNKNOWN-55c0f2b7-dc24-425b-9be8-6b86719f2865,2018-11-15 10:11:27.037,UNKNOWN,0,100,0,HDAC,WITHDRAWAL,,,,0,COMPLETED,0,sum-user-id,1855171.27,airdrop-20181115-hdac-sum-user-id-withdrawal,accac570-de75-11e8-bd11-2f9252c4dc2f,AIRDROP,0
airdrop-20181115-hdac-3f0c0f22-ab4b-4c99-95a6-4c156463f59e-withdrawal-exchange,2018-11-15 10:11:27.087,UNKNOWN,,UNKNOWN-55c0f2b7-dc24-425b-9be8-6b86719f2865,2018-11-15 10:11:27.087,UNKNOWN,0,100,0,HDAC,WITHDRAWAL,,,,0,COMPLETED,0,sum-user-id,1855071.27,airdrop-20181115-hdac-sum-user-id-withdrawal,accac570-de75-11e8-bd11-2f9252c4dc2f,AIRDROP,0
airdrop-20181115-hdac-3f0e1b41-8df2-4231-b988-63826dd7a791-withdrawal-exchange,2018.11.15 10:11,UNKNOWN,,UNKNOWN-55c0f2b7-dc24-425b-9be8-6b86719f2865,2018.11.15 10:11,UNKNOWN,0,100,0,HDAC,WITHDRAWAL,,,,0,COMPLETED,0,sum-user-id,1854971.27,airdrop-20181115-hdac-sum-user-id-withdrawal,accac570-de75-11e8-bd11-2f9252c4dc2f,AIRDROP,0
airdrop-20181115-hdac-3f28d7e3-bfca-4e1b-8c31-f55ded9bfd33-withdrawal-exchange,2018.11.15 10:11,UNKNOWN,,UNKNOWN-55c0f2b7-dc24-425b-9be8-6b86719f2865,2018.11.15 10:11,UNKNOWN,0,100,0,HDAC,WITHDRAWAL,,,,0,COMPLETED,0,sum-user-id,1854871.27,airdrop-20181115-hdac-sum-user-id-withdrawal,accac570-de75-11e8-bd11-2f9252c4dc2f,AIRDROP,0
airdrop-20181115-hdac-3f6bee48-7187-42fa-954e-6f3db65b3542-withdrawal-exchange,2018.11.15 10:11,UNKNOWN,,UNKNOWN-55c0f2b7-dc24-425b-9be8-6b86719f2865,2018.11.15 10:11,UNKNOWN,0,100,0,HDAC,WITHDRAWAL,,,,0,COMPLETED,0,sum-user-id,1854771.27,airdrop-20181115-hdac-sum-user-id-withdrawal,accac570-de75-11e8-bd11-2f9252c4dc2f,AIRDROP,0
airdrop-20181115-hdac-3fd992ad-9f32-4980-8c22-ea388c551831-withdrawal-exchange,2018.11.15 10:11,UNKNOWN,,UNKNOWN-55c0f2b7-dc24-425b-9be8-6b86719f2865,2018.11.15 10:11,UNKNOWN,0,100,0,HDAC,WITHDRAWAL,,,,0,COMPLETED,0,sum-user-id,1854671.27,airdrop-20181115-hdac-sum-user-id-withdrawal,accac570-de75-11e8-bd11-2f9252c4dc2f,AIRDROP,0
airdrop-20181115-hdac-3fe9060b-2bef-4dda-b54f-95d4e3bd4abd-withdrawal-exchange,2018.11.15 10:11,UNKNOWN,,UNKNOWN-55c0f2b7-dc24-425b-9be8-6b86719f2865,2018.11.15 10:11,UNKNOWN,0,100,0,HDAC,WITHDRAWAL,,,,0,COMPLETED,0,sum-user-id,1854571.27,airdrop-20181115-hdac-sum-user-id-withdrawal,accac570-de75-11e8-bd11-2f9252c4dc2f,AIRDROP,0
airdrop-20181115-hdac-3ff947e0-66ee-42bd-829f-adaea24e555f-withdrawal-exchange,2018.11.15 10:11,UNKNOWN,,UNKNOWN-55c0f2b7-dc24-425b-9be8-6b86719f2865,2018.11.15 10:11,UNKNOWN,0,100,0,HDAC,WITHDRAWAL,,,,0,COMPLETED,0,sum-user-id,1854471.27,airdrop-20181115-hdac-sum-user-id-withdrawal,accac570-de75-11e8-bd11-2f9252c4dc2f,AIRDROP,0
airdrop-20181115-hdac-402888eb-e986-40cd-9992-d597786f8323-withdrawal-exchange,2018.11.15 10:11,UNKNOWN,,UNKNOWN-55c0f2b7-dc24-425b-9be8-6b86719f2865,2018.11.15 10:11,UNKNOWN,0,100,0,HDAC,WITHDRAWAL,,,,0,COMPLETED,0,sum-user-id,1854371.27,airdrop-20181115-hdac-sum-user-id-withdrawal,accac570-de75-11e8-bd11-2f9252c4dc2f,AIRDROP,0
airdrop-20181115-hdac-405c1ac8-197f-48a3-aeba-2b47a7107956-withdrawal-exchange,2018.11.15 10:11,UNKNOWN,,UNKNOWN-55c0f2b7-dc24-425b-9be8-6b86719f2865,2018.11.15 10:11,UNKNOWN,0,100,0,HDAC,WITHDRAWAL,,,,0,COMPLETED,0,sum-user-id,1854271.27,airdrop-20181115-hdac-sum-user-id-withdrawal,accac570-de75-11e8-bd11-2f9252c4dc2f,AIRDROP,0
airdrop-20181115-hdac-408e8dc7-2aa2-4e59-a8c2-388fc985a6d2-withdrawal-exchange,2018.11.15 10:11,UNKNOWN,,UNKNOWN-55c0f2b7-dc24-425b-9be8-6b86719f2865,2018.11.15 10:11,UNKNOWN,0,100,0,HDAC,WITHDRAWAL,,,,0,COMPLETED,0,sum-user-id,1854171.27,airdrop-20181115-hdac-sum-user-id-withdrawal,accac570-de75-11e8-bd11-2f9252c4dc2f,AIRDROP,0
airdrop-20181115-hdac-40ad375b-e2d1-4bae-9098-58cf4c524f50-withdrawal-exchange,2018.11.15 10:11,UNKNOWN,,UNKNOWN-55c0f2b7-dc24-425b-9be8-6b86719f2865,2018.11.15 10:11,UNKNOWN,0,100,0,HDAC,WITHDRAWAL,,,,0,COMPLETED,0,sum-user-id,1854071.27,airdrop-20181115-hdac-sum-user-id-withdrawal,accac570-de75-11e8-bd11-2f9252c4dc2f,AIRDROP,0
airdrop-20181115-hdac-40ad67f2-4892-4973-890e-598eede6eed1-withdrawal-exchange,2018.11.15 10:11,UNKNOWN,,UNKNOWN-55c0f2b7-dc24-425b-9be8-6b86719f2865,2018.11.15 10:11,UNKNOWN,0,100,0,HDAC,WITHDRAWAL,,,,0,COMPLETED,0,sum-user-id,1853971.27,airdrop-20181115-hdac-sum-user-id-withdrawal,accac570-de75-11e8-bd11-2f9252c4dc2f,AIRDROP,0
airdrop-20181115-hdac-40b1a6ed-559f-45c4-b7af-566a9d1d4df5-withdrawal-exchange,2018.11.15 10:11,UNKNOWN,,UNKNOWN-55c0f2b7-dc24-425b-9be8-6b86719f2865,2018.11.15 10:11,UNKNOWN,0,100,0,HDAC,WITHDRAWAL,,,,0,COMPLETED,0,sum-user-id,1853871.27,airdrop-20181115-hdac-sum-user-id-withdrawal,accac570-de75-11e8-bd11-2f9252c4dc2f,AIRDROP,0
airdrop-20181115-hdac-40bef2e4-e0b9-4b67-b58c-23a78b30712d-withdrawal-exchange,2018.11.15 10:11,UNKNOWN,,UNKNOWN-55c0f2b7-dc24-425b-9be8-6b86719f2865,2018.11.15 10:11,UNKNOWN,0,100,0,HDAC,WITHDRAWAL,,,,0,COMPLETED,0,sum-user-id,1853771.27,airdrop-20181115-hdac-sum-user-id-withdrawal,accac570-de75-11e8-bd11-2f9252c4dc2f,AIRDROP,0
airdrop-20181115-hdac-40ea31ed-e9d6-4bb7-a5f5-ab8add6a2cac-withdrawal-exchange,2018.11.15 10:11,UNKNOWN,,UNKNOWN-55c0f2b7-dc24-425b-9be8-6b86719f2865,2018.11.15 10:11,UNKNOWN,0,100,0,HDAC,WITHDRAWAL,,,,0,COMPLETED,0,sum-user-id,1853671.27,airdrop-20181115-hdac-sum-user-id-withdrawal,accac570-de75-11e8-bd11-2f9252c4dc2f,AIRDROP,0
airdrop-20181115-hdac-40fa6253-87ee-4951-a8b7-3d671584b936-withdrawal-exchange,2018.11.15 10:11,UNKNOWN,,UNKNOWN-55c0f2b7-dc24-425b-9be8-6b86719f2865,2018.11.15 10:11,UNKNOWN,0,100,0,HDAC,WITHDRAWAL,,,,0,COMPLETED,0,sum-user-id,1853571.27,airdrop-20181115-hdac-sum-user-id-withdrawal,accac570-de75-11e8-bd11-2f9252c4dc2f,AIRDROP,0
airdrop-20181115-hdac-410aa3af-c920-48e8-9bce-d053dfe7713c-withdrawal-exchange,2018.11.15 10:11,UNKNOWN,,UNKNOWN-55c0f2b7-dc24-425b-9be8-6b86719f2865,2018.11.15 10:11,UNKNOWN,0,100,0,HDAC,WITHDRAWAL,,,,0,COMPLETED,0,sum-user-id,1853471.27,airdrop-20181115-hdac-sum-user-id-withdrawal,accac570-de75-11e8-bd11-2f9252c4dc2f,AIRDROP,0
airdrop-20181115-hdac-41189fd9-513a-46a7-a1ea-f74255410921-withdrawal-exchange,2018.11.15 10:11,UNKNOWN,,UNKNOWN-55c0f2b7-dc24-425b-9be8-6b86719f2865,2018.11.15 10:11,UNKNOWN,0,100,0,HDAC,WITHDRAWAL,,,,0,COMPLETED,0,sum-user-id,1853371.27,airdrop-20181115-hdac-sum-user-id-withdrawal,accac570-de75-11e8-bd11-2f9252c4dc2f,AIRDROP,0
airdrop-20181115-hdac-4129bb02-7ae2-4074-9970-5256e079acd8-withdrawal-exchange,2018.11.15 10:11,UNKNOWN,,UNKNOWN-55c0f2b7-dc24-425b-9be8-6b86719f2865,2018.11.15 10:11,UNKNOWN,0,100,0,HDAC,WITHDRAWAL,,,,0,COMPLETED,0,sum-user-id,1853271.27,airdrop-20181115-hdac-sum-user-id-withdrawal,accac570-de75-11e8-bd11-2f9252c4dc2f,AIRDROP,0
airdrop-20181115-hdac-414192ba-8bb3-4c75-8221-10de9bec7928-withdrawal-exchange,2018.11.15 10:11,UNKNOWN,,UNKNOWN-55c0f2b7-dc24-425b-9be8-6b86719f2865,2018.11.15 10:11,UNKNOWN,0,100,0,HDAC,WITHDRAWAL,,,,0,COMPLETED,0,sum-user-id,1853171.27,airdrop-20181115-hdac-sum-user-id-withdrawal,accac570-de75-11e8-bd11-2f9252c4dc2f,AIRDROP,0
airdrop-20181115-hdac-4179fd3b-7eff-4298-bbdc-5b9b7f421bd6-withdrawal-exchange,2018.11.15 10:11,UNKNOWN,,UNKNOWN-55c0f2b7-dc24-425b-9be8-6b86719f2865,2018.11.15 10:11,UNKNOWN,0,100,0,HDAC,WITHDRAWAL,,,,0,COMPLETED,0,sum-user-id,1853071.27,airdrop-20181115-hdac-sum-user-id-withdrawal,accac570-de75-11e8-bd11-2f9252c4dc2f,AIRDROP,0
airdrop-20181115-hdac-41eb5afa-0eb6-49a7-b0b7-22a20376560b-withdrawal-exchange,2018.11.15 10:11,UNKNOWN,,UNKNOWN-55c0f2b7-dc24-425b-9be8-6b86719f2865,2018.11.15 10:11,UNKNOWN,0,100,0,HDAC,WITHDRAWAL,,,,0,COMPLETED,0,sum-user-id,1852971.27,airdrop-20181115-hdac-sum-user-id-withdrawal,accac570-de75-11e8-bd11-2f9252c4dc2f,AIRDROP,0
airdrop-20181115-hdac-4208d0a4-145a-401e-934a-4ff451daf492-withdrawal-exchange,2018.11.15 10:11,UNKNOWN,,UNKNOWN-55c0f2b7-dc24-425b-9be8-6b86719f2865,2018.11.15 10:11,UNKNOWN,0,100,0,HDAC,WITHDRAWAL,,,,0,COMPLETED,0,sum-user-id,1852871.27,airdrop-20181115-hdac-sum-user-id-withdrawal,accac570-de75-11e8-bd11-2f9252c4dc2f,AIRDROP,0
airdrop-20181115-hdac-421c7397-d519-4e21-86e0-5770d9d2c05e-withdrawal-exchange,2018.11.15 10:12,UNKNOWN,,UNKNOWN-55c0f2b7-dc24-425b-9be8-6b86719f2865,2018.11.15 10:12,UNKNOWN,0,214,0,HDAC,WITHDRAWAL,,,,0,COMPLETED,0,sum-user-id,1304316.96,airdrop-20181115-hdac-sum-user-id-withdrawal,accac570-de75-11e8-bd11-2f9252c4dc2f,AIRDROP,0
airdrop-20181115-hdac-4252f400-f73d-42d1-801a-7eb3d8ba534e-withdrawal-exchange,2018.11.15 10:11,UNKNOWN,,UNKNOWN-55c0f2b7-dc24-425b-9be8-6b86719f2865,2018.11.15 10:11,UNKNOWN,0,100,0,HDAC,WITHDRAWAL,,,,0,COMPLETED,0,sum-user-id,1852771.27,airdrop-20181115-hdac-sum-user-id-withdrawal,accac570-de75-11e8-bd11-2f9252c4dc2f,AIRDROP,0
airdrop-20181115-hdac-4278ba68-ab6c-40ad-b17c-52944e129bb1-withdrawal-exchange,2018.11.15 10:11,UNKNOWN,,UNKNOWN-55c0f2b7-dc24-425b-9be8-6b86719f2865,2018.11.15 10:11,UNKNOWN,0,100,0,HDAC,WITHDRAWAL,,,,0,COMPLETED,0,sum-user-id,1852671.27,airdrop-20181115-hdac-sum-user-id-withdrawal,accac570-de75-11e8-bd11-2f9252c4dc2f,AIRDROP,0
airdrop-20181115-hdac-42e1a45a-a83c-4929-95d0-e12fc6ad13d4-withdrawal-exchange,2018.11.15 10:12,UNKNOWN,,UNKNOWN-55c0f2b7-dc24-425b-9be8-6b86719f2865,2018.11.15 10:12,UNKNOWN,0,167.605645,0,HDAC,WITHDRAWAL,,,,0,COMPLETED,0,sum-user-id,1304149.354,airdrop-20181115-hdac-sum-user-id-withdrawal,accac570-de75-11e8-bd11-2f9252c4dc2f,AIRDROP,0
airdrop-20181115-hdac-42f0b94d-199b-4065-a235-f18414e9a154-withdrawal-exchange,2018.11.15 10:11,UNKNOWN,,UNKNOWN-55c0f2b7-dc24-425b-9be8-6b86719f2865,2018.11.15 10:11,UNKNOWN,0,100,0,HDAC,WITHDRAWAL,,,,0,COMPLETED,0,sum-user-id,1852571.27,airdrop-20181115-hdac-sum-user-id-withdrawal,accac570-de75-11e8-bd11-2f9252c4dc2f,AIRDROP,0
airdrop-20181115-hdac-430cb7e6-d0ce-44a8-b76b-130707eedef5-withdrawal-exchange,2018.11.15 10:11,UNKNOWN,,UNKNOWN-55c0f2b7-dc24-425b-9be8-6b86719f2865,2018.11.15 10:11,UNKNOWN,0,100,0,HDAC,WITHDRAWAL,,,,0,COMPLETED,0,sum-user-id,1852471.27,airdrop-20181115-hdac-sum-user-id-withdrawal,accac570-de75-11e8-bd11-2f9252c4dc2f,AIRDROP,0
airdrop-20181115-hdac-43223795-ee49-45d8-bc64-07e6c05735b9-withdrawal-exchange,2018-11-15 10:11:28.028,UNKNOWN,,UNKNOWN-55c0f2b7-dc24-425b-9be8-6b86719f2865,2018-11-15 10:11:28.028,UNKNOWN,0,100,0,HDAC,WITHDRAWAL,,,,0,COMPLETED,0,sum-user-id,1852371.27,airdrop-20181115-hdac-sum-user-id-withdrawal,accac570-de75-11e8-bd11-2f9252c4dc2f,AIRDROP,0
airdrop-20181115-hdac-4338bca5-3706-428f-9b69-53cd1efd7600-withdrawal-exchange,2018-11-15 10:11:28.059,UNKNOWN,,UNKNOWN-55c0f2b7-dc24-425b-9be8-6b86719f2865,2018-11-15 10:11:28.059,UNKNOWN,0,100,0,HDAC,WITHDRAWAL,,,,0,COMPLETED,0,sum-user-id,1852271.27,airdrop-20181115-hdac-sum-user-id-withdrawal,accac570-de75-11e8-bd11-2f9252c4dc2f,AIRDROP,0
airdrop-20181115-hdac-434103fe-c0eb-4b0d-99dc-24a0870c8fe5-withdrawal-exchange,2018-11-15 10:11:28.094,UNKNOWN,,UNKNOWN-55c0f2b7-dc24-425b-9be8-6b86719f2865,2018-11-15 10:11:28.094,UNKNOWN,0,100,0,HDAC,WITHDRAWAL,,,,0,COMPLETED,0,sum-user-id,1852171.27,airdrop-20181115-hdac-sum-user-id-withdrawal,accac570-de75-11e8-bd11-2f9252c4dc2f,AIRDROP,0
airdrop-20181115-hdac-434692fb-9c12-45db-b62f-08b079740287-withdrawal-exchange,2018.11.15 10:11,UNKNOWN,,UNKNOWN-55c0f2b7-dc24-425b-9be8-6b86719f2865,2018.11.15 10:11,UNKNOWN,0,100,0,HDAC,WITHDRAWAL,,,,0,COMPLETED,0,sum-user-id,1852071.27,airdrop-20181115-hdac-sum-user-id-withdrawal,accac570-de75-11e8-bd11-2f9252c4dc2f,AIRDROP,0
airdrop-20181115-hdac-4353c074-1c05-414f-9894-2f692a9b627d-withdrawal-exchange,2018.11.15 10:11,UNKNOWN,,UNKNOWN-55c0f2b7-dc24-425b-9be8-6b86719f2865,2018.11.15 10:11,UNKNOWN,0,100,0,HDAC,WITHDRAWAL,,,,0,COMPLETED,0,sum-user-id,1851971.27,airdrop-20181115-hdac-sum-user-id-withdrawal,accac570-de75-11e8-bd11-2f9252c4dc2f,AIRDROP,0
airdrop-20181115-hdac-437c6723-865a-4e4a-bc80-20c41d757507-withdrawal-exchange,2018.11.15 10:11,UNKNOWN,,UNKNOWN-55c0f2b7-dc24-425b-9be8-6b86719f2865,2018.11.15 10:11,UNKNOWN,0,100,0,HDAC,WITHDRAWAL,,,,0,COMPLETED,0,sum-user-id,1851871.27,airdrop-20181115-hdac-sum-user-id-withdrawal,accac570-de75-11e8-bd11-2f9252c4dc2f,AIRDROP,0
airdrop-20181115-hdac-4380dcf8-f086-4313-a428-ddfd5ef9d777-withdrawal-exchange,2018.11.15 10:11,UNKNOWN,,UNKNOWN-55c0f2b7-dc24-425b-9be8-6b86719f2865,2018.11.15 10:11,UNKNOWN,0,100,0,HDAC,WITHDRAWAL,,,,0,COMPLETED,0,sum-user-id,1851771.27,airdrop-20181115-hdac-sum-user-id-withdrawal,accac570-de75-11e8-bd11-2f9252c4dc2f,AIRDROP,0
airdrop-20181115-hdac-4389491c-088d-41e6-9caa-0399655e931f-withdrawal-exchange,2018.11.15 10:11,UNKNOWN,,UNKNOWN-55c0f2b7-dc24-425b-9be8-6b86719f2865,2018.11.15 10:11,UNKNOWN,0,100,0,HDAC,WITHDRAWAL,,,,0,COMPLETED,0,sum-user-id,1851671.27,airdrop-20181115-hdac-sum-user-id-withdrawal,accac570-de75-11e8-bd11-2f9252c4dc2f,AIRDROP,0
airdrop-20181115-hdac-43c68c87-4e76-4739-abbc-9bcd209fd4c1-withdrawal-exchange,2018.11.15 10:11,UNKNOWN,,UNKNOWN-55c0f2b7-dc24-425b-9be8-6b86719f2865,2018.11.15 10:11,UNKNOWN,0,100,0,HDAC,WITHDRAWAL,,,,0,COMPLETED,0,sum-user-id,1851571.27,airdrop-20181115-hdac-sum-user-id-withdrawal,accac570-de75-11e8-bd11-2f9252c4dc2f,AIRDROP,0
airdrop-20181115-hdac-43cb7dd2-7d65-4988-a635-8bfaee1b1cde-withdrawal-exchange,2018.11.15 10:11,UNKNOWN,,UNKNOWN-55c0f2b7-dc24-425b-9be8-6b86719f2865,2018.11.15 10:11,UNKNOWN,0,100,0,HDAC,WITHDRAWAL,,,,0,COMPLETED,0,sum-user-id,1851471.27,airdrop-20181115-hdac-sum-user-id-withdrawal,accac570-de75-11e8-bd11-2f9252c4dc2f,AIRDROP,0
airdrop-20181115-hdac-43d7bed2-05fb-48a2-88e1-3aae66ecd5e6-withdrawal-exchange,2018.11.15 10:11,UNKNOWN,,UNKNOWN-55c0f2b7-dc24-425b-9be8-6b86719f2865,2018.11.15 10:11,UNKNOWN,0,100,0,HDAC,WITHDRAWAL,,,,0,COMPLETED,0,sum-user-id,1851371.27,airdrop-20181115-hdac-sum-user-id-withdrawal,accac570-de75-11e8-bd11-2f9252c4dc2f,AIRDROP,0
airdrop-20181115-hdac-43ddcba8-0fb0-42ec-9206-a1c8f5e51284-withdrawal-exchange,2018.11.15 10:11,UNKNOWN,,UNKNOWN-55c0f2b7-dc24-425b-9be8-6b86719f2865,2018.11.15 10:11,UNKNOWN,0,100,0,HDAC,WITHDRAWAL,,,,0,COMPLETED,0,sum-user-id,1851271.27,airdrop-20181115-hdac-sum-user-id-withdrawal,accac570-de75-11e8-bd11-2f9252c4dc2f,AIRDROP,0
airdrop-20181115-hdac-43e817a3-04be-4497-86fb-1d6e6c739b26-withdrawal-exchange,2018.11.15 10:11,UNKNOWN,,UNKNOWN-55c0f2b7-dc24-425b-9be8-6b86719f2865,2018.11.15 10:11,UNKNOWN,0,100,0,HDAC,WITHDRAWAL,,,,0,COMPLETED,0,sum-user-id,1851171.27,airdrop-20181115-hdac-sum-user-id-withdrawal,accac570-de75-11e8-bd11-2f9252c4dc2f,AIRDROP,0
airdrop-20181115-hdac-4402db33-17f2-4f4c-820d-1f6d50d335d6-withdrawal-exchange,2018.11.15 10:11,UNKNOWN,,UNKNOWN-55c0f2b7-dc24-425b-9be8-6b86719f2865,2018.11.15 10:11,UNKNOWN,0,100,0,HDAC,WITHDRAWAL,,,,0,COMPLETED,0,sum-user-id,1851071.27,airdrop-20181115-hdac-sum-user-id-withdrawal,accac570-de75-11e8-bd11-2f9252c4dc2f,AIRDROP,0
airdrop-20181115-hdac-440d07a6-1fc9-43f1-8a8e-dcad351ee5d2-withdrawal-exchange,2018.11.15 10:11,UNKNOWN,,UNKNOWN-55c0f2b7-dc24-425b-9be8-6b86719f2865,2018.11.15 10:11,UNKNOWN,0,100,0,HDAC,WITHDRAWAL,,,,0,COMPLETED,0,sum-user-id,1850971.27,airdrop-20181115-hdac-sum-user-id-withdrawal,accac570-de75-11e8-bd11-2f9252c4dc2f,AIRDROP,0
airdrop-20181115-hdac-440d21ad-761f-4215-9e86-305ec728b534-withdrawal-exchange,2018.11.15 10:11,UNKNOWN,,UNKNOWN-55c0f2b7-dc24-425b-9be8-6b86719f2865,2018.11.15 10:11,UNKNOWN,0,100,0,HDAC,WITHDRAWAL,,,,0,COMPLETED,0,sum-user-id,1850871.27,airdrop-20181115-hdac-sum-user-id-withdrawal,accac570-de75-11e8-bd11-2f9252c4dc2f,AIRDROP,0
airdrop-20181115-hdac-440eac9f-048a-4c1c-b47e-76899c6faeaf-withdrawal-exchange,2018.11.15 10:11,UNKNOWN,,UNKNOWN-55c0f2b7-dc24-425b-9be8-6b86719f2865,2018.11.15 10:11,UNKNOWN,0,100,0,HDAC,WITHDRAWAL,,,,0,COMPLETED,0,sum-user-id,1850771.27,airdrop-20181115-hdac-sum-user-id-withdrawal,accac570-de75-11e8-bd11-2f9252c4dc2f,AIRDROP,0
airdrop-20181115-hdac-441eff7f-6d1d-470a-9d49-15fb65606353-withdrawal-exchange,2018.11.15 10:11,UNKNOWN,,UNKNOWN-55c0f2b7-dc24-425b-9be8-6b86719f2865,2018.11.15 10:11,UNKNOWN,0,100,0,HDAC,WITHDRAWAL,,,,0,COMPLETED,0,sum-user-id,1850671.27,airdrop-20181115-hdac-sum-user-id-withdrawal,accac570-de75-11e8-bd11-2f9252c4dc2f,AIRDROP,0
airdrop-20181115-hdac-443104c2-ca8c-4d85-b7fc-a8e449ba76fa-withdrawal-exchange,2018.11.15 10:11,UNKNOWN,,UNKNOWN-55c0f2b7-dc24-425b-9be8-6b86719f2865,2018.11.15 10:11,UNKNOWN,0,100,0,HDAC,WITHDRAWAL,,,,0,COMPLETED,0,sum-user-id,1850571.27,airdrop-20181115-hdac-sum-user-id-withdrawal,accac570-de75-11e8-bd11-2f9252c4dc2f,AIRDROP,0
airdrop-20181115-hdac-4449e0d5-4219-40fa-a477-d742f288de73-withdrawal-exchange,2018.11.15 10:11,UNKNOWN,,UNKNOWN-55c0f2b7-dc24-425b-9be8-6b86719f2865,2018.11.15 10:11,UNKNOWN,0,100,0,HDAC,WITHDRAWAL,,,,0,COMPLETED,0,sum-user-id,1850471.27,airdrop-20181115-hdac-sum-user-id-withdrawal,accac570-de75-11e8-bd11-2f9252c4dc2f,AIRDROP,0
airdrop-20181115-hdac-445335a1-323d-41b8-9b19-34401a62756a-withdrawal-exchange,2018.11.15 10:11,UNKNOWN,,UNKNOWN-55c0f2b7-dc24-425b-9be8-6b86719f2865,2018.11.15 10:11,UNKNOWN,0,100,0,HDAC,WITHDRAWAL,,,,0,COMPLETED,0,sum-user-id,1850371.27,airdrop-20181115-hdac-sum-user-id-withdrawal,accac570-de75-11e8-bd11-2f9252c4dc2f,AIRDROP,0
airdrop-20181115-hdac-4463fda9-e5db-4d32-af99-d19f25b00841-withdrawal-exchange,2018.11.15 10:11,UNKNOWN,,UNKNOWN-55c0f2b7-dc24-425b-9be8-6b86719f2865,2018.11.15 10:11,UNKNOWN,0,100,0,HDAC,WITHDRAWAL,,,,0,COMPLETED,0,sum-user-id,1850271.27,airdrop-20181115-hdac-sum-user-id-withdrawal,accac570-de75-11e8-bd11-2f9252c4dc2f,AIRDROP,0
airdrop-20181115-hdac-447b1e44-cca5-4e39-954c-0718aef23e30-withdrawal-exchange,2018.11.15 10:11,UNKNOWN,,UNKNOWN-55c0f2b7-dc24-425b-9be8-6b86719f2865,2018.11.15 10:11,UNKNOWN,0,100,0,HDAC,WITHDRAWAL,,,,0,COMPLETED,0,sum-user-id,1850171.27,airdrop-20181115-hdac-sum-user-id-withdrawal,accac570-de75-11e8-bd11-2f9252c4dc2f,AIRDROP,0
airdrop-20181115-hdac-44ad965a-be30-4794-b515-5d12f10faed0-withdrawal-exchange,2018.11.15 10:11,UNKNOWN,,UNKNOWN-55c0f2b7-dc24-425b-9be8-6b86719f2865,2018.11.15 10:11,UNKNOWN,0,100,0,HDAC,WITHDRAWAL,,,,0,COMPLETED,0,sum-user-id,1850071.27,airdrop-20181115-hdac-sum-user-id-withdrawal,accac570-de75-11e8-bd11-2f9252c4dc2f,AIRDROP,0
airdrop-20181115-hdac-44cb7f0d-301a-462b-9bed-d337db509bf2-withdrawal-exchange,2018.11.15 10:11,UNKNOWN,,UNKNOWN-55c0f2b7-dc24-425b-9be8-6b86719f2865,2018.11.15 10:11,UNKNOWN,0,100,0,HDAC,WITHDRAWAL,,,,0,COMPLETED,0,sum-user-id,1849971.27,airdrop-20181115-hdac-sum-user-id-withdrawal,accac570-de75-11e8-bd11-2f9252c4dc2f,AIRDROP,0
airdrop-20181115-hdac-44cdf083-8af8-4580-bcd5-d4917a0b97de-withdrawal-exchange,2018.11.15 10:11,UNKNOWN,,UNKNOWN-55c0f2b7-dc24-425b-9be8-6b86719f2865,2018.11.15 10:11,UNKNOWN,0,100,0,HDAC,WITHDRAWAL,,,,0,COMPLETED,0,sum-user-id,1849871.27,airdrop-20181115-hdac-sum-user-id-withdrawal,accac570-de75-11e8-bd11-2f9252c4dc2f,AIRDROP,0
airdrop-20181115-hdac-44e19d8b-7e32-4a24-98c9-ef06c68c6733-withdrawal-exchange,2018.11.15 10:11,UNKNOWN,,UNKNOWN-55c0f2b7-dc24-425b-9be8-6b86719f2865,2018.11.15 10:11,UNKNOWN,0,100,0,HDAC,WITHDRAWAL,,,,0,COMPLETED,0,sum-user-id,1849771.27,airdrop-20181115-hdac-sum-user-id-withdrawal,accac570-de75-11e8-bd11-2f9252c4dc2f,AIRDROP,0
airdrop-20181115-hdac-45056c03-70c9-4f7f-948b-aa1de85e1ed8-withdrawal-exchange,2018.11.15 10:11,UNKNOWN,,UNKNOWN-55c0f2b7-dc24-425b-9be8-6b86719f2865,2018.11.15 10:11,UNKNOWN,0,100,0,HDAC,WITHDRAWAL,,,,0,COMPLETED,0,sum-user-id,1849671.27,airdrop-20181115-hdac-sum-user-id-withdrawal,accac570-de75-11e8-bd11-2f9252c4dc2f,AIRDROP,0
airdrop-20181115-hdac-456391e7-5b00-4199-8d17-2d1cd2e066e5-withdrawal-exchange,2018.11.15 10:11,UNKNOWN,,UNKNOWN-55c0f2b7-dc24-425b-9be8-6b86719f2865,2018.11.15 10:11,UNKNOWN,0,100,0,HDAC,WITHDRAWAL,,,,0,COMPLETED,0,sum-user-id,1849571.27,airdrop-20181115-hdac-sum-user-id-withdrawal,accac570-de75-11e8-bd11-2f9252c4dc2f,AIRDROP,0
airdrop-20181115-hdac-456e5e64-ceb2-44a9-bd17-33bbc2dc3930-withdrawal-exchange,2018.11.15 10:11,UNKNOWN,,UNKNOWN-55c0f2b7-dc24-425b-9be8-6b86719f2865,2018.11.15 10:11,UNKNOWN,0,100,0,HDAC,WITHDRAWAL,,,,0,COMPLETED,0,sum-user-id,1849471.27,airdrop-20181115-hdac-sum-user-id-withdrawal,accac570-de75-11e8-bd11-2f9252c4dc2f,AIRDROP,0
airdrop-20181115-hdac-45b7eb29-125b-4e34-97bb-1055ba66a911-withdrawal-exchange,2018-11-15 10:11:29.000,UNKNOWN,,UNKNOWN-55c0f2b7-dc24-425b-9be8-6b86719f2865,2018-11-15 10:11:29.000,UNKNOWN,0,100,0,HDAC,WITHDRAWAL,,,,0,COMPLETED,0,sum-user-id,1849371.27,airdrop-20181115-hdac-sum-user-id-withdrawal,accac570-de75-11e8-bd11-2f9252c4dc2f,AIRDROP,0
airdrop-20181115-hdac-45d21ead-e6de-4cc9-b5d8-e1ad206a94c9-withdrawal-exchange,2018-11-15 10:11:29.033,UNKNOWN,,UNKNOWN-55c0f2b7-dc24-425b-9be8-6b86719f2865,2018-11-15 10:11:29.033,UNKNOWN,0,100,0,HDAC,WITHDRAWAL,,,,0,COMPLETED,0,sum-user-id,1849271.27,airdrop-20181115-hdac-sum-user-id-withdrawal,accac570-de75-11e8-bd11-2f9252c4dc2f,AIRDROP,0
airdrop-20181115-hdac-460a399b-5d5a-42ec-9154-6796719076e7-withdrawal-exchange,2018-11-15 10:11:29.063,UNKNOWN,,UNKNOWN-55c0f2b7-dc24-425b-9be8-6b86719f2865,2018-11-15 10:11:29.063,UNKNOWN,0,100,0,HDAC,WITHDRAWAL,,,,0,COMPLETED,0,sum-user-id,1849171.27,airdrop-20181115-hdac-sum-user-id-withdrawal,accac570-de75-11e8-bd11-2f9252c4dc2f,AIRDROP,0
airdrop-20181115-hdac-460ed6a5-d77d-4058-a0c7-d830e2614903-withdrawal-exchange,2018-11-15 10:11:29.093,UNKNOWN,,UNKNOWN-55c0f2b7-dc24-425b-9be8-6b86719f2865,2018-11-15 10:11:29.093,UNKNOWN,0,100,0,HDAC,WITHDRAWAL,,,,0,COMPLETED,0,sum-user-id,1849071.27,airdrop-20181115-hdac-sum-user-id-withdrawal,accac570-de75-11e8-bd11-2f9252c4dc2f,AIRDROP,0
airdrop-20181115-hdac-4613ee64-51ad-45fa-928f-66deabe647c3-withdrawal-exchange,2018.11.15 10:11,UNKNOWN,,UNKNOWN-55c0f2b7-dc24-425b-9be8-6b86719f2865,2018.11.15 10:11,UNKNOWN,0,100,0,HDAC,WITHDRAWAL,,,,0,COMPLETED,0,sum-user-id,1848971.27,airdrop-20181115-hdac-sum-user-id-withdrawal,accac570-de75-11e8-bd11-2f9252c4dc2f,AIRDROP,0
airdrop-20181115-hdac-46217568-cd71-4243-af9d-10054d97790b-withdrawal-exchange,2018.11.15 10:11,UNKNOWN,,UNKNOWN-55c0f2b7-dc24-425b-9be8-6b86719f2865,2018.11.15 10:11,UNKNOWN,0,100,0,HDAC,WITHDRAWAL,,,,0,COMPLETED,0,sum-user-id,1848871.27,airdrop-20181115-hdac-sum-user-id-withdrawal,accac570-de75-11e8-bd11-2f9252c4dc2f,AIRDROP,0
airdrop-20181115-hdac-462de1a8-4cf9-4ac2-a2c5-5332018e18a0-withdrawal-exchange,2018.11.15 10:11,UNKNOWN,,UNKNOWN-55c0f2b7-dc24-425b-9be8-6b86719f2865,2018.11.15 10:11,UNKNOWN,0,100,0,HDAC,WITHDRAWAL,,,,0,COMPLETED,0,sum-user-id,1848771.27,airdrop-20181115-hdac-sum-user-id-withdrawal,accac570-de75-11e8-bd11-2f9252c4dc2f,AIRDROP,0
airdrop-20181115-hdac-463e93a4-9bef-4bfe-88db-8fc43c5a56bc-withdrawal-exchange,2018.11.15 10:11,UNKNOWN,,UNKNOWN-55c0f2b7-dc24-425b-9be8-6b86719f2865,2018.11.15 10:11,UNKNOWN,0,100,0,HDAC,WITHDRAWAL,,,,0,COMPLETED,0,sum-user-id,1848671.27,airdrop-20181115-hdac-sum-user-id-withdrawal,accac570-de75-11e8-bd11-2f9252c4dc2f,AIRDROP,0
airdrop-20181115-hdac-464748c7-4092-4d14-b91c-aa774535a054-withdrawal-exchange,2018.11.15 10:11,UNKNOWN,,UNKNOWN-55c0f2b7-dc24-425b-9be8-6b86719f2865,2018.11.15 10:11,UNKNOWN,0,100,0,HDAC,WITHDRAWAL,,,,0,COMPLETED,0,sum-user-id,1848571.27,airdrop-20181115-hdac-sum-user-id-withdrawal,accac570-de75-11e8-bd11-2f9252c4dc2f,AIRDROP,0
airdrop-20181115-hdac-46737268-3db1-4e02-82d6-4b9da1e26812-withdrawal-exchange,2018.11.15 10:11,UNKNOWN,,UNKNOWN-55c0f2b7-dc24-425b-9be8-6b86719f2865,2018.11.15 10:11,UNKNOWN,0,100,0,HDAC,WITHDRAWAL,,,,0,COMPLETED,0,sum-user-id,1848471.27,airdrop-20181115-hdac-sum-user-id-withdrawal,accac570-de75-11e8-bd11-2f9252c4dc2f,AIRDROP,0
airdrop-20181115-hdac-4677ef49-ab33-4f3d-bf6f-cd56b6cc75b9-withdrawal-exchange,2018.11.15 10:11,UNKNOWN,,UNKNOWN-55c0f2b7-dc24-425b-9be8-6b86719f2865,2018.11.15 10:11,UNKNOWN,0,100,0,HDAC,WITHDRAWAL,,,,0,COMPLETED,0,sum-user-id,1848371.27,airdrop-20181115-hdac-sum-user-id-withdrawal,accac570-de75-11e8-bd11-2f9252c4dc2f,AIRDROP,0
airdrop-20181115-hdac-4698ee02-61b6-4ef1-b14a-bf789fa9df1d-withdrawal-exchange,2018.11.15 10:11,UNKNOWN,,UNKNOWN-55c0f2b7-dc24-425b-9be8-6b86719f2865,2018.11.15 10:11,UNKNOWN,0,100,0,HDAC,WITHDRAWAL,,,,0,COMPLETED,0,sum-user-id,1848271.27,airdrop-20181115-hdac-sum-user-id-withdrawal,accac570-de75-11e8-bd11-2f9252c4dc2f,AIRDROP,0
airdrop-20181115-hdac-46c0b955-cb60-413c-bb08-d8742bb7630c-withdrawal-exchange,2018.11.15 10:11,UNKNOWN,,UNKNOWN-55c0f2b7-dc24-425b-9be8-6b86719f2865,2018.11.15 10:11,UNKNOWN,0,100,0,HDAC,WITHDRAWAL,,,,0,COMPLETED,0,sum-user-id,1848171.27,airdrop-20181115-hdac-sum-user-id-withdrawal,accac570-de75-11e8-bd11-2f9252c4dc2f,AIRDROP,0
airdrop-20181115-hdac-46d8ddb9-779a-47dd-8e28-0ebf5b537855-withdrawal-exchange,2018.11.15 10:11,UNKNOWN,,UNKNOWN-55c0f2b7-dc24-425b-9be8-6b86719f2865,2018.11.15 10:11,UNKNOWN,0,100,0,HDAC,WITHDRAWAL,,,,0,COMPLETED,0,sum-user-id,1848071.27,airdrop-20181115-hdac-sum-user-id-withdrawal,accac570-de75-11e8-bd11-2f9252c4dc2f,AIRDROP,0
airdrop-20181115-hdac-4703b450-e951-4f4f-8d75-5c5f549d70fb-withdrawal-exchange,2018.11.15 10:11,UNKNOWN,,UNKNOWN-55c0f2b7-dc24-425b-9be8-6b86719f2865,2018.11.15 10:11,UNKNOWN,0,100,0,HDAC,WITHDRAWAL,,,,0,COMPLETED,0,sum-user-id,1847971.27,airdrop-20181115-hdac-sum-user-id-withdrawal,accac570-de75-11e8-bd11-2f9252c4dc2f,AIRDROP,0
airdrop-20181115-hdac-4705d90d-c248-4b74-8329-0f1baa9b8f8e-withdrawal-exchange,2018.11.15 10:11,UNKNOWN,,UNKNOWN-55c0f2b7-dc24-425b-9be8-6b86719f2865,2018.11.15 10:11,UNKNOWN,0,100,0,HDAC,WITHDRAWAL,,,,0,COMPLETED,0,sum-user-id,1847871.27,airdrop-20181115-hdac-sum-user-id-withdrawal,accac570-de75-11e8-bd11-2f9252c4dc2f,AIRDROP,0
airdrop-20181115-hdac-470d5ae0-e35a-41a7-9dd6-8cf4bebbf43b-withdrawal-exchange,2018.11.15 10:11,UNKNOWN,,UNKNOWN-55c0f2b7-dc24-425b-9be8-6b86719f2865,2018.11.15 10:11,UNKNOWN,0,100,0,HDAC,WITHDRAWAL,,,,0,COMPLETED,0,sum-user-id,1847771.27,airdrop-20181115-hdac-sum-user-id-withdrawal,accac570-de75-11e8-bd11-2f9252c4dc2f,AIRDROP,0
airdrop-20181115-hdac-4726e524-39e0-4a65-9ca0-52330fb132fa-withdrawal-exchange,2018.11.15 10:11,UNKNOWN,,UNKNOWN-55c0f2b7-dc24-425b-9be8-6b86719f2865,2018.11.15 10:11,UNKNOWN,0,100,0,HDAC,WITHDRAWAL,,,,0,COMPLETED,0,sum-user-id,1847671.27,airdrop-20181115-hdac-sum-user-id-withdrawal,accac570-de75-11e8-bd11-2f9252c4dc2f,AIRDROP,0
airdrop-20181115-hdac-473998b1-d408-4be0-ba91-5ee4ca67b659-withdrawal-exchange,2018.11.15 10:11,UNKNOWN,,UNKNOWN-55c0f2b7-dc24-425b-9be8-6b86719f2865,2018.11.15 10:11,UNKNOWN,0,100,0,HDAC,WITHDRAWAL,,,,0,COMPLETED,0,sum-user-id,1847571.27,airdrop-20181115-hdac-sum-user-id-withdrawal,accac570-de75-11e8-bd11-2f9252c4dc2f,AIRDROP,0
airdrop-20181115-hdac-4751041c-cb4a-4a74-8a8b-df18392e2e71-withdrawal-exchange,2018.11.15 10:11,UNKNOWN,,UNKNOWN-55c0f2b7-dc24-425b-9be8-6b86719f2865,2018.11.15 10:11,UNKNOWN,0,100,0,HDAC,WITHDRAWAL,,,,0,COMPLETED,0,sum-user-id,1847471.27,airdrop-20181115-hdac-sum-user-id-withdrawal,accac570-de75-11e8-bd11-2f9252c4dc2f,AIRDROP,0
airdrop-20181115-hdac-4761470a-22d2-482b-9e7c-f8dfed853ae4-withdrawal-exchange,2018.11.15 10:11,UNKNOWN,,UNKNOWN-55c0f2b7-dc24-425b-9be8-6b86719f2865,2018.11.15 10:11,UNKNOWN,0,100,0,HDAC,WITHDRAWAL,,,,0,COMPLETED,0,sum-user-id,1847371.27,airdrop-20181115-hdac-sum-user-id-withdrawal,accac570-de75-11e8-bd11-2f9252c4dc2f,AIRDROP,0
airdrop-20181115-hdac-476aaea9-ddcc-488b-9209-933e3b60c878-withdrawal-exchange,2018.11.15 10:11,UNKNOWN,,UNKNOWN-55c0f2b7-dc24-425b-9be8-6b86719f2865,2018.11.15 10:11,UNKNOWN,0,100,0,HDAC,WITHDRAWAL,,,,0,COMPLETED,0,sum-user-id,1847271.27,airdrop-20181115-hdac-sum-user-id-withdrawal,accac570-de75-11e8-bd11-2f9252c4dc2f,AIRDROP,0
airdrop-20181115-hdac-477c4ed1-455c-4604-a29a-e90ac3fbaf32-withdrawal-exchange,2018.11.15 10:11,UNKNOWN,,UNKNOWN-55c0f2b7-dc24-425b-9be8-6b86719f2865,2018.11.15 10:11,UNKNOWN,0,100,0,HDAC,WITHDRAWAL,,,,0,COMPLETED,0,sum-user-id,1847171.27,airdrop-20181115-hdac-sum-user-id-withdrawal,accac570-de75-11e8-bd11-2f9252c4dc2f,AIRDROP,0
airdrop-20181115-hdac-47ba73ae-a26a-4f83-b560-15035e869860-withdrawal-exchange,2018.11.15 10:11,UNKNOWN,,UNKNOWN-55c0f2b7-dc24-425b-9be8-6b86719f2865,2018.11.15 10:11,UNKNOWN,0,100,0,HDAC,WITHDRAWAL,,,,0,COMPLETED,0,sum-user-id,1847071.27,airdrop-20181115-hdac-sum-user-id-withdrawal,accac570-de75-11e8-bd11-2f9252c4dc2f,AIRDROP,0
airdrop-20181115-hdac-47e35e60-a8a5-485c-b046-fbf939f67f66-withdrawal-exchange,2018.11.15 10:11,UNKNOWN,,UNKNOWN-55c0f2b7-dc24-425b-9be8-6b86719f2865,2018.11.15 10:11,UNKNOWN,0,100,0,HDAC,WITHDRAWAL,,,,0,COMPLETED,0,sum-user-id,1846971.27,airdrop-20181115-hdac-sum-user-id-withdrawal,accac570-de75-11e8-bd11-2f9252c4dc2f,AIRDROP,0
airdrop-20181115-hdac-4840a844-3b99-42c3-b7d6-bfc12e073d75-withdrawal-exchange,2018.11.15 10:11,UNKNOWN,,UNKNOWN-55c0f2b7-dc24-425b-9be8-6b86719f2865,2018.11.15 10:11,UNKNOWN,0,100,0,HDAC,WITHDRAWAL,,,,0,COMPLETED,0,sum-user-id,1846871.27,airdrop-20181115-hdac-sum-user-id-withdrawal,accac570-de75-11e8-bd11-2f9252c4dc2f,AIRDROP,0
airdrop-20181115-hdac-485ce01a-c19e-49be-bb8a-95e401a185e3-withdrawal-exchange,2018.11.15 10:11,UNKNOWN,,UNKNOWN-55c0f2b7-dc24-425b-9be8-6b86719f2865,2018.11.15 10:11,UNKNOWN,0,100,0,HDAC,WITHDRAWAL,,,,0,COMPLETED,0,sum-user-id,1846771.27,airdrop-20181115-hdac-sum-user-id-withdrawal,accac570-de75-11e8-bd11-2f9252c4dc2f,AIRDROP,0
airdrop-20181115-hdac-48d2ee7a-581f-44db-8a8b-313974e33628-withdrawal-exchange,2018.11.15 10:11,UNKNOWN,,UNKNOWN-55c0f2b7-dc24-425b-9be8-6b86719f2865,2018.11.15 10:11,UNKNOWN,0,100,0,HDAC,WITHDRAWAL,,,,0,COMPLETED,0,sum-user-id,1846671.27,airdrop-20181115-hdac-sum-user-id-withdrawal,accac570-de75-11e8-bd11-2f9252c4dc2f,AIRDROP,0
airdrop-20181115-hdac-48d7f56a-abf2-4e0b-a8a3-faf0310da427-withdrawal-exchange,2018.11.15 10:11,UNKNOWN,,UNKNOWN-55c0f2b7-dc24-425b-9be8-6b86719f2865,2018.11.15 10:11,UNKNOWN,0,100,0,HDAC,WITHDRAWAL,,,,0,COMPLETED,0,sum-user-id,1846571.27,airdrop-20181115-hdac-sum-user-id-withdrawal,accac570-de75-11e8-bd11-2f9252c4dc2f,AIRDROP,0
airdrop-20181115-hdac-48d9ae3c-d62d-4a21-9d65-7a94c89b2e8b-withdrawal-exchange,2018.11.15 10:11,UNKNOWN,,UNKNOWN-55c0f2b7-dc24-425b-9be8-6b86719f2865,2018.11.15 10:11,UNKNOWN,0,100,0,HDAC,WITHDRAWAL,,,,0,COMPLETED,0,sum-user-id,1846471.27,airdrop-20181115-hdac-sum-user-id-withdrawal,accac570-de75-11e8-bd11-2f9252c4dc2f,AIRDROP,0
airdrop-20181115-hdac-48e13b0d-ec03-49a3-a1df-db40fe6fe722-withdrawal-exchange,2018.11.15 10:11,UNKNOWN,,UNKNOWN-55c0f2b7-dc24-425b-9be8-6b86719f2865,2018.11.15 10:11,UNKNOWN,0,100,0,HDAC,WITHDRAWAL,,,,0,COMPLETED,0,sum-user-id,1846371.27,airdrop-20181115-hdac-sum-user-id-withdrawal,accac570-de75-11e8-bd11-2f9252c4dc2f,AIRDROP,0
airdrop-20181115-hdac-48f64967-7f40-4799-b2d3-09885629fa6e-withdrawal-exchange,2018-11-15 10:11:30.007,UNKNOWN,,UNKNOWN-55c0f2b7-dc24-425b-9be8-6b86719f2865,2018-11-15 10:11:30.007,UNKNOWN,0,100,0,HDAC,WITHDRAWAL,,,,0,COMPLETED,0,sum-user-id,1846271.27,airdrop-20181115-hdac-sum-user-id-withdrawal,accac570-de75-11e8-bd11-2f9252c4dc2f,AIRDROP,0
airdrop-20181115-hdac-491f6d9c-0da2-4d5d-80ec-0e8b585141af-withdrawal-exchange,2018-11-15 10:11:30.041,UNKNOWN,,UNKNOWN-55c0f2b7-dc24-425b-9be8-6b86719f2865,2018-11-15 10:11:30.041,UNKNOWN,0,100,0,HDAC,WITHDRAWAL,,,,0,COMPLETED,0,sum-user-id,1846171.27,airdrop-20181115-hdac-sum-user-id-withdrawal,accac570-de75-11e8-bd11-2f9252c4dc2f,AIRDROP,0
airdrop-20181115-hdac-497dd46b-26b9-437f-b940-b4513674c0f1-withdrawal-exchange,2018-11-15 10:11:30.074,UNKNOWN,,UNKNOWN-55c0f2b7-dc24-425b-9be8-6b86719f2865,2018-11-15 10:11:30.074,UNKNOWN,0,100,0,HDAC,WITHDRAWAL,,,,0,COMPLETED,0,sum-user-id,1846071.27,airdrop-20181115-hdac-sum-user-id-withdrawal,accac570-de75-11e8-bd11-2f9252c4dc2f,AIRDROP,0
airdrop-20181115-hdac-49b9ac9a-b7e1-4a33-ab3d-b35aea909e40-withdrawal-exchange,2018.11.15 10:12,UNKNOWN,,UNKNOWN-55c0f2b7-dc24-425b-9be8-6b86719f2865,2018.11.15 10:12,UNKNOWN,0,275.19,0,HDAC,WITHDRAWAL,,,,0,COMPLETED,0,sum-user-id,1303874.164,airdrop-20181115-hdac-sum-user-id-withdrawal,accac570-de75-11e8-bd11-2f9252c4dc2f,AIRDROP,0
airdrop-20181115-hdac-49cd1bd1-205f-452f-8aec-45500071f70f-withdrawal-exchange,2018.11.15 10:11,UNKNOWN,,UNKNOWN-55c0f2b7-dc24-425b-9be8-6b86719f2865,2018.11.15 10:11,UNKNOWN,0,100,0,HDAC,WITHDRAWAL,,,,0,COMPLETED,0,sum-user-id,1845971.27,airdrop-20181115-hdac-sum-user-id-withdrawal,accac570-de75-11e8-bd11-2f9252c4dc2f,AIRDROP,0
airdrop-20181115-hdac-49da8685-8ffd-4cbc-a0cc-2a56263ee336-withdrawal-exchange,2018.11.15 10:11,UNKNOWN,,UNKNOWN-55c0f2b7-dc24-425b-9be8-6b86719f2865,2018.11.15 10:11,UNKNOWN,0,100,0,HDAC,WITHDRAWAL,,,,0,COMPLETED,0,sum-user-id,1845871.27,airdrop-20181115-hdac-sum-user-id-withdrawal,accac570-de75-11e8-bd11-2f9252c4dc2f,AIRDROP,0
airdrop-20181115-hdac-49e3721e-74ee-4c87-b56e-31da95f0a042-withdrawal-exchange,2018.11.15 10:11,UNKNOWN,,UNKNOWN-55c0f2b7-dc24-425b-9be8-6b86719f2865,2018.11.15 10:11,UNKNOWN,0,100,0,HDAC,WITHDRAWAL,,,,0,COMPLETED,0,sum-user-id,1845771.27,airdrop-20181115-hdac-sum-user-id-withdrawal,accac570-de75-11e8-bd11-2f9252c4dc2f,AIRDROP,0
airdrop-20181115-hdac-49f5c010-db7c-4d50-b824-67d59984308a-withdrawal-exchange,2018.11.15 10:11,UNKNOWN,,UNKNOWN-55c0f2b7-dc24-425b-9be8-6b86719f2865,2018.11.15 10:11,UNKNOWN,0,100,0,HDAC,WITHDRAWAL,,,,0,COMPLETED,0,sum-user-id,1845671.27,airdrop-20181115-hdac-sum-user-id-withdrawal,accac570-de75-11e8-bd11-2f9252c4dc2f,AIRDROP,0
airdrop-20181115-hdac-4a1e0db4-ee8b-41e7-9a5b-70a2a8493541-withdrawal-exchange,2018.11.15 10:11,UNKNOWN,,UNKNOWN-55c0f2b7-dc24-425b-9be8-6b86719f2865,2018.11.15 10:11,UNKNOWN,0,100,0,HDAC,WITHDRAWAL,,,,0,COMPLETED,0,sum-user-id,1845571.27,airdrop-20181115-hdac-sum-user-id-withdrawal,accac570-de75-11e8-bd11-2f9252c4dc2f,AIRDROP,0
airdrop-20181115-hdac-4a923cf8-236d-42ac-b7e2-a21ce40a79d5-withdrawal-exchange,2018.11.15 10:11,UNKNOWN,,UNKNOWN-55c0f2b7-dc24-425b-9be8-6b86719f2865,2018.11.15 10:11,UNKNOWN,0,100,0,HDAC,WITHDRAWAL,,,,0,COMPLETED,0,sum-user-id,1845471.27,airdrop-20181115-hdac-sum-user-id-withdrawal,accac570-de75-11e8-bd11-2f9252c4dc2f,AIRDROP,0
airdrop-20181115-hdac-4aaed1c5-a2bf-42d2-93d3-e803a5e58472-withdrawal-exchange,2018.11.15 10:11,UNKNOWN,,UNKNOWN-55c0f2b7-dc24-425b-9be8-6b86719f2865,2018.11.15 10:11,UNKNOWN,0,100,0,HDAC,WITHDRAWAL,,,,0,COMPLETED,0,sum-user-id,1845371.27,airdrop-20181115-hdac-sum-user-id-withdrawal,accac570-de75-11e8-bd11-2f9252c4dc2f,AIRDROP,0
airdrop-20181115-hdac-4ab5638c-9170-49d1-a8fc-7f20a3466f0f-withdrawal-exchange,2018.11.15 10:11,UNKNOWN,,UNKNOWN-55c0f2b7-dc24-425b-9be8-6b86719f2865,2018.11.15 10:11,UNKNOWN,0,100,0,HDAC,WITHDRAWAL,,,,0,COMPLETED,0,sum-user-id,1845271.27,airdrop-20181115-hdac-sum-user-id-withdrawal,accac570-de75-11e8-bd11-2f9252c4dc2f,AIRDROP,0
airdrop-20181115-hdac-4b4c00af-ed0d-4288-8d9a-9c2edb35e424-withdrawal-exchange,2018.11.15 10:11,UNKNOWN,,UNKNOWN-55c0f2b7-dc24-425b-9be8-6b86719f2865,2018.11.15 10:11,UNKNOWN,0,100,0,HDAC,WITHDRAWAL,,,,0,COMPLETED,0,sum-user-id,1845171.27,airdrop-20181115-hdac-sum-user-id-withdrawal,accac570-de75-11e8-bd11-2f9252c4dc2f,AIRDROP,0
airdrop-20181115-hdac-4b4f6006-430e-4fcd-a002-48f731378b4c-withdrawal-exchange,2018.11.15 10:11,UNKNOWN,,UNKNOWN-55c0f2b7-dc24-425b-9be8-6b86719f2865,2018.11.15 10:11,UNKNOWN,0,100,0,HDAC,WITHDRAWAL,,,,0,COMPLETED,0,sum-user-id,1845071.27,airdrop-20181115-hdac-sum-user-id-withdrawal,accac570-de75-11e8-bd11-2f9252c4dc2f,AIRDROP,0
airdrop-20181115-hdac-4b63ee17-825e-4002-87ca-53f2ff6992bc-withdrawal-exchange,2018.11.15 10:11,UNKNOWN,,UNKNOWN-55c0f2b7-dc24-425b-9be8-6b86719f2865,2018.11.15 10:11,UNKNOWN,0,100,0,HDAC,WITHDRAWAL,,,,0,COMPLETED,0,sum-user-id,1844971.27,airdrop-20181115-hdac-sum-user-id-withdrawal,accac570-de75-11e8-bd11-2f9252c4dc2f,AIRDROP,0
airdrop-20181115-hdac-4b7c3be2-d341-4b19-903d-2cd13216a543-withdrawal-exchange,2018.11.15 10:11,UNKNOWN,,UNKNOWN-55c0f2b7-dc24-425b-9be8-6b86719f2865,2018.11.15 10:11,UNKNOWN,0,100,0,HDAC,WITHDRAWAL,,,,0,COMPLETED,0,sum-user-id,1844871.27,airdrop-20181115-hdac-sum-user-id-withdrawal,accac570-de75-11e8-bd11-2f9252c4dc2f,AIRDROP,0
airdrop-20181115-hdac-4b9f65ea-69ae-4274-b57b-5b8b1ffe4d8f-withdrawal-exchange,2018.11.15 10:11,UNKNOWN,,UNKNOWN-55c0f2b7-dc24-425b-9be8-6b86719f2865,2018.11.15 10:11,UNKNOWN,0,100,0,HDAC,WITHDRAWAL,,,,0,COMPLETED,0,sum-user-id,1844771.27,airdrop-20181115-hdac-sum-user-id-withdrawal,accac570-de75-11e8-bd11-2f9252c4dc2f,AIRDROP,0
airdrop-20181115-hdac-4ba89787-c51d-4daf-8cdf-a67ac42ebbb7-withdrawal-exchange,2018.11.15 10:11,UNKNOWN,,UNKNOWN-55c0f2b7-dc24-425b-9be8-6b86719f2865,2018.11.15 10:11,UNKNOWN,0,100,0,HDAC,WITHDRAWAL,,,,0,COMPLETED,0,sum-user-id,1844671.27,airdrop-20181115-hdac-sum-user-id-withdrawal,accac570-de75-11e8-bd11-2f9252c4dc2f,AIRDROP,0
airdrop-20181115-hdac-4bb0ec31-bb4f-4086-b2d3-63dd52da4cad-withdrawal-exchange,2018.11.15 10:11,UNKNOWN,,UNKNOWN-55c0f2b7-dc24-425b-9be8-6b86719f2865,2018.11.15 10:11,UNKNOWN,0,100,0,HDAC,WITHDRAWAL,,,,0,COMPLETED,0,sum-user-id,1844571.27,airdrop-20181115-hdac-sum-user-id-withdrawal,accac570-de75-11e8-bd11-2f9252c4dc2f,AIRDROP,0
airdrop-20181115-hdac-4bc4a5b6-6101-48a3-bf24-ac080bd896af-withdrawal-exchange,2018.11.15 10:11,UNKNOWN,,UNKNOWN-55c0f2b7-dc24-425b-9be8-6b86719f2865,2018.11.15 10:11,UNKNOWN,0,100,0,HDAC,WITHDRAWAL,,,,0,COMPLETED,0,sum-user-id,1844471.27,airdrop-20181115-hdac-sum-user-id-withdrawal,accac570-de75-11e8-bd11-2f9252c4dc2f,AIRDROP,0
airdrop-20181115-hdac-4c41085a-3617-4772-a2e9-785b7e3e29cc-withdrawal-exchange,2018.11.15 10:11,UNKNOWN,,UNKNOWN-55c0f2b7-dc24-425b-9be8-6b86719f2865,2018.11.15 10:11,UNKNOWN,0,100,0,HDAC,WITHDRAWAL,,,,0,COMPLETED,0,sum-user-id,1844371.27,airdrop-20181115-hdac-sum-user-id-withdrawal,accac570-de75-11e8-bd11-2f9252c4dc2f,AIRDROP,0
airdrop-20181115-hdac-4c53bd21-e73f-42d4-8a48-f30d49e09f26-withdrawal-exchange,2018.11.15 10:11,UNKNOWN,,UNKNOWN-55c0f2b7-dc24-425b-9be8-6b86719f2865,2018.11.15 10:11,UNKNOWN,0,100,0,HDAC,WITHDRAWAL,,,,0,COMPLETED,0,sum-user-id,1844271.27,airdrop-20181115-hdac-sum-user-id-withdrawal,accac570-de75-11e8-bd11-2f9252c4dc2f,AIRDROP,0
airdrop-20181115-hdac-4c7b2188-b4d0-4be3-b4f6-8ea6b55d004e-withdrawal-exchange,2018.11.15 10:11,UNKNOWN,,UNKNOWN-55c0f2b7-dc24-425b-9be8-6b86719f2865,2018.11.15 10:11,UNKNOWN,0,100,0,HDAC,WITHDRAWAL,,,,0,COMPLETED,0,sum-user-id,1844171.27,airdrop-20181115-hdac-sum-user-id-withdrawal,accac570-de75-11e8-bd11-2f9252c4dc2f,AIRDROP,0
airdrop-20181115-hdac-4c9125c6-5123-4b1e-8505-651a2352c5b5-withdrawal-exchange,2018.11.15 10:11,UNKNOWN,,UNKNOWN-55c0f2b7-dc24-425b-9be8-6b86719f2865,2018.11.15 10:11,UNKNOWN,0,100,0,HDAC,WITHDRAWAL,,,,0,COMPLETED,0,sum-user-id,1844071.27,airdrop-20181115-hdac-sum-user-id-withdrawal,accac570-de75-11e8-bd11-2f9252c4dc2f,AIRDROP,0
airdrop-20181115-hdac-4c92c66e-b4b2-4fee-844a-4321b1d237f7-withdrawal-exchange,2018.11.15 10:11,UNKNOWN,,UNKNOWN-55c0f2b7-dc24-425b-9be8-6b86719f2865,2018.11.15 10:11,UNKNOWN,0,100,0,HDAC,WITHDRAWAL,,,,0,COMPLETED,0,sum-user-id,1843971.27,airdrop-20181115-hdac-sum-user-id-withdrawal,accac570-de75-11e8-bd11-2f9252c4dc2f,AIRDROP,0
airdrop-20181115-hdac-4cb4e61e-553e-48c5-8dbb-6bd8c3a6a009-withdrawal-exchange,2018.11.15 10:11,UNKNOWN,,UNKNOWN-55c0f2b7-dc24-425b-9be8-6b86719f2865,2018.11.15 10:11,UNKNOWN,0,100,0,HDAC,WITHDRAWAL,,,,0,COMPLETED,0,sum-user-id,1843871.27,airdrop-20181115-hdac-sum-user-id-withdrawal,accac570-de75-11e8-bd11-2f9252c4dc2f,AIRDROP,0
airdrop-20181115-hdac-4cd636e9-6bc2-4b1c-820d-57199ddd3e4c-withdrawal-exchange,2018.11.15 10:11,UNKNOWN,,UNKNOWN-55c0f2b7-dc24-425b-9be8-6b86719f2865,2018.11.15 10:11,UNKNOWN,0,100,0,HDAC,WITHDRAWAL,,,,0,COMPLETED,0,sum-user-id,1843771.27,airdrop-20181115-hdac-sum-user-id-withdrawal,accac570-de75-11e8-bd11-2f9252c4dc2f,AIRDROP,0
airdrop-20181115-hdac-4cdd0001-8e5b-4636-9b8b-71719de859bc-withdrawal-exchange,2018.11.15 10:11,UNKNOWN,,UNKNOWN-55c0f2b7-dc24-425b-9be8-6b86719f2865,2018.11.15 10:11,UNKNOWN,0,100,0,HDAC,WITHDRAWAL,,,,0,COMPLETED,0,sum-user-id,1843671.27,airdrop-20181115-hdac-sum-user-id-withdrawal,accac570-de75-11e8-bd11-2f9252c4dc2f,AIRDROP,0
airdrop-20181115-hdac-4ce341a1-ec04-4774-a709-4d993fd20970-withdrawal-exchange,2018.11.15 10:11,UNKNOWN,,UNKNOWN-55c0f2b7-dc24-425b-9be8-6b86719f2865,2018.11.15 10:11,UNKNOWN,0,100,0,HDAC,WITHDRAWAL,,,,0,COMPLETED,0,sum-user-id,1843571.27,airdrop-20181115-hdac-sum-user-id-withdrawal,accac570-de75-11e8-bd11-2f9252c4dc2f,AIRDROP,0
airdrop-20181115-hdac-4cef1803-190a-4439-a79a-1fac001d1e13-withdrawal-exchange,2018.11.15 10:11,UNKNOWN,,UNKNOWN-55c0f2b7-dc24-425b-9be8-6b86719f2865,2018.11.15 10:11,UNKNOWN,0,100,0,HDAC,WITHDRAWAL,,,,0,COMPLETED,0,sum-user-id,1843471.27,airdrop-20181115-hdac-sum-user-id-withdrawal,accac570-de75-11e8-bd11-2f9252c4dc2f,AIRDROP,0
airdrop-20181115-hdac-4d181bcf-0193-4fe2-b0fa-b368cc747b01-withdrawal-exchange,2018.11.15 10:11,UNKNOWN,,UNKNOWN-55c0f2b7-dc24-425b-9be8-6b86719f2865,2018.11.15 10:11,UNKNOWN,0,100,0,HDAC,WITHDRAWAL,,,,0,COMPLETED,0,sum-user-id,1843371.27,airdrop-20181115-hdac-sum-user-id-withdrawal,accac570-de75-11e8-bd11-2f9252c4dc2f,AIRDROP,0
airdrop-20181115-hdac-4d1cdcfc-08e8-47be-8f7a-215929d4db85-withdrawal-exchange,2018.11.15 10:11,UNKNOWN,,UNKNOWN-55c0f2b7-dc24-425b-9be8-6b86719f2865,2018.11.15 10:11,UNKNOWN,0,100,0,HDAC,WITHDRAWAL,,,,0,COMPLETED,0,sum-user-id,1843271.27,airdrop-20181115-hdac-sum-user-id-withdrawal,accac570-de75-11e8-bd11-2f9252c4dc2f,AIRDROP,0
airdrop-20181115-hdac-4d355fe0-232a-4a36-b3d3-cc9af47656d3-withdrawal-exchange,2018-11-15 10:11:31.021,UNKNOWN,,UNKNOWN-55c0f2b7-dc24-425b-9be8-6b86719f2865,2018-11-15 10:11:31.021,UNKNOWN,0,100,0,HDAC,WITHDRAWAL,,,,0,COMPLETED,0,sum-user-id,1843171.27,airdrop-20181115-hdac-sum-user-id-withdrawal,accac570-de75-11e8-bd11-2f9252c4dc2f,AIRDROP,0
airdrop-20181115-hdac-4d3f8871-2d7d-49dc-b83a-5226090bdb72-withdrawal-exchange,2018-11-15 10:11:31.053,UNKNOWN,,UNKNOWN-55c0f2b7-dc24-425b-9be8-6b86719f2865,2018-11-15 10:11:31.053,UNKNOWN,0,100,0,HDAC,WITHDRAWAL,,,,0,COMPLETED,0,sum-user-id,1843071.27,airdrop-20181115-hdac-sum-user-id-withdrawal,accac570-de75-11e8-bd11-2f9252c4dc2f,AIRDROP,0
airdrop-20181115-hdac-4d47ad14-ce6a-4b68-b9be-8b3dbf02bd94-withdrawal-exchange,2018-11-15 10:11:31.085,UNKNOWN,,UNKNOWN-55c0f2b7-dc24-425b-9be8-6b86719f2865,2018-11-15 10:11:31.085,UNKNOWN,0,100,0,HDAC,WITHDRAWAL,,,,0,COMPLETED,0,sum-user-id,1842971.27,airdrop-20181115-hdac-sum-user-id-withdrawal,accac570-de75-11e8-bd11-2f9252c4dc2f,AIRDROP,0
airdrop-20181115-hdac-4d75f43d-2893-4fe2-afe8-a0c16c2fdde1-withdrawal-exchange,2018.11.15 10:11,UNKNOWN,,UNKNOWN-55c0f2b7-dc24-425b-9be8-6b86719f2865,2018.11.15 10:11,UNKNOWN,0,100,0,HDAC,WITHDRAWAL,,,,0,COMPLETED,0,sum-user-id,1842871.27,airdrop-20181115-hdac-sum-user-id-withdrawal,accac570-de75-11e8-bd11-2f9252c4dc2f,AIRDROP,0
airdrop-20181115-hdac-4d7d5bd5-07d4-451b-8fa1-31883213e10f-withdrawal-exchange,2018.11.15 10:11,UNKNOWN,,UNKNOWN-55c0f2b7-dc24-425b-9be8-6b86719f2865,2018.11.15 10:11,UNKNOWN,0,100,0,HDAC,WITHDRAWAL,,,,0,COMPLETED,0,sum-user-id,1842771.27,airdrop-20181115-hdac-sum-user-id-withdrawal,accac570-de75-11e8-bd11-2f9252c4dc2f,AIRDROP,0
airdrop-20181115-hdac-4d82e061-f159-41c5-a22e-2e72f73d6a00-withdrawal-exchange,2018.11.15 10:11,UNKNOWN,,UNKNOWN-55c0f2b7-dc24-425b-9be8-6b86719f2865,2018.11.15 10:11,UNKNOWN,0,100,0,HDAC,WITHDRAWAL,,,,0,COMPLETED,0,sum-user-id,1842671.27,airdrop-20181115-hdac-sum-user-id-withdrawal,accac570-de75-11e8-bd11-2f9252c4dc2f,AIRDROP,0
airdrop-20181115-hdac-4d857b2c-4e93-4235-bd94-e144525c25d8-withdrawal-exchange,2018.11.15 10:11,UNKNOWN,,UNKNOWN-55c0f2b7-dc24-425b-9be8-6b86719f2865,2018.11.15 10:11,UNKNOWN,0,100,0,HDAC,WITHDRAWAL,,,,0,COMPLETED,0,sum-user-id,1842571.27,airdrop-20181115-hdac-sum-user-id-withdrawal,accac570-de75-11e8-bd11-2f9252c4dc2f,AIRDROP,0
airdrop-20181115-hdac-4d9ef8a9-b290-4e46-b714-81529b0f474e-withdrawal-exchange,2018.11.15 10:11,UNKNOWN,,UNKNOWN-55c0f2b7-dc24-425b-9be8-6b86719f2865,2018.11.15 10:11,UNKNOWN,0,100,0,HDAC,WITHDRAWAL,,,,0,COMPLETED,0,sum-user-id,1842471.27,airdrop-20181115-hdac-sum-user-id-withdrawal,accac570-de75-11e8-bd11-2f9252c4dc2f,AIRDROP,0
airdrop-20181115-hdac-4da19c7d-45fd-4534-8402-2516883f2492-withdrawal-exchange,2018.11.15 10:11,UNKNOWN,,UNKNOWN-55c0f2b7-dc24-425b-9be8-6b86719f2865,2018.11.15 10:11,UNKNOWN,0,100,0,HDAC,WITHDRAWAL,,,,0,COMPLETED,0,sum-user-id,1842371.27,airdrop-20181115-hdac-sum-user-id-withdrawal,accac570-de75-11e8-bd11-2f9252c4dc2f,AIRDROP,0
airdrop-20181115-hdac-4dc85b9e-2089-418b-999f-d87b079e0404-withdrawal-exchange,2018.11.15 10:11,UNKNOWN,,UNKNOWN-55c0f2b7-dc24-425b-9be8-6b86719f2865,2018.11.15 10:11,UNKNOWN,0,100,0,HDAC,WITHDRAWAL,,,,0,COMPLETED,0,sum-user-id,1842271.27,airdrop-20181115-hdac-sum-user-id-withdrawal,accac570-de75-11e8-bd11-2f9252c4dc2f,AIRDROP,0
airdrop-20181115-hdac-4de8e7f7-c272-473b-a1db-44be70731a8e-withdrawal-exchange,2018.11.15 10:11,UNKNOWN,,UNKNOWN-55c0f2b7-dc24-425b-9be8-6b86719f2865,2018.11.15 10:11,UNKNOWN,0,100,0,HDAC,WITHDRAWAL,,,,0,COMPLETED,0,sum-user-id,1842171.27,airdrop-20181115-hdac-sum-user-id-withdrawal,accac570-de75-11e8-bd11-2f9252c4dc2f,AIRDROP,0
airdrop-20181115-hdac-4dff44eb-0341-4447-bf9d-978338c3e96d-withdrawal-exchange,2018.11.15 10:11,UNKNOWN,,UNKNOWN-55c0f2b7-dc24-425b-9be8-6b86719f2865,2018.11.15 10:11,UNKNOWN,0,100,0,HDAC,WITHDRAWAL,,,,0,COMPLETED,0,sum-user-id,1842071.27,airdrop-20181115-hdac-sum-user-id-withdrawal,accac570-de75-11e8-bd11-2f9252c4dc2f,AIRDROP,0
airdrop-20181115-hdac-4e44604e-33a9-4fd7-bb97-d93fa80ec802-withdrawal-exchange,2018.11.15 10:11,UNKNOWN,,UNKNOWN-55c0f2b7-dc24-425b-9be8-6b86719f2865,2018.11.15 10:11,UNKNOWN,0,100,0,HDAC,WITHDRAWAL,,,,0,COMPLETED,0,sum-user-id,1841971.27,airdrop-20181115-hdac-sum-user-id-withdrawal,accac570-de75-11e8-bd11-2f9252c4dc2f,AIRDROP,0
airdrop-20181115-hdac-4e760c93-ba11-4923-9c3e-cf83e8de5f48-withdrawal-exchange,2018.11.15 10:11,UNKNOWN,,UNKNOWN-55c0f2b7-dc24-425b-9be8-6b86719f2865,2018.11.15 10:11,UNKNOWN,0,100,0,HDAC,WITHDRAWAL,,,,0,COMPLETED,0,sum-user-id,1841871.27,airdrop-20181115-hdac-sum-user-id-withdrawal,accac570-de75-11e8-bd11-2f9252c4dc2f,AIRDROP,0
airdrop-20181115-hdac-4eaa30a3-5f6f-4663-8a29-a1492065471b-withdrawal-exchange,2018.11.15 10:11,UNKNOWN,,UNKNOWN-55c0f2b7-dc24-425b-9be8-6b86719f2865,2018.11.15 10:11,UNKNOWN,0,100,0,HDAC,WITHDRAWAL,,,,0,COMPLETED,0,sum-user-id,1841771.27,airdrop-20181115-hdac-sum-user-id-withdrawal,accac570-de75-11e8-bd11-2f9252c4dc2f,AIRDROP,0
airdrop-20181115-hdac-4eb03581-ab37-4d8a-937d-1889ddeed7e9-withdrawal-exchange,2018.11.15 10:11,UNKNOWN,,UNKNOWN-55c0f2b7-dc24-425b-9be8-6b86719f2865,2018.11.15 10:11,UNKNOWN,0,100,0,HDAC,WITHDRAWAL,,,,0,COMPLETED,0,sum-user-id,1841671.27,airdrop-20181115-hdac-sum-user-id-withdrawal,accac570-de75-11e8-bd11-2f9252c4dc2f,AIRDROP,0
airdrop-20181115-hdac-4ebc5478-70a5-417f-9528-c2887b7f31a7-withdrawal-exchange,2018.11.15 10:11,UNKNOWN,,UNKNOWN-55c0f2b7-dc24-425b-9be8-6b86719f2865,2018.11.15 10:11,UNKNOWN,0,100,0,HDAC,WITHDRAWAL,,,,0,COMPLETED,0,sum-user-id,1841571.27,airdrop-20181115-hdac-sum-user-id-withdrawal,accac570-de75-11e8-bd11-2f9252c4dc2f,AIRDROP,0
airdrop-20181115-hdac-4ec6816b-ec3e-49cf-b23b-b27b4f5abee9-withdrawal-exchange,2018.11.15 10:11,UNKNOWN,,UNKNOWN-55c0f2b7-dc24-425b-9be8-6b86719f2865,2018.11.15 10:11,UNKNOWN,0,100,0,HDAC,WITHDRAWAL,,,,0,COMPLETED,0,sum-user-id,1841471.27,airdrop-20181115-hdac-sum-user-id-withdrawal,accac570-de75-11e8-bd11-2f9252c4dc2f,AIRDROP,0
airdrop-20181115-hdac-4ed00f26-8192-45bb-b44e-cb293579414e-withdrawal-exchange,2018.11.15 10:11,UNKNOWN,,UNKNOWN-55c0f2b7-dc24-425b-9be8-6b86719f2865,2018.11.15 10:11,UNKNOWN,0,100,0,HDAC,WITHDRAWAL,,,,0,COMPLETED,0,sum-user-id,1841371.27,airdrop-20181115-hdac-sum-user-id-withdrawal,accac570-de75-11e8-bd11-2f9252c4dc2f,AIRDROP,0
airdrop-20181115-hdac-4f044a18-6344-4d55-b5e5-2ebd1fb18303-withdrawal-exchange,2018.11.15 10:11,UNKNOWN,,UNKNOWN-55c0f2b7-dc24-425b-9be8-6b86719f2865,2018.11.15 10:11,UNKNOWN,0,100,0,HDAC,WITHDRAWAL,,,,0,COMPLETED,0,sum-user-id,1841271.27,airdrop-20181115-hdac-sum-user-id-withdrawal,accac570-de75-11e8-bd11-2f9252c4dc2f,AIRDROP,0
airdrop-20181115-hdac-4f0ed910-719b-4193-93e2-b8bcbd675c40-withdrawal-exchange,2018.11.15 10:11,UNKNOWN,,UNKNOWN-55c0f2b7-dc24-425b-9be8-6b86719f2865,2018.11.15 10:11,UNKNOWN,0,100,0,HDAC,WITHDRAWAL,,,,0,COMPLETED,0,sum-user-id,1841171.27,airdrop-20181115-hdac-sum-user-id-withdrawal,accac570-de75-11e8-bd11-2f9252c4dc2f,AIRDROP,0
airdrop-20181115-hdac-4f3a0d31-4396-4b7d-b873-0f4d088b5e1e-withdrawal-exchange,2018.11.15 10:11,UNKNOWN,,UNKNOWN-55c0f2b7-dc24-425b-9be8-6b86719f2865,2018.11.15 10:11,UNKNOWN,0,100,0,HDAC,WITHDRAWAL,,,,0,COMPLETED,0,sum-user-id,1841071.27,airdrop-20181115-hdac-sum-user-id-withdrawal,accac570-de75-11e8-bd11-2f9252c4dc2f,AIRDROP,0
airdrop-20181115-hdac-4f402497-2537-4f26-87ab-c64fdaaa66f7-withdrawal-exchange,2018.11.15 10:11,UNKNOWN,,UNKNOWN-55c0f2b7-dc24-425b-9be8-6b86719f2865,2018.11.15 10:11,UNKNOWN,0,100,0,HDAC,WITHDRAWAL,,,,0,COMPLETED,0,sum-user-id,1840971.27,airdrop-20181115-hdac-sum-user-id-withdrawal,accac570-de75-11e8-bd11-2f9252c4dc2f,AIRDROP,0
airdrop-20181115-hdac-4f8c7268-04b9-4874-b6ff-45fdc2bf12b4-withdrawal-exchange,2018.11.15 10:11,UNKNOWN,,UNKNOWN-55c0f2b7-dc24-425b-9be8-6b86719f2865,2018.11.15 10:11,UNKNOWN,0,100,0,HDAC,WITHDRAWAL,,,,0,COMPLETED,0,sum-user-id,1840871.27,airdrop-20181115-hdac-sum-user-id-withdrawal,accac570-de75-11e8-bd11-2f9252c4dc2f,AIRDROP,0
airdrop-20181115-hdac-4fabef2c-806e-451a-9b44-cbf41809d673-withdrawal-exchange,2018.11.15 10:11,UNKNOWN,,UNKNOWN-55c0f2b7-dc24-425b-9be8-6b86719f2865,2018.11.15 10:11,UNKNOWN,0,100,0,HDAC,WITHDRAWAL,,,,0,COMPLETED,0,sum-user-id,1840771.27,airdrop-20181115-hdac-sum-user-id-withdrawal,accac570-de75-11e8-bd11-2f9252c4dc2f,AIRDROP,0
airdrop-20181115-hdac-4fe64df1-855f-458b-a5c8-191bed0686e6-withdrawal-exchange,2018.11.15 10:11,UNKNOWN,,UNKNOWN-55c0f2b7-dc24-425b-9be8-6b86719f2865,2018.11.15 10:11,UNKNOWN,0,100,0,HDAC,WITHDRAWAL,,,,0,COMPLETED,0,sum-user-id,1840671.27,airdrop-20181115-hdac-sum-user-id-withdrawal,accac570-de75-11e8-bd11-2f9252c4dc2f,AIRDROP,0
airdrop-20181115-hdac-4fe91375-1d9b-4817-8e74-505a5a4ff069-withdrawal-exchange,2018.11.15 10:11,UNKNOWN,,UNKNOWN-55c0f2b7-dc24-425b-9be8-6b86719f2865,2018.11.15 10:11,UNKNOWN,0,100,0,HDAC,WITHDRAWAL,,,,0,COMPLETED,0,sum-user-id,1840571.27,airdrop-20181115-hdac-sum-user-id-withdrawal,accac570-de75-11e8-bd11-2f9252c4dc2f,AIRDROP,0
airdrop-20181115-hdac-4fefa8d9-0c55-49c3-bc6d-87627c1f7571-withdrawal-exchange,2018.11.15 10:11,UNKNOWN,,UNKNOWN-55c0f2b7-dc24-425b-9be8-6b86719f2865,2018.11.15 10:11,UNKNOWN,0,100,0,HDAC,WITHDRAWAL,,,,0,COMPLETED,0,sum-user-id,1840471.27,airdrop-20181115-hdac-sum-user-id-withdrawal,accac570-de75-11e8-bd11-2f9252c4dc2f,AIRDROP,0
airdrop-20181115-hdac-500f5f61-8943-4a0c-a419-d515c89d019b-withdrawal-exchange,2018.11.15 10:11,UNKNOWN,,UNKNOWN-55c0f2b7-dc24-425b-9be8-6b86719f2865,2018.11.15 10:11,UNKNOWN,0,100,0,HDAC,WITHDRAWAL,,,,0,COMPLETED,0,sum-user-id,1840371.27,airdrop-20181115-hdac-sum-user-id-withdrawal,accac570-de75-11e8-bd11-2f9252c4dc2f,AIRDROP,0
airdrop-20181115-hdac-501586c3-7cd9-4339-900e-addfde004c23-withdrawal-exchange,2018.11.15 10:11,UNKNOWN,,UNKNOWN-55c0f2b7-dc24-425b-9be8-6b86719f2865,2018.11.15 10:11,UNKNOWN,0,100,0,HDAC,WITHDRAWAL,,,,0,COMPLETED,0,sum-user-id,1840271.27,airdrop-20181115-hdac-sum-user-id-withdrawal,accac570-de75-11e8-bd11-2f9252c4dc2f,AIRDROP,0
airdrop-20181115-hdac-5018cc25-bbbf-4b7e-92f9-c67add35075b-withdrawal-exchange,2018.11.15 10:11,UNKNOWN,,UNKNOWN-55c0f2b7-dc24-425b-9be8-6b86719f2865,2018.11.15 10:11,UNKNOWN,0,100,0,HDAC,WITHDRAWAL,,,,0,COMPLETED,0,sum-user-id,1840171.27,airdrop-20181115-hdac-sum-user-id-withdrawal,accac570-de75-11e8-bd11-2f9252c4dc2f,AIRDROP,0
airdrop-20181115-hdac-502e22a5-abc9-48ab-9fc3-639a8cc865f9-withdrawal-exchange,2018-11-15 10:11:32.027,UNKNOWN,,UNKNOWN-55c0f2b7-dc24-425b-9be8-6b86719f2865,2018-11-15 10:11:32.027,UNKNOWN,0,100,0,HDAC,WITHDRAWAL,,,,0,COMPLETED,0,sum-user-id,1840071.27,airdrop-20181115-hdac-sum-user-id-withdrawal,accac570-de75-11e8-bd11-2f9252c4dc2f,AIRDROP,0
airdrop-20181115-hdac-50336081-55d8-470f-b70d-974f490d0dc9-withdrawal-exchange,2018-11-15 10:11:32.057,UNKNOWN,,UNKNOWN-55c0f2b7-dc24-425b-9be8-6b86719f2865,2018-11-15 10:11:32.057,UNKNOWN,0,100,0,HDAC,WITHDRAWAL,,,,0,COMPLETED,0,sum-user-id,1839971.27,airdrop-20181115-hdac-sum-user-id-withdrawal,accac570-de75-11e8-bd11-2f9252c4dc2f,AIRDROP,0
airdrop-20181115-hdac-503906d8-7c37-401d-a899-501bcbfe0e30-withdrawal-exchange,2018-11-15 10:11:32.088,UNKNOWN,,UNKNOWN-55c0f2b7-dc24-425b-9be8-6b86719f2865,2018-11-15 10:11:32.088,UNKNOWN,0,100,0,HDAC,WITHDRAWAL,,,,0,COMPLETED,0,sum-user-id,1839871.27,airdrop-20181115-hdac-sum-user-id-withdrawal,accac570-de75-11e8-bd11-2f9252c4dc2f,AIRDROP,0
airdrop-20181115-hdac-505c9e67-3887-44b8-b5f7-8dc2c7a9940e-withdrawal-exchange,2018.11.15 10:11,UNKNOWN,,UNKNOWN-55c0f2b7-dc24-425b-9be8-6b86719f2865,2018.11.15 10:11,UNKNOWN,0,100,0,HDAC,WITHDRAWAL,,,,0,COMPLETED,0,sum-user-id,1839771.27,airdrop-20181115-hdac-sum-user-id-withdrawal,accac570-de75-11e8-bd11-2f9252c4dc2f,AIRDROP,0
airdrop-20181115-hdac-50650c54-f640-46cd-a6ce-c996887d0dbd-withdrawal-exchange,2018.11.15 10:11,UNKNOWN,,UNKNOWN-55c0f2b7-dc24-425b-9be8-6b86719f2865,2018.11.15 10:11,UNKNOWN,0,100,0,HDAC,WITHDRAWAL,,,,0,COMPLETED,0,sum-user-id,1839671.27,airdrop-20181115-hdac-sum-user-id-withdrawal,accac570-de75-11e8-bd11-2f9252c4dc2f,AIRDROP,0
airdrop-20181115-hdac-50acc04a-07ad-4754-b30e-d535f7187d5e-withdrawal-exchange,2018.11.15 10:11,UNKNOWN,,UNKNOWN-55c0f2b7-dc24-425b-9be8-6b86719f2865,2018.11.15 10:11,UNKNOWN,0,100,0,HDAC,WITHDRAWAL,,,,0,COMPLETED,0,sum-user-id,1839571.27,airdrop-20181115-hdac-sum-user-id-withdrawal,accac570-de75-11e8-bd11-2f9252c4dc2f,AIRDROP,0
airdrop-20181115-hdac-50d7550a-8b77-479d-90d8-d218a0522c8b-withdrawal-exchange,2018.11.15 10:11,UNKNOWN,,UNKNOWN-55c0f2b7-dc24-425b-9be8-6b86719f2865,2018.11.15 10:11,UNKNOWN,0,100,0,HDAC,WITHDRAWAL,,,,0,COMPLETED,0,sum-user-id,1839471.27,airdrop-20181115-hdac-sum-user-id-withdrawal,accac570-de75-11e8-bd11-2f9252c4dc2f,AIRDROP,0
airdrop-20181115-hdac-50dc1c7d-1345-4663-bed2-dfa46b2e1f8b-withdrawal-exchange,2018.11.15 10:11,UNKNOWN,,UNKNOWN-55c0f2b7-dc24-425b-9be8-6b86719f2865,2018.11.15 10:11,UNKNOWN,0,100,0,HDAC,WITHDRAWAL,,,,0,COMPLETED,0,sum-user-id,1839371.27,airdrop-20181115-hdac-sum-user-id-withdrawal,accac570-de75-11e8-bd11-2f9252c4dc2f,AIRDROP,0
airdrop-20181115-hdac-50fbd83d-f049-40e4-ab07-0b44fb26fce0-withdrawal-exchange,2018.11.15 10:11,UNKNOWN,,UNKNOWN-55c0f2b7-dc24-425b-9be8-6b86719f2865,2018.11.15 10:11,UNKNOWN,0,100,0,HDAC,WITHDRAWAL,,,,0,COMPLETED,0,sum-user-id,1839271.27,airdrop-20181115-hdac-sum-user-id-withdrawal,accac570-de75-11e8-bd11-2f9252c4dc2f,AIRDROP,0
airdrop-20181115-hdac-51428eef-b5b7-4c49-a39f-162fa29bb7ba-withdrawal-exchange,2018.11.15 10:11,UNKNOWN,,UNKNOWN-55c0f2b7-dc24-425b-9be8-6b86719f2865,2018.11.15 10:11,UNKNOWN,0,100,0,HDAC,WITHDRAWAL,,,,0,COMPLETED,0,sum-user-id,1839171.27,airdrop-20181115-hdac-sum-user-id-withdrawal,accac570-de75-11e8-bd11-2f9252c4dc2f,AIRDROP,0
airdrop-20181115-hdac-515a33aa-20ab-45a5-a046-5ef4c3772ec8-withdrawal-exchange,2018.11.15 10:11,UNKNOWN,,UNKNOWN-55c0f2b7-dc24-425b-9be8-6b86719f2865,2018.11.15 10:11,UNKNOWN,0,100,0,HDAC,WITHDRAWAL,,,,0,COMPLETED,0,sum-user-id,1839071.27,airdrop-20181115-hdac-sum-user-id-withdrawal,accac570-de75-11e8-bd11-2f9252c4dc2f,AIRDROP,0
airdrop-20181115-hdac-51867520-0c7d-4a80-9e77-84bb42dc805f-withdrawal-exchange,2018.11.15 10:11,UNKNOWN,,UNKNOWN-55c0f2b7-dc24-425b-9be8-6b86719f2865,2018.11.15 10:11,UNKNOWN,0,100,0,HDAC,WITHDRAWAL,,,,0,COMPLETED,0,sum-user-id,1838971.27,airdrop-20181115-hdac-sum-user-id-withdrawal,accac570-de75-11e8-bd11-2f9252c4dc2f,AIRDROP,0
airdrop-20181115-hdac-51995f10-c00a-45ad-83e5-13e15d71cba2-withdrawal-exchange,2018.11.15 10:11,UNKNOWN,,UNKNOWN-55c0f2b7-dc24-425b-9be8-6b86719f2865,2018.11.15 10:11,UNKNOWN,0,11030.57012,0,HDAC,WITHDRAWAL,,,,0,COMPLETED,0,sum-user-id,1827940.7,airdrop-20181115-hdac-sum-user-id-withdrawal,accac570-de75-11e8-bd11-2f9252c4dc2f,AIRDROP,0
airdrop-20181115-hdac-51c5cac6-2dbe-4334-88f5-92a356836b2a-withdrawal-exchange,2018.11.15 10:11,UNKNOWN,,UNKNOWN-55c0f2b7-dc24-425b-9be8-6b86719f2865,2018.11.15 10:11,UNKNOWN,0,100,0,HDAC,WITHDRAWAL,,,,0,COMPLETED,0,sum-user-id,1827840.7,airdrop-20181115-hdac-sum-user-id-withdrawal,accac570-de75-11e8-bd11-2f9252c4dc2f,AIRDROP,0
airdrop-20181115-hdac-51e141dd-ffd2-4e08-8938-3d35a4092acc-withdrawal-exchange,2018.11.15 10:11,UNKNOWN,,UNKNOWN-55c0f2b7-dc24-425b-9be8-6b86719f2865,2018.11.15 10:11,UNKNOWN,0,100,0,HDAC,WITHDRAWAL,,,,0,COMPLETED,0,sum-user-id,1827740.7,airdrop-20181115-hdac-sum-user-id-withdrawal,accac570-de75-11e8-bd11-2f9252c4dc2f,AIRDROP,0
airdrop-20181115-hdac-51e97b6b-ad41-4220-98dc-e4a4194e6e16-withdrawal-exchange,2018.11.15 10:11,UNKNOWN,,UNKNOWN-55c0f2b7-dc24-425b-9be8-6b86719f2865,2018.11.15 10:11,UNKNOWN,0,100,0,HDAC,WITHDRAWAL,,,,0,COMPLETED,0,sum-user-id,1827640.7,airdrop-20181115-hdac-sum-user-id-withdrawal,accac570-de75-11e8-bd11-2f9252c4dc2f,AIRDROP,0
airdrop-20181115-hdac-51f49c94-6540-48f5-a608-5afbbd26306f-withdrawal-exchange,2018.11.15 10:11,UNKNOWN,,UNKNOWN-55c0f2b7-dc24-425b-9be8-6b86719f2865,2018.11.15 10:11,UNKNOWN,0,100,0,HDAC,WITHDRAWAL,,,,0,COMPLETED,0,sum-user-id,1827540.7,airdrop-20181115-hdac-sum-user-id-withdrawal,accac570-de75-11e8-bd11-2f9252c4dc2f,AIRDROP,0
airdrop-20181115-hdac-51fa6f05-bed4-44e5-822f-4b552cdf2214-withdrawal-exchange,2018.11.15 10:11,UNKNOWN,,UNKNOWN-55c0f2b7-dc24-425b-9be8-6b86719f2865,2018.11.15 10:11,UNKNOWN,0,100,0,HDAC,WITHDRAWAL,,,,0,COMPLETED,0,sum-user-id,1827440.7,airdrop-20181115-hdac-sum-user-id-withdrawal,accac570-de75-11e8-bd11-2f9252c4dc2f,AIRDROP,0
airdrop-20181115-hdac-5221aa0c-9046-41e9-ab30-a4c328f6f87f-withdrawal-exchange,2018.11.15 10:11,UNKNOWN,,UNKNOWN-55c0f2b7-dc24-425b-9be8-6b86719f2865,2018.11.15 10:11,UNKNOWN,0,100,0,HDAC,WITHDRAWAL,,,,0,COMPLETED,0,sum-user-id,1827340.7,airdrop-20181115-hdac-sum-user-id-withdrawal,accac570-de75-11e8-bd11-2f9252c4dc2f,AIRDROP,0
airdrop-20181115-hdac-5221fd46-337e-4ddb-93e9-47de4c3a7ddb-withdrawal-exchange,2018.11.15 10:11,UNKNOWN,,UNKNOWN-55c0f2b7-dc24-425b-9be8-6b86719f2865,2018.11.15 10:11,UNKNOWN,0,100,0,HDAC,WITHDRAWAL,,,,0,COMPLETED,0,sum-user-id,1827240.7,airdrop-20181115-hdac-sum-user-id-withdrawal,accac570-de75-11e8-bd11-2f9252c4dc2f,AIRDROP,0
airdrop-20181115-hdac-522fbdd4-770f-431f-a346-aa545d87ad38-withdrawal-exchange,2018.11.15 10:11,UNKNOWN,,UNKNOWN-55c0f2b7-dc24-425b-9be8-6b86719f2865,2018.11.15 10:11,UNKNOWN,0,100,0,HDAC,WITHDRAWAL,,,,0,COMPLETED,0,sum-user-id,1827140.7,airdrop-20181115-hdac-sum-user-id-withdrawal,accac570-de75-11e8-bd11-2f9252c4dc2f,AIRDROP,0
airdrop-20181115-hdac-5262a0bf-a127-4c80-8e39-362875c96315-withdrawal-exchange,2018.11.15 10:11,UNKNOWN,,UNKNOWN-55c0f2b7-dc24-425b-9be8-6b86719f2865,2018.11.15 10:11,UNKNOWN,0,100,0,HDAC,WITHDRAWAL,,,,0,COMPLETED,0,sum-user-id,1827040.7,airdrop-20181115-hdac-sum-user-id-withdrawal,accac570-de75-11e8-bd11-2f9252c4dc2f,AIRDROP,0
airdrop-20181115-hdac-526bae89-b095-416a-b0d7-9f4b0623e2b0-withdrawal-exchange,2018.11.15 10:11,UNKNOWN,,UNKNOWN-55c0f2b7-dc24-425b-9be8-6b86719f2865,2018.11.15 10:11,UNKNOWN,0,100,0,HDAC,WITHDRAWAL,,,,0,COMPLETED,0,sum-user-id,1826940.7,airdrop-20181115-hdac-sum-user-id-withdrawal,accac570-de75-11e8-bd11-2f9252c4dc2f,AIRDROP,0
airdrop-20181115-hdac-528c82db-53c5-4d8a-aae3-0091edc1b682-withdrawal-exchange,2018.11.15 10:11,UNKNOWN,,UNKNOWN-55c0f2b7-dc24-425b-9be8-6b86719f2865,2018.11.15 10:11,UNKNOWN,0,100,0,HDAC,WITHDRAWAL,,,,0,COMPLETED,0,sum-user-id,1826840.7,airdrop-20181115-hdac-sum-user-id-withdrawal,accac570-de75-11e8-bd11-2f9252c4dc2f,AIRDROP,0
airdrop-20181115-hdac-52a73e15-772f-481f-8f60-e6ef19cba1ed-withdrawal-exchange,2018.11.15 10:11,UNKNOWN,,UNKNOWN-55c0f2b7-dc24-425b-9be8-6b86719f2865,2018.11.15 10:11,UNKNOWN,0,100,0,HDAC,WITHDRAWAL,,,,0,COMPLETED,0,sum-user-id,1826740.7,airdrop-20181115-hdac-sum-user-id-withdrawal,accac570-de75-11e8-bd11-2f9252c4dc2f,AIRDROP,0
airdrop-20181115-hdac-52b0e341-f9a5-4ca4-b237-467ae8cacc2f-withdrawal-exchange,2018.11.15 10:12,UNKNOWN,,UNKNOWN-55c0f2b7-dc24-425b-9be8-6b86719f2865,2018.11.15 10:12,UNKNOWN,0,2384.56,0,HDAC,WITHDRAWAL,,,,0,COMPLETED,0,sum-user-id,1301489.604,airdrop-20181115-hdac-sum-user-id-withdrawal,accac570-de75-11e8-bd11-2f9252c4dc2f,AIRDROP,0
airdrop-20181115-hdac-52c32083-8232-4b7c-9cef-8b8c7819e535-withdrawal-exchange,2018.11.15 10:11,UNKNOWN,,UNKNOWN-55c0f2b7-dc24-425b-9be8-6b86719f2865,2018.11.15 10:11,UNKNOWN,0,100,0,HDAC,WITHDRAWAL,,,,0,COMPLETED,0,sum-user-id,1826640.7,airdrop-20181115-hdac-sum-user-id-withdrawal,accac570-de75-11e8-bd11-2f9252c4dc2f,AIRDROP,0
airdrop-20181115-hdac-52efb07a-2721-4029-abdc-c2edf841dbd4-withdrawal-exchange,2018.11.15 10:11,UNKNOWN,,UNKNOWN-55c0f2b7-dc24-425b-9be8-6b86719f2865,2018.11.15 10:11,UNKNOWN,0,100,0,HDAC,WITHDRAWAL,,,,0,COMPLETED,0,sum-user-id,1826540.7,airdrop-20181115-hdac-sum-user-id-withdrawal,accac570-de75-11e8-bd11-2f9252c4dc2f,AIRDROP,0
airdrop-20181115-hdac-5307bd30-0373-437e-ba0b-ca9d25536c44-withdrawal-exchange,2018.11.15 10:11,UNKNOWN,,UNKNOWN-55c0f2b7-dc24-425b-9be8-6b86719f2865,2018.11.15 10:11,UNKNOWN,0,100,0,HDAC,WITHDRAWAL,,,,0,COMPLETED,0,sum-user-id,1826440.7,airdrop-20181115-hdac-sum-user-id-withdrawal,accac570-de75-11e8-bd11-2f9252c4dc2f,AIRDROP,0
airdrop-20181115-hdac-530cda7a-8fcd-4adf-8c28-74fd5b9d8992-withdrawal-exchange,2018.11.15 10:11,UNKNOWN,,UNKNOWN-55c0f2b7-dc24-425b-9be8-6b86719f2865,2018.11.15 10:11,UNKNOWN,0,100,0,HDAC,WITHDRAWAL,,,,0,COMPLETED,0,sum-user-id,1826340.7,airdrop-20181115-hdac-sum-user-id-withdrawal,accac570-de75-11e8-bd11-2f9252c4dc2f,AIRDROP,0
airdrop-20181115-hdac-53267d99-1d31-49ab-b0ce-6799887d0c96-withdrawal-exchange,2018.11.15 10:11,UNKNOWN,,UNKNOWN-55c0f2b7-dc24-425b-9be8-6b86719f2865,2018.11.15 10:11,UNKNOWN,0,100,0,HDAC,WITHDRAWAL,,,,0,COMPLETED,0,sum-user-id,1826240.7,airdrop-20181115-hdac-sum-user-id-withdrawal,accac570-de75-11e8-bd11-2f9252c4dc2f,AIRDROP,0
airdrop-20181115-hdac-535cf55f-f7b4-400b-bbca-c4bf37580865-withdrawal-exchange,2018-11-15 10:11:33.015,UNKNOWN,,UNKNOWN-55c0f2b7-dc24-425b-9be8-6b86719f2865,2018-11-15 10:11:33.015,UNKNOWN,0,100,0,HDAC,WITHDRAWAL,,,,0,COMPLETED,0,sum-user-id,1826140.7,airdrop-20181115-hdac-sum-user-id-withdrawal,accac570-de75-11e8-bd11-2f9252c4dc2f,AIRDROP,0
airdrop-20181115-hdac-5361c2ec-35d8-4536-8761-b609a0e38075-withdrawal-exchange,2018-11-15 10:11:33.045,UNKNOWN,,UNKNOWN-55c0f2b7-dc24-425b-9be8-6b86719f2865,2018-11-15 10:11:33.045,UNKNOWN,0,100,0,HDAC,WITHDRAWAL,,,,0,COMPLETED,0,sum-user-id,1826040.7,airdrop-20181115-hdac-sum-user-id-withdrawal,accac570-de75-11e8-bd11-2f9252c4dc2f,AIRDROP,0
airdrop-20181115-hdac-5371ee93-cc55-4c08-af3c-46aec5f266fa-withdrawal-exchange,2018-11-15 10:11:33.074,UNKNOWN,,UNKNOWN-55c0f2b7-dc24-425b-9be8-6b86719f2865,2018-11-15 10:11:33.074,UNKNOWN,0,100,0,HDAC,WITHDRAWAL,,,,0,COMPLETED,0,sum-user-id,1825940.7,airdrop-20181115-hdac-sum-user-id-withdrawal,accac570-de75-11e8-bd11-2f9252c4dc2f,AIRDROP,0
airdrop-20181115-hdac-539b7b74-3f80-4541-9e97-eba798517b16-withdrawal-exchange,2018.11.15 10:11,UNKNOWN,,UNKNOWN-55c0f2b7-dc24-425b-9be8-6b86719f2865,2018.11.15 10:11,UNKNOWN,0,100,0,HDAC,WITHDRAWAL,,,,0,COMPLETED,0,sum-user-id,1825840.7,airdrop-20181115-hdac-sum-user-id-withdrawal,accac570-de75-11e8-bd11-2f9252c4dc2f,AIRDROP,0
airdrop-20181115-hdac-539d243c-6f7d-42aa-88c2-1866ba1ced78-withdrawal-exchange,2018.11.15 10:11,UNKNOWN,,UNKNOWN-55c0f2b7-dc24-425b-9be8-6b86719f2865,2018.11.15 10:11,UNKNOWN,0,100,0,HDAC,WITHDRAWAL,,,,0,COMPLETED,0,sum-user-id,1825740.7,airdrop-20181115-hdac-sum-user-id-withdrawal,accac570-de75-11e8-bd11-2f9252c4dc2f,AIRDROP,0
airdrop-20181115-hdac-53b041fc-7574-4004-ab8e-02de9cf263f1-withdrawal-exchange,2018.11.15 10:11,UNKNOWN,,UNKNOWN-55c0f2b7-dc24-425b-9be8-6b86719f2865,2018.11.15 10:11,UNKNOWN,0,100,0,HDAC,WITHDRAWAL,,,,0,COMPLETED,0,sum-user-id,1825640.7,airdrop-20181115-hdac-sum-user-id-withdrawal,accac570-de75-11e8-bd11-2f9252c4dc2f,AIRDROP,0
airdrop-20181115-hdac-53db3279-6fb6-478d-af77-0e9ce7740e4a-withdrawal-exchange,2018.11.15 10:11,UNKNOWN,,UNKNOWN-55c0f2b7-dc24-425b-9be8-6b86719f2865,2018.11.15 10:11,UNKNOWN,0,100,0,HDAC,WITHDRAWAL,,,,0,COMPLETED,0,sum-user-id,1825540.7,airdrop-20181115-hdac-sum-user-id-withdrawal,accac570-de75-11e8-bd11-2f9252c4dc2f,AIRDROP,0
airdrop-20181115-hdac-5438f91f-b4b7-4c2e-a39d-92f4cbd01146-withdrawal-exchange,2018.11.15 10:11,UNKNOWN,,UNKNOWN-55c0f2b7-dc24-425b-9be8-6b86719f2865,2018.11.15 10:11,UNKNOWN,0,100,0,HDAC,WITHDRAWAL,,,,0,COMPLETED,0,sum-user-id,1825440.7,airdrop-20181115-hdac-sum-user-id-withdrawal,accac570-de75-11e8-bd11-2f9252c4dc2f,AIRDROP,0
airdrop-20181115-hdac-546a9ab4-61a3-48f9-8583-bfb149cab9ab-withdrawal-exchange,2018.11.15 10:11,UNKNOWN,,UNKNOWN-55c0f2b7-dc24-425b-9be8-6b86719f2865,2018.11.15 10:11,UNKNOWN,0,100,0,HDAC,WITHDRAWAL,,,,0,COMPLETED,0,sum-user-id,1825340.7,airdrop-20181115-hdac-sum-user-id-withdrawal,accac570-de75-11e8-bd11-2f9252c4dc2f,AIRDROP,0
airdrop-20181115-hdac-546af98c-b656-4d9b-965e-ae9f8195dca0-withdrawal-exchange,2018.11.15 10:11,UNKNOWN,,UNKNOWN-55c0f2b7-dc24-425b-9be8-6b86719f2865,2018.11.15 10:11,UNKNOWN,0,100,0,HDAC,WITHDRAWAL,,,,0,COMPLETED,0,sum-user-id,1825240.7,airdrop-20181115-hdac-sum-user-id-withdrawal,accac570-de75-11e8-bd11-2f9252c4dc2f,AIRDROP,0
airdrop-20181115-hdac-549c2239-97f0-46ef-8988-3ac592bc9c78-withdrawal-exchange,2018.11.15 10:11,UNKNOWN,,UNKNOWN-55c0f2b7-dc24-425b-9be8-6b86719f2865,2018.11.15 10:11,UNKNOWN,0,100,0,HDAC,WITHDRAWAL,,,,0,COMPLETED,0,sum-user-id,1825140.7,airdrop-20181115-hdac-sum-user-id-withdrawal,accac570-de75-11e8-bd11-2f9252c4dc2f,AIRDROP,0
airdrop-20181115-hdac-54b3d9c2-a9f9-4961-b5af-04a86dcfb228-withdrawal-exchange,2018.11.15 10:11,UNKNOWN,,UNKNOWN-55c0f2b7-dc24-425b-9be8-6b86719f2865,2018.11.15 10:11,UNKNOWN,0,100,0,HDAC,WITHDRAWAL,,,,0,COMPLETED,0,sum-user-id,1825040.7,airdrop-20181115-hdac-sum-user-id-withdrawal,accac570-de75-11e8-bd11-2f9252c4dc2f,AIRDROP,0
airdrop-20181115-hdac-54c53644-21f0-455b-b0d4-4e9c688681da-withdrawal-exchange,2018.11.15 10:11,UNKNOWN,,UNKNOWN-55c0f2b7-dc24-425b-9be8-6b86719f2865,2018.11.15 10:11,UNKNOWN,0,100,0,HDAC,WITHDRAWAL,,,,0,COMPLETED,0,sum-user-id,1824940.7,airdrop-20181115-hdac-sum-user-id-withdrawal,accac570-de75-11e8-bd11-2f9252c4dc2f,AIRDROP,0
airdrop-20181115-hdac-54cbe0d3-5932-4c96-89a6-ffa14fc5f111-withdrawal-exchange,2018.11.15 10:11,UNKNOWN,,UNKNOWN-55c0f2b7-dc24-425b-9be8-6b86719f2865,2018.11.15 10:11,UNKNOWN,0,100,0,HDAC,WITHDRAWAL,,,,0,COMPLETED,0,sum-user-id,1824840.7,airdrop-20181115-hdac-sum-user-id-withdrawal,accac570-de75-11e8-bd11-2f9252c4dc2f,AIRDROP,0
airdrop-20181115-hdac-54ed9aad-0695-492d-92d3-8c23de01e2c8-withdrawal-exchange,2018.11.15 10:11,UNKNOWN,,UNKNOWN-55c0f2b7-dc24-425b-9be8-6b86719f2865,2018.11.15 10:11,UNKNOWN,0,100,0,HDAC,WITHDRAWAL,,,,0,COMPLETED,0,sum-user-id,1824740.7,airdrop-20181115-hdac-sum-user-id-withdrawal,accac570-de75-11e8-bd11-2f9252c4dc2f,AIRDROP,0
airdrop-20181115-hdac-5517a68d-951f-4194-b3e6-e163fbaa58d4-withdrawal-exchange,2018.11.15 10:11,UNKNOWN,,UNKNOWN-55c0f2b7-dc24-425b-9be8-6b86719f2865,2018.11.15 10:11,UNKNOWN,0,100,0,HDAC,WITHDRAWAL,,,,0,COMPLETED,0,sum-user-id,1824640.7,airdrop-20181115-hdac-sum-user-id-withdrawal,accac570-de75-11e8-bd11-2f9252c4dc2f,AIRDROP,0
airdrop-20181115-hdac-554f23e6-6422-45bd-b320-cb234cbeb5c6-withdrawal-exchange,2018.11.15 10:11,UNKNOWN,,UNKNOWN-55c0f2b7-dc24-425b-9be8-6b86719f2865,2018.11.15 10:11,UNKNOWN,0,100,0,HDAC,WITHDRAWAL,,,,0,COMPLETED,0,sum-user-id,1824540.7,airdrop-20181115-hdac-sum-user-id-withdrawal,accac570-de75-11e8-bd11-2f9252c4dc2f,AIRDROP,0
airdrop-20181115-hdac-559b0b69-2d75-481e-b2e6-81455a84a9f3-withdrawal-exchange,2018.11.15 10:11,UNKNOWN,,UNKNOWN-55c0f2b7-dc24-425b-9be8-6b86719f2865,2018.11.15 10:11,UNKNOWN,0,100,0,HDAC,WITHDRAWAL,,,,0,COMPLETED,0,sum-user-id,1824440.7,airdrop-20181115-hdac-sum-user-id-withdrawal,accac570-de75-11e8-bd11-2f9252c4dc2f,AIRDROP,0
airdrop-20181115-hdac-55b4e2a9-f191-40d0-a04f-a1a4fa817750-withdrawal-exchange,2018.11.15 10:11,UNKNOWN,,UNKNOWN-55c0f2b7-dc24-425b-9be8-6b86719f2865,2018.11.15 10:11,UNKNOWN,0,100,0,HDAC,WITHDRAWAL,,,,0,COMPLETED,0,sum-user-id,1824340.7,airdrop-20181115-hdac-sum-user-id-withdrawal,accac570-de75-11e8-bd11-2f9252c4dc2f,AIRDROP,0
airdrop-20181115-hdac-55c77706-e39a-48ba-b21a-cd2d024f21db-withdrawal-exchange,2018.11.15 10:11,UNKNOWN,,UNKNOWN-55c0f2b7-dc24-425b-9be8-6b86719f2865,2018.11.15 10:11,UNKNOWN,0,100,0,HDAC,WITHDRAWAL,,,,0,COMPLETED,0,sum-user-id,1824240.7,airdrop-20181115-hdac-sum-user-id-withdrawal,accac570-de75-11e8-bd11-2f9252c4dc2f,AIRDROP,0
airdrop-20181115-hdac-56193680-4e03-4348-82ee-a5a4e5a6ea44-withdrawal-exchange,2018.11.15 10:11,UNKNOWN,,UNKNOWN-55c0f2b7-dc24-425b-9be8-6b86719f2865,2018.11.15 10:11,UNKNOWN,0,100,0,HDAC,WITHDRAWAL,,,,0,COMPLETED,0,sum-user-id,1824140.7,airdrop-20181115-hdac-sum-user-id-withdrawal,accac570-de75-11e8-bd11-2f9252c4dc2f,AIRDROP,0
airdrop-20181115-hdac-561f8226-a318-4366-8b54-6f7b12904c2a-withdrawal-exchange,2018.11.15 10:11,UNKNOWN,,UNKNOWN-55c0f2b7-dc24-425b-9be8-6b86719f2865,2018.11.15 10:11,UNKNOWN,0,100,0,HDAC,WITHDRAWAL,,,,0,COMPLETED,0,sum-user-id,1824040.7,airdrop-20181115-hdac-sum-user-id-withdrawal,accac570-de75-11e8-bd11-2f9252c4dc2f,AIRDROP,0
airdrop-20181115-hdac-564bd620-9dc6-4832-9225-28610f1853ce-withdrawal-exchange,2018.11.15 10:11,UNKNOWN,,UNKNOWN-55c0f2b7-dc24-425b-9be8-6b86719f2865,2018.11.15 10:11,UNKNOWN,0,100,0,HDAC,WITHDRAWAL,,,,0,COMPLETED,0,sum-user-id,1823940.7,airdrop-20181115-hdac-sum-user-id-withdrawal,accac570-de75-11e8-bd11-2f9252c4dc2f,AIRDROP,0
airdrop-20181115-hdac-566d0d6f-70bb-417f-9bd2-b75fc0141dda-withdrawal-exchange,2018.11.15 10:11,UNKNOWN,,UNKNOWN-55c0f2b7-dc24-425b-9be8-6b86719f2865,2018.11.15 10:11,UNKNOWN,0,100,0,HDAC,WITHDRAWAL,,,,0,COMPLETED,0,sum-user-id,1823840.7,airdrop-20181115-hdac-sum-user-id-withdrawal,accac570-de75-11e8-bd11-2f9252c4dc2f,AIRDROP,0
airdrop-20181115-hdac-568627a2-7b0b-4369-a19f-1235f61f99a7-withdrawal-exchange,2018.11.15 10:11,UNKNOWN,,UNKNOWN-55c0f2b7-dc24-425b-9be8-6b86719f2865,2018.11.15 10:11,UNKNOWN,0,100,0,HDAC,WITHDRAWAL,,,,0,COMPLETED,0,sum-user-id,1823740.7,airdrop-20181115-hdac-sum-user-id-withdrawal,accac570-de75-11e8-bd11-2f9252c4dc2f,AIRDROP,0
airdrop-20181115-hdac-5692b459-92ff-43b5-af7f-74c8f5da5a78-withdrawal-exchange,2018.11.15 10:11,UNKNOWN,,UNKNOWN-55c0f2b7-dc24-425b-9be8-6b86719f2865,2018.11.15 10:11,UNKNOWN,0,100,0,HDAC,WITHDRAWAL,,,,0,COMPLETED,0,sum-user-id,1823640.7,airdrop-20181115-hdac-sum-user-id-withdrawal,accac570-de75-11e8-bd11-2f9252c4dc2f,AIRDROP,0
airdrop-20181115-hdac-56a89fbd-f5e1-45a2-a99e-ee9d5d9a3b74-withdrawal-exchange,2018.11.15 10:11,UNKNOWN,,UNKNOWN-55c0f2b7-dc24-425b-9be8-6b86719f2865,2018.11.15 10:11,UNKNOWN,0,100,0,HDAC,WITHDRAWAL,,,,0,COMPLETED,0,sum-user-id,1823540.7,airdrop-20181115-hdac-sum-user-id-withdrawal,accac570-de75-11e8-bd11-2f9252c4dc2f,AIRDROP,0
airdrop-20181115-hdac-56bf6c99-265b-457a-a45c-2fde8630d782-withdrawal-exchange,2018.11.15 10:11,UNKNOWN,,UNKNOWN-55c0f2b7-dc24-425b-9be8-6b86719f2865,2018.11.15 10:11,UNKNOWN,0,100,0,HDAC,WITHDRAWAL,,,,0,COMPLETED,0,sum-user-id,1823440.7,airdrop-20181115-hdac-sum-user-id-withdrawal,accac570-de75-11e8-bd11-2f9252c4dc2f,AIRDROP,0
airdrop-20181115-hdac-56dcb421-d0df-4ddc-bced-ab110651327d-withdrawal-exchange,2018.11.15 10:11,UNKNOWN,,UNKNOWN-55c0f2b7-dc24-425b-9be8-6b86719f2865,2018.11.15 10:11,UNKNOWN,0,100,0,HDAC,WITHDRAWAL,,,,0,COMPLETED,0,sum-user-id,1823340.7,airdrop-20181115-hdac-sum-user-id-withdrawal,accac570-de75-11e8-bd11-2f9252c4dc2f,AIRDROP,0
airdrop-20181115-hdac-56e0199f-5036-44cf-9d8e-4e08825f61cd-withdrawal-exchange,2018.11.15 10:11,UNKNOWN,,UNKNOWN-55c0f2b7-dc24-425b-9be8-6b86719f2865,2018.11.15 10:11,UNKNOWN,0,100,0,HDAC,WITHDRAWAL,,,,0,COMPLETED,0,sum-user-id,1823240.7,airdrop-20181115-hdac-sum-user-id-withdrawal,accac570-de75-11e8-bd11-2f9252c4dc2f,AIRDROP,0
airdrop-20181115-hdac-5703e5e3-0c1f-460c-8853-91e9b8a0e9d8-withdrawal-exchange,2018.11.15 10:11,UNKNOWN,,UNKNOWN-55c0f2b7-dc24-425b-9be8-6b86719f2865,2018.11.15 10:11,UNKNOWN,0,100,0,HDAC,WITHDRAWAL,,,,0,COMPLETED,0,sum-user-id,1823140.7,airdrop-20181115-hdac-sum-user-id-withdrawal,accac570-de75-11e8-bd11-2f9252c4dc2f,AIRDROP,0
airdrop-20181115-hdac-5777a5b8-70f4-4f8c-a3f5-34e0efca7e18-withdrawal-exchange,2018.11.15 10:11,UNKNOWN,,UNKNOWN-55c0f2b7-dc24-425b-9be8-6b86719f2865,2018.11.15 10:11,UNKNOWN,0,100,0,HDAC,WITHDRAWAL,,,,0,COMPLETED,0,sum-user-id,1823040.7,airdrop-20181115-hdac-sum-user-id-withdrawal,accac570-de75-11e8-bd11-2f9252c4dc2f,AIRDROP,0
airdrop-20181115-hdac-578c056e-e80a-43e1-a0c6-fe3f25e78595-withdrawal-exchange,2018-11-15 10:11:34.023,UNKNOWN,,UNKNOWN-55c0f2b7-dc24-425b-9be8-6b86719f2865,2018-11-15 10:11:34.023,UNKNOWN,0,100,0,HDAC,WITHDRAWAL,,,,0,COMPLETED,0,sum-user-id,1822940.7,airdrop-20181115-hdac-sum-user-id-withdrawal,accac570-de75-11e8-bd11-2f9252c4dc2f,AIRDROP,0
airdrop-20181115-hdac-57e1558a-bf08-4986-86f1-5306493dd2d0-withdrawal-exchange,2018-11-15 10:11:34.057,UNKNOWN,,UNKNOWN-55c0f2b7-dc24-425b-9be8-6b86719f2865,2018-11-15 10:11:34.057,UNKNOWN,0,100,0,HDAC,WITHDRAWAL,,,,0,COMPLETED,0,sum-user-id,1822840.7,airdrop-20181115-hdac-sum-user-id-withdrawal,accac570-de75-11e8-bd11-2f9252c4dc2f,AIRDROP,0
airdrop-20181115-hdac-57e52194-55fc-4962-81a9-6358c069b907-withdrawal-exchange,2018-11-15 10:11:34.086,UNKNOWN,,UNKNOWN-55c0f2b7-dc24-425b-9be8-6b86719f2865,2018-11-15 10:11:34.086,UNKNOWN,0,100,0,HDAC,WITHDRAWAL,,,,0,COMPLETED,0,sum-user-id,1822740.7,airdrop-20181115-hdac-sum-user-id-withdrawal,accac570-de75-11e8-bd11-2f9252c4dc2f,AIRDROP,0
airdrop-20181115-hdac-5808239e-7772-4b86-b4c9-7453f4bd7543-withdrawal-exchange,2018.11.15 10:11,UNKNOWN,,UNKNOWN-55c0f2b7-dc24-425b-9be8-6b86719f2865,2018.11.15 10:11,UNKNOWN,0,100,0,HDAC,WITHDRAWAL,,,,0,COMPLETED,0,sum-user-id,1822640.7,airdrop-20181115-hdac-sum-user-id-withdrawal,accac570-de75-11e8-bd11-2f9252c4dc2f,AIRDROP,0
airdrop-20181115-hdac-581dcf2f-6e1f-47e0-84bd-4384ae96a5ea-withdrawal-exchange,2018.11.15 10:11,UNKNOWN,,UNKNOWN-55c0f2b7-dc24-425b-9be8-6b86719f2865,2018.11.15 10:11,UNKNOWN,0,100,0,HDAC,WITHDRAWAL,,,,0,COMPLETED,0,sum-user-id,1822540.7,airdrop-20181115-hdac-sum-user-id-withdrawal,accac570-de75-11e8-bd11-2f9252c4dc2f,AIRDROP,0
airdrop-20181115-hdac-58210901-2e56-411b-bc58-ebe8482877f4-withdrawal-exchange,2018.11.15 10:11,UNKNOWN,,UNKNOWN-55c0f2b7-dc24-425b-9be8-6b86719f2865,2018.11.15 10:11,UNKNOWN,0,100,0,HDAC,WITHDRAWAL,,,,0,COMPLETED,0,sum-user-id,1822440.7,airdrop-20181115-hdac-sum-user-id-withdrawal,accac570-de75-11e8-bd11-2f9252c4dc2f,AIRDROP,0
airdrop-20181115-hdac-58374b03-caab-4c3e-a989-b00cc455507b-withdrawal-exchange,2018.11.15 10:11,UNKNOWN,,UNKNOWN-55c0f2b7-dc24-425b-9be8-6b86719f2865,2018.11.15 10:11,UNKNOWN,0,100,0,HDAC,WITHDRAWAL,,,,0,COMPLETED,0,sum-user-id,1822340.7,airdrop-20181115-hdac-sum-user-id-withdrawal,accac570-de75-11e8-bd11-2f9252c4dc2f,AIRDROP,0
airdrop-20181115-hdac-5837add7-e8a5-4714-95e5-334c1f2922c6-withdrawal-exchange,2018.11.15 10:11,UNKNOWN,,UNKNOWN-55c0f2b7-dc24-425b-9be8-6b86719f2865,2018.11.15 10:11,UNKNOWN,0,100,0,HDAC,WITHDRAWAL,,,,0,COMPLETED,0,sum-user-id,1822240.7,airdrop-20181115-hdac-sum-user-id-withdrawal,accac570-de75-11e8-bd11-2f9252c4dc2f,AIRDROP,0
airdrop-20181115-hdac-586ae665-8bfb-4f35-9661-69193e5b9a63-withdrawal-exchange,2018.11.15 10:11,UNKNOWN,,UNKNOWN-55c0f2b7-dc24-425b-9be8-6b86719f2865,2018.11.15 10:11,UNKNOWN,0,100,0,HDAC,WITHDRAWAL,,,,0,COMPLETED,0,sum-user-id,1822140.7,airdrop-20181115-hdac-sum-user-id-withdrawal,accac570-de75-11e8-bd11-2f9252c4dc2f,AIRDROP,0
airdrop-20181115-hdac-58715006-09e9-4941-b060-52e2fa7ce362-withdrawal-exchange,2018.11.15 10:11,UNKNOWN,,UNKNOWN-55c0f2b7-dc24-425b-9be8-6b86719f2865,2018.11.15 10:11,UNKNOWN,0,100,0,HDAC,WITHDRAWAL,,,,0,COMPLETED,0,sum-user-id,1822040.7,airdrop-20181115-hdac-sum-user-id-withdrawal,accac570-de75-11e8-bd11-2f9252c4dc2f,AIRDROP,0
airdrop-20181115-hdac-587b9d9d-8e3e-447c-941d-d4c24135d027-withdrawal-exchange,2018.11.15 10:11,UNKNOWN,,UNKNOWN-55c0f2b7-dc24-425b-9be8-6b86719f2865,2018.11.15 10:11,UNKNOWN,0,100,0,HDAC,WITHDRAWAL,,,,0,COMPLETED,0,sum-user-id,1821940.7,airdrop-20181115-hdac-sum-user-id-withdrawal,accac570-de75-11e8-bd11-2f9252c4dc2f,AIRDROP,0
airdrop-20181115-hdac-588a6b6f-49ea-4ea6-b30b-e4c8702e5049-withdrawal-exchange,2018.11.15 10:11,UNKNOWN,,UNKNOWN-55c0f2b7-dc24-425b-9be8-6b86719f2865,2018.11.15 10:11,UNKNOWN,0,100,0,HDAC,WITHDRAWAL,,,,0,COMPLETED,0,sum-user-id,1821840.7,airdrop-20181115-hdac-sum-user-id-withdrawal,accac570-de75-11e8-bd11-2f9252c4dc2f,AIRDROP,0
airdrop-20181115-hdac-588ee25c-88a2-4622-88e7-0d1ff44efd07-withdrawal-exchange,2018.11.15 10:11,UNKNOWN,,UNKNOWN-55c0f2b7-dc24-425b-9be8-6b86719f2865,2018.11.15 10:11,UNKNOWN,0,100,0,HDAC,WITHDRAWAL,,,,0,COMPLETED,0,sum-user-id,1821740.7,airdrop-20181115-hdac-sum-user-id-withdrawal,accac570-de75-11e8-bd11-2f9252c4dc2f,AIRDROP,0
airdrop-20181115-hdac-58cf0c95-5a14-463f-90f9-2810327e6379-withdrawal-exchange,2018.11.15 10:11,UNKNOWN,,UNKNOWN-55c0f2b7-dc24-425b-9be8-6b86719f2865,2018.11.15 10:11,UNKNOWN,0,100,0,HDAC,WITHDRAWAL,,,,0,COMPLETED,0,sum-user-id,1821640.7,airdrop-20181115-hdac-sum-user-id-withdrawal,accac570-de75-11e8-bd11-2f9252c4dc2f,AIRDROP,0
airdrop-20181115-hdac-590513ec-3dd0-4fdb-a98b-a309cbd0618f-withdrawal-exchange,2018.11.15 10:12,UNKNOWN,,UNKNOWN-55c0f2b7-dc24-425b-9be8-6b86719f2865,2018.11.15 10:12,UNKNOWN,0,118.263383,0,HDAC,WITHDRAWAL,,,,0,COMPLETED,0,sum-user-id,1301371.341,airdrop-20181115-hdac-sum-user-id-withdrawal,accac570-de75-11e8-bd11-2f9252c4dc2f,AIRDROP,0
airdrop-20181115-hdac-5973d22d-dbbf-4b7f-a31c-f934eb476467-withdrawal-exchange,2018.11.15 10:11,UNKNOWN,,UNKNOWN-55c0f2b7-dc24-425b-9be8-6b86719f2865,2018.11.15 10:11,UNKNOWN,0,100,0,HDAC,WITHDRAWAL,,,,0,COMPLETED,0,sum-user-id,1821540.7,airdrop-20181115-hdac-sum-user-id-withdrawal,accac570-de75-11e8-bd11-2f9252c4dc2f,AIRDROP,0
airdrop-20181115-hdac-59745069-8305-4673-9aa4-9861ce525868-withdrawal-exchange,2018.11.15 10:11,UNKNOWN,,UNKNOWN-55c0f2b7-dc24-425b-9be8-6b86719f2865,2018.11.15 10:11,UNKNOWN,0,100,0,HDAC,WITHDRAWAL,,,,0,COMPLETED,0,sum-user-id,1821440.7,airdrop-20181115-hdac-sum-user-id-withdrawal,accac570-de75-11e8-bd11-2f9252c4dc2f,AIRDROP,0
airdrop-20181115-hdac-59c7bd22-f051-46d5-92e4-1aa1c281d32f-withdrawal-exchange,2018.11.15 10:11,UNKNOWN,,UNKNOWN-55c0f2b7-dc24-425b-9be8-6b86719f2865,2018.11.15 10:11,UNKNOWN,0,100,0,HDAC,WITHDRAWAL,,,,0,COMPLETED,0,sum-user-id,1821340.7,airdrop-20181115-hdac-sum-user-id-withdrawal,accac570-de75-11e8-bd11-2f9252c4dc2f,AIRDROP,0
airdrop-20181115-hdac-59ca2ce9-7e7f-4cd5-90d6-acc8ba57f00d-withdrawal-exchange,2018.11.15 10:11,UNKNOWN,,UNKNOWN-55c0f2b7-dc24-425b-9be8-6b86719f2865,2018.11.15 10:11,UNKNOWN,0,100,0,HDAC,WITHDRAWAL,,,,0,COMPLETED,0,sum-user-id,1821240.7,airdrop-20181115-hdac-sum-user-id-withdrawal,accac570-de75-11e8-bd11-2f9252c4dc2f,AIRDROP,0
airdrop-20181115-hdac-59e4cd0e-1993-49dc-8419-04e3810cbb47-withdrawal-exchange,2018.11.15 10:11,UNKNOWN,,UNKNOWN-55c0f2b7-dc24-425b-9be8-6b86719f2865,2018.11.15 10:11,UNKNOWN,0,100,0,HDAC,WITHDRAWAL,,,,0,COMPLETED,0,sum-user-id,1821140.7,airdrop-20181115-hdac-sum-user-id-withdrawal,accac570-de75-11e8-bd11-2f9252c4dc2f,AIRDROP,0
airdrop-20181115-hdac-5a2ee0d5-ce75-476b-ba58-12e91f610005-withdrawal-exchange,2018.11.15 10:11,UNKNOWN,,UNKNOWN-55c0f2b7-dc24-425b-9be8-6b86719f2865,2018.11.15 10:11,UNKNOWN,0,100,0,HDAC,WITHDRAWAL,,,,0,COMPLETED,0,sum-user-id,1821040.7,airdrop-20181115-hdac-sum-user-id-withdrawal,accac570-de75-11e8-bd11-2f9252c4dc2f,AIRDROP,0
airdrop-20181115-hdac-5a569178-6c8d-4e7a-b7aa-ef753c6a5ba8-withdrawal-exchange,2018.11.15 10:11,UNKNOWN,,UNKNOWN-55c0f2b7-dc24-425b-9be8-6b86719f2865,2018.11.15 10:11,UNKNOWN,0,100,0,HDAC,WITHDRAWAL,,,,0,COMPLETED,0,sum-user-id,1820940.7,airdrop-20181115-hdac-sum-user-id-withdrawal,accac570-de75-11e8-bd11-2f9252c4dc2f,AIRDROP,0
airdrop-20181115-hdac-5a5ee9d0-9d9f-47bf-a8ca-d1d5b9fbda89-withdrawal-exchange,2018.11.15 10:11,UNKNOWN,,UNKNOWN-55c0f2b7-dc24-425b-9be8-6b86719f2865,2018.11.15 10:11,UNKNOWN,0,100,0,HDAC,WITHDRAWAL,,,,0,COMPLETED,0,sum-user-id,1820840.7,airdrop-20181115-hdac-sum-user-id-withdrawal,accac570-de75-11e8-bd11-2f9252c4dc2f,AIRDROP,0
airdrop-20181115-hdac-5a668712-29a8-45fb-85fb-5bed4a2545d8-withdrawal-exchange,2018.11.15 10:11,UNKNOWN,,UNKNOWN-55c0f2b7-dc24-425b-9be8-6b86719f2865,2018.11.15 10:11,UNKNOWN,0,100,0,HDAC,WITHDRAWAL,,,,0,COMPLETED,0,sum-user-id,1820740.7,airdrop-20181115-hdac-sum-user-id-withdrawal,accac570-de75-11e8-bd11-2f9252c4dc2f,AIRDROP,0
airdrop-20181115-hdac-5a7ebd0e-e2dd-4829-9891-08ae1cab0882-withdrawal-exchange,2018.11.15 10:11,UNKNOWN,,UNKNOWN-55c0f2b7-dc24-425b-9be8-6b86719f2865,2018.11.15 10:11,UNKNOWN,0,100,0,HDAC,WITHDRAWAL,,,,0,COMPLETED,0,sum-user-id,1820640.7,airdrop-20181115-hdac-sum-user-id-withdrawal,accac570-de75-11e8-bd11-2f9252c4dc2f,AIRDROP,0
airdrop-20181115-hdac-5abec2c1-9103-4026-aaa7-9cbca4460c9b-withdrawal-exchange,2018.11.15 10:11,UNKNOWN,,UNKNOWN-55c0f2b7-dc24-425b-9be8-6b86719f2865,2018.11.15 10:11,UNKNOWN,0,100,0,HDAC,WITHDRAWAL,,,,0,COMPLETED,0,sum-user-id,1820540.7,airdrop-20181115-hdac-sum-user-id-withdrawal,accac570-de75-11e8-bd11-2f9252c4dc2f,AIRDROP,0
airdrop-20181115-hdac-5ac8165d-920d-4214-9374-237a7c0336ee-withdrawal-exchange,2018.11.15 10:11,UNKNOWN,,UNKNOWN-55c0f2b7-dc24-425b-9be8-6b86719f2865,2018.11.15 10:11,UNKNOWN,0,100,0,HDAC,WITHDRAWAL,,,,0,COMPLETED,0,sum-user-id,1820440.7,airdrop-20181115-hdac-sum-user-id-withdrawal,accac570-de75-11e8-bd11-2f9252c4dc2f,AIRDROP,0
airdrop-20181115-hdac-5adfcc74-b5bd-4a62-ba6f-c83a5bb57ee9-withdrawal-exchange,2018.11.15 10:11,UNKNOWN,,UNKNOWN-55c0f2b7-dc24-425b-9be8-6b86719f2865,2018.11.15 10:11,UNKNOWN,0,100,0,HDAC,WITHDRAWAL,,,,0,COMPLETED,0,sum-user-id,1820340.7,airdrop-20181115-hdac-sum-user-id-withdrawal,accac570-de75-11e8-bd11-2f9252c4dc2f,AIRDROP,0
airdrop-20181115-hdac-5b048560-53b8-4eb3-bf39-6f840d04ab01-withdrawal-exchange,2018.11.15 10:11,UNKNOWN,,UNKNOWN-55c0f2b7-dc24-425b-9be8-6b86719f2865,2018.11.15 10:11,UNKNOWN,0,100,0,HDAC,WITHDRAWAL,,,,0,COMPLETED,0,sum-user-id,1820240.7,airdrop-20181115-hdac-sum-user-id-withdrawal,accac570-de75-11e8-bd11-2f9252c4dc2f,AIRDROP,0
airdrop-20181115-hdac-5b1d544f-81f4-4c91-8fb9-0bf426fcf9ff-withdrawal-exchange,2018.11.15 10:11,UNKNOWN,,UNKNOWN-55c0f2b7-dc24-425b-9be8-6b86719f2865,2018.11.15 10:11,UNKNOWN,0,100,0,HDAC,WITHDRAWAL,,,,0,COMPLETED,0,sum-user-id,1820140.7,airdrop-20181115-hdac-sum-user-id-withdrawal,accac570-de75-11e8-bd11-2f9252c4dc2f,AIRDROP,0
airdrop-20181115-hdac-5b20df98-b586-4671-af9a-5e57eba004bf-withdrawal-exchange,2018.11.15 10:11,UNKNOWN,,UNKNOWN-55c0f2b7-dc24-425b-9be8-6b86719f2865,2018.11.15 10:11,UNKNOWN,0,100,0,HDAC,WITHDRAWAL,,,,0,COMPLETED,0,sum-user-id,1820040.7,airdrop-20181115-hdac-sum-user-id-withdrawal,accac570-de75-11e8-bd11-2f9252c4dc2f,AIRDROP,0
airdrop-20181115-hdac-5b236456-e6d3-461c-af18-ddd099ffa0eb-withdrawal-exchange,2018.11.15 10:11,UNKNOWN,,UNKNOWN-55c0f2b7-dc24-425b-9be8-6b86719f2865,2018.11.15 10:11,UNKNOWN,0,100,0,HDAC,WITHDRAWAL,,,,0,COMPLETED,0,sum-user-id,1819940.7,airdrop-20181115-hdac-sum-user-id-withdrawal,accac570-de75-11e8-bd11-2f9252c4dc2f,AIRDROP,0
airdrop-20181115-hdac-5b5c4296-c651-4bad-a1b4-b6aff905a84f-withdrawal-exchange,2018-11-15 10:11:35.025,UNKNOWN,,UNKNOWN-55c0f2b7-dc24-425b-9be8-6b86719f2865,2018-11-15 10:11:35.025,UNKNOWN,0,100,0,HDAC,WITHDRAWAL,,,,0,COMPLETED,0,sum-user-id,1819840.7,airdrop-20181115-hdac-sum-user-id-withdrawal,accac570-de75-11e8-bd11-2f9252c4dc2f,AIRDROP,0
airdrop-20181115-hdac-5bb5d027-6fc1-495e-b12c-45aba2bb00ea-withdrawal-exchange,2018-11-15 10:11:35.060,UNKNOWN,,UNKNOWN-55c0f2b7-dc24-425b-9be8-6b86719f2865,2018-11-15 10:11:35.060,UNKNOWN,0,100,0,HDAC,WITHDRAWAL,,,,0,COMPLETED,0,sum-user-id,1819740.7,airdrop-20181115-hdac-sum-user-id-withdrawal,accac570-de75-11e8-bd11-2f9252c4dc2f,AIRDROP,0
airdrop-20181115-hdac-5bbe0eb3-1f2d-4bb6-954c-81caae022a17-withdrawal-exchange,2018-11-15 10:11:35.092,UNKNOWN,,UNKNOWN-55c0f2b7-dc24-425b-9be8-6b86719f2865,2018-11-15 10:11:35.092,UNKNOWN,0,100,0,HDAC,WITHDRAWAL,,,,0,COMPLETED,0,sum-user-id,1819640.7,airdrop-20181115-hdac-sum-user-id-withdrawal,accac570-de75-11e8-bd11-2f9252c4dc2f,AIRDROP,0
airdrop-20181115-hdac-5bcd85f9-5770-4842-bd03-76c8246fb1eb-withdrawal-exchange,2018.11.15 10:11,UNKNOWN,,UNKNOWN-55c0f2b7-dc24-425b-9be8-6b86719f2865,2018.11.15 10:11,UNKNOWN,0,100,0,HDAC,WITHDRAWAL,,,,0,COMPLETED,0,sum-user-id,1819540.7,airdrop-20181115-hdac-sum-user-id-withdrawal,accac570-de75-11e8-bd11-2f9252c4dc2f,AIRDROP,0
airdrop-20181115-hdac-5bd37579-c9e1-4b92-9af2-c581128582d1-withdrawal-exchange,2018.11.15 10:11,UNKNOWN,,UNKNOWN-55c0f2b7-dc24-425b-9be8-6b86719f2865,2018.11.15 10:11,UNKNOWN,0,100,0,HDAC,WITHDRAWAL,,,,0,COMPLETED,0,sum-user-id,1819440.7,airdrop-20181115-hdac-sum-user-id-withdrawal,accac570-de75-11e8-bd11-2f9252c4dc2f,AIRDROP,0
airdrop-20181115-hdac-5be4daf8-4d6e-47c4-9fb4-89975472489e-withdrawal-exchange,2018.11.15 10:11,UNKNOWN,,UNKNOWN-55c0f2b7-dc24-425b-9be8-6b86719f2865,2018.11.15 10:11,UNKNOWN,0,100,0,HDAC,WITHDRAWAL,,,,0,COMPLETED,0,sum-user-id,1819340.7,airdrop-20181115-hdac-sum-user-id-withdrawal,accac570-de75-11e8-bd11-2f9252c4dc2f,AIRDROP,0
airdrop-20181115-hdac-5be76871-5b94-441c-b74b-9fbed8699424-withdrawal-exchange,2018.11.15 10:11,UNKNOWN,,UNKNOWN-55c0f2b7-dc24-425b-9be8-6b86719f2865,2018.11.15 10:11,UNKNOWN,0,100,0,HDAC,WITHDRAWAL,,,,0,COMPLETED,0,sum-user-id,1819240.7,airdrop-20181115-hdac-sum-user-id-withdrawal,accac570-de75-11e8-bd11-2f9252c4dc2f,AIRDROP,0
airdrop-20181115-hdac-5bec478a-96c5-4b17-bfd8-439d02bc63f5-withdrawal-exchange,2018.11.15 10:11,UNKNOWN,,UNKNOWN-55c0f2b7-dc24-425b-9be8-6b86719f2865,2018.11.15 10:11,UNKNOWN,0,100,0,HDAC,WITHDRAWAL,,,,0,COMPLETED,0,sum-user-id,1819140.7,airdrop-20181115-hdac-sum-user-id-withdrawal,accac570-de75-11e8-bd11-2f9252c4dc2f,AIRDROP,0
airdrop-20181115-hdac-5bec5957-dc0a-44eb-a9ef-bffed69f8928-withdrawal-exchange,2018.11.15 10:11,UNKNOWN,,UNKNOWN-55c0f2b7-dc24-425b-9be8-6b86719f2865,2018.11.15 10:11,UNKNOWN,0,100,0,HDAC,WITHDRAWAL,,,,0,COMPLETED,0,sum-user-id,1819040.7,airdrop-20181115-hdac-sum-user-id-withdrawal,accac570-de75-11e8-bd11-2f9252c4dc2f,AIRDROP,0
airdrop-20181115-hdac-5bf63a9a-71eb-4487-8e1a-4c333f7460cc-withdrawal-exchange,2018.11.15 10:11,UNKNOWN,,UNKNOWN-55c0f2b7-dc24-425b-9be8-6b86719f2865,2018.11.15 10:11,UNKNOWN,0,100,0,HDAC,WITHDRAWAL,,,,0,COMPLETED,0,sum-user-id,1818940.7,airdrop-20181115-hdac-sum-user-id-withdrawal,accac570-de75-11e8-bd11-2f9252c4dc2f,AIRDROP,0
airdrop-20181115-hdac-5bf7fb5c-2408-4ad5-af04-bc0a563c7421-withdrawal-exchange,2018.11.15 10:11,UNKNOWN,,UNKNOWN-55c0f2b7-dc24-425b-9be8-6b86719f2865,2018.11.15 10:11,UNKNOWN,0,100,0,HDAC,WITHDRAWAL,,,,0,COMPLETED,0,sum-user-id,1818840.7,airdrop-20181115-hdac-sum-user-id-withdrawal,accac570-de75-11e8-bd11-2f9252c4dc2f,AIRDROP,0
airdrop-20181115-hdac-5c0b5a9e-8a29-433b-a86c-17cdfd2840c0-withdrawal-exchange,2018.11.15 10:11,UNKNOWN,,UNKNOWN-55c0f2b7-dc24-425b-9be8-6b86719f2865,2018.11.15 10:11,UNKNOWN,0,100,0,HDAC,WITHDRAWAL,,,,0,COMPLETED,0,sum-user-id,1818740.7,airdrop-20181115-hdac-sum-user-id-withdrawal,accac570-de75-11e8-bd11-2f9252c4dc2f,AIRDROP,0
airdrop-20181115-hdac-5c3b2f7b-20ee-4deb-ad9a-0ff11ca112cb-withdrawal-exchange,2018.11.15 10:11,UNKNOWN,,UNKNOWN-55c0f2b7-dc24-425b-9be8-6b86719f2865,2018.11.15 10:11,UNKNOWN,0,100,0,HDAC,WITHDRAWAL,,,,0,COMPLETED,0,sum-user-id,1818640.7,airdrop-20181115-hdac-sum-user-id-withdrawal,accac570-de75-11e8-bd11-2f9252c4dc2f,AIRDROP,0
airdrop-20181115-hdac-5c5ae739-0907-4ce2-bcc6-6600f7ad71a4-withdrawal-exchange,2018.11.15 10:11,UNKNOWN,,UNKNOWN-55c0f2b7-dc24-425b-9be8-6b86719f2865,2018.11.15 10:11,UNKNOWN,0,100,0,HDAC,WITHDRAWAL,,,,0,COMPLETED,0,sum-user-id,1818540.7,airdrop-20181115-hdac-sum-user-id-withdrawal,accac570-de75-11e8-bd11-2f9252c4dc2f,AIRDROP,0
airdrop-20181115-hdac-5c68fdac-0e5e-4eea-b847-7bc4839ef94e-withdrawal-exchange,2018.11.15 10:11,UNKNOWN,,UNKNOWN-55c0f2b7-dc24-425b-9be8-6b86719f2865,2018.11.15 10:11,UNKNOWN,0,100,0,HDAC,WITHDRAWAL,,,,0,COMPLETED,0,sum-user-id,1818440.7,airdrop-20181115-hdac-sum-user-id-withdrawal,accac570-de75-11e8-bd11-2f9252c4dc2f,AIRDROP,0
airdrop-20181115-hdac-5c6b7c0a-54ff-4e49-9555-3e742e0f30f0-withdrawal-exchange,2018.11.15 10:11,UNKNOWN,,UNKNOWN-55c0f2b7-dc24-425b-9be8-6b86719f2865,2018.11.15 10:11,UNKNOWN,0,100,0,HDAC,WITHDRAWAL,,,,0,COMPLETED,0,sum-user-id,1818340.7,airdrop-20181115-hdac-sum-user-id-withdrawal,accac570-de75-11e8-bd11-2f9252c4dc2f,AIRDROP,0
airdrop-20181115-hdac-5c731597-2f00-4c17-9818-756cb4654412-withdrawal-exchange,2018.11.15 10:11,UNKNOWN,,UNKNOWN-55c0f2b7-dc24-425b-9be8-6b86719f2865,2018.11.15 10:11,UNKNOWN,0,100,0,HDAC,WITHDRAWAL,,,,0,COMPLETED,0,sum-user-id,1818240.7,airdrop-20181115-hdac-sum-user-id-withdrawal,accac570-de75-11e8-bd11-2f9252c4dc2f,AIRDROP,0
airdrop-20181115-hdac-5c770f4a-a26a-4f83-965e-a27fc2f7ac76-withdrawal-exchange,2018.11.15 10:11,UNKNOWN,,UNKNOWN-55c0f2b7-dc24-425b-9be8-6b86719f2865,2018.11.15 10:11,UNKNOWN,0,100,0,HDAC,WITHDRAWAL,,,,0,COMPLETED,0,sum-user-id,1818140.7,airdrop-20181115-hdac-sum-user-id-withdrawal,accac570-de75-11e8-bd11-2f9252c4dc2f,AIRDROP,0
airdrop-20181115-hdac-5c8c8b60-5bf9-4db1-8a2f-727d054c9bb4-withdrawal-exchange,2018.11.15 10:11,UNKNOWN,,UNKNOWN-55c0f2b7-dc24-425b-9be8-6b86719f2865,2018.11.15 10:11,UNKNOWN,0,100,0,HDAC,WITHDRAWAL,,,,0,COMPLETED,0,sum-user-id,1818040.7,airdrop-20181115-hdac-sum-user-id-withdrawal,accac570-de75-11e8-bd11-2f9252c4dc2f,AIRDROP,0
airdrop-20181115-hdac-5cb1dbe9-3716-435c-a93e-64f6dc0acafe-withdrawal-exchange,2018.11.15 10:11,UNKNOWN,,UNKNOWN-55c0f2b7-dc24-425b-9be8-6b86719f2865,2018.11.15 10:11,UNKNOWN,0,100,0,HDAC,WITHDRAWAL,,,,0,COMPLETED,0,sum-user-id,1817940.7,airdrop-20181115-hdac-sum-user-id-withdrawal,accac570-de75-11e8-bd11-2f9252c4dc2f,AIRDROP,0
airdrop-20181115-hdac-5cd09182-9f85-4b1e-9b4a-4abbbf0920db-withdrawal-exchange,2018.11.15 10:11,UNKNOWN,,UNKNOWN-55c0f2b7-dc24-425b-9be8-6b86719f2865,2018.11.15 10:11,UNKNOWN,0,100,0,HDAC,WITHDRAWAL,,,,0,COMPLETED,0,sum-user-id,1817840.7,airdrop-20181115-hdac-sum-user-id-withdrawal,accac570-de75-11e8-bd11-2f9252c4dc2f,AIRDROP,0
airdrop-20181115-hdac-5cd0af87-81e0-4125-9c2f-4f3a4e829591-withdrawal-exchange,2018.11.15 10:11,UNKNOWN,,UNKNOWN-55c0f2b7-dc24-425b-9be8-6b86719f2865,2018.11.15 10:11,UNKNOWN,0,100,0,HDAC,WITHDRAWAL,,,,0,COMPLETED,0,sum-user-id,1817740.7,airdrop-20181115-hdac-sum-user-id-withdrawal,accac570-de75-11e8-bd11-2f9252c4dc2f,AIRDROP,0
airdrop-20181115-hdac-5cd5bb98-ccd1-4524-83e7-b2a94bd306d5-withdrawal-exchange,2018.11.15 10:11,UNKNOWN,,UNKNOWN-55c0f2b7-dc24-425b-9be8-6b86719f2865,2018.11.15 10:11,UNKNOWN,0,100,0,HDAC,WITHDRAWAL,,,,0,COMPLETED,0,sum-user-id,1817640.7,airdrop-20181115-hdac-sum-user-id-withdrawal,accac570-de75-11e8-bd11-2f9252c4dc2f,AIRDROP,0
airdrop-20181115-hdac-5ce556c0-18d7-4be8-ad83-b54215d5349f-withdrawal-exchange,2018.11.15 10:11,UNKNOWN,,UNKNOWN-55c0f2b7-dc24-425b-9be8-6b86719f2865,2018.11.15 10:11,UNKNOWN,0,100,0,HDAC,WITHDRAWAL,,,,0,COMPLETED,0,sum-user-id,1817540.7,airdrop-20181115-hdac-sum-user-id-withdrawal,accac570-de75-11e8-bd11-2f9252c4dc2f,AIRDROP,0
airdrop-20181115-hdac-5cf0f56c-2179-4fb1-b8dd-524fe76a3668-withdrawal-exchange,2018.11.15 10:11,UNKNOWN,,UNKNOWN-55c0f2b7-dc24-425b-9be8-6b86719f2865,2018.11.15 10:11,UNKNOWN,0,100,0,HDAC,WITHDRAWAL,,,,0,COMPLETED,0,sum-user-id,1817440.7,airdrop-20181115-hdac-sum-user-id-withdrawal,accac570-de75-11e8-bd11-2f9252c4dc2f,AIRDROP,0
airdrop-20181115-hdac-5cf327d0-0358-4161-bda4-c46f86867b1b-withdrawal-exchange,2018.11.15 10:11,UNKNOWN,,UNKNOWN-55c0f2b7-dc24-425b-9be8-6b86719f2865,2018.11.15 10:11,UNKNOWN,0,100,0,HDAC,WITHDRAWAL,,,,0,COMPLETED,0,sum-user-id,1817340.7,airdrop-20181115-hdac-sum-user-id-withdrawal,accac570-de75-11e8-bd11-2f9252c4dc2f,AIRDROP,0
airdrop-20181115-hdac-5d05a921-600c-4d67-b345-edff4ddc21df-withdrawal-exchange,2018.11.15 10:12,UNKNOWN,,UNKNOWN-55c0f2b7-dc24-425b-9be8-6b86719f2865,2018.11.15 10:12,UNKNOWN,0,160.207216,0,HDAC,WITHDRAWAL,,,,0,COMPLETED,0,sum-user-id,1301211.133,airdrop-20181115-hdac-sum-user-id-withdrawal,accac570-de75-11e8-bd11-2f9252c4dc2f,AIRDROP,0
airdrop-20181115-hdac-5d1599c3-e64c-4467-aef5-3a83113a0cdf-withdrawal-exchange,2018.11.15 10:11,UNKNOWN,,UNKNOWN-55c0f2b7-dc24-425b-9be8-6b86719f2865,2018.11.15 10:11,UNKNOWN,0,100,0,HDAC,WITHDRAWAL,,,,0,COMPLETED,0,sum-user-id,1817240.7,airdrop-20181115-hdac-sum-user-id-withdrawal,accac570-de75-11e8-bd11-2f9252c4dc2f,AIRDROP,0
airdrop-20181115-hdac-5d648ae0-3436-4f36-bc24-ffcd702dc5a6-withdrawal-exchange,2018.11.15 10:11,UNKNOWN,,UNKNOWN-55c0f2b7-dc24-425b-9be8-6b86719f2865,2018.11.15 10:11,UNKNOWN,0,100,0,HDAC,WITHDRAWAL,,,,0,COMPLETED,0,sum-user-id,1817140.7,airdrop-20181115-hdac-sum-user-id-withdrawal,accac570-de75-11e8-bd11-2f9252c4dc2f,AIRDROP,0
airdrop-20181115-hdac-5d8c1ee1-3075-4f78-a0ef-05d996a4df7e-withdrawal-exchange,2018.11.15 10:11,UNKNOWN,,UNKNOWN-55c0f2b7-dc24-425b-9be8-6b86719f2865,2018.11.15 10:11,UNKNOWN,0,100,0,HDAC,WITHDRAWAL,,,,0,COMPLETED,0,sum-user-id,1817040.7,airdrop-20181115-hdac-sum-user-id-withdrawal,accac570-de75-11e8-bd11-2f9252c4dc2f,AIRDROP,0
airdrop-20181115-hdac-5dcbfdf8-13bc-4b83-a0d6-29aa80e54630-withdrawal-exchange,2018.11.15 10:11,UNKNOWN,,UNKNOWN-55c0f2b7-dc24-425b-9be8-6b86719f2865,2018.11.15 10:11,UNKNOWN,0,100,0,HDAC,WITHDRAWAL,,,,0,COMPLETED,0,sum-user-id,1816940.7,airdrop-20181115-hdac-sum-user-id-withdrawal,accac570-de75-11e8-bd11-2f9252c4dc2f,AIRDROP,0
airdrop-20181115-hdac-5e0358ef-b148-4a9b-8fe2-6f5ff7e3e53b-withdrawal-exchange,2018-11-15 10:11:36.022,UNKNOWN,,UNKNOWN-55c0f2b7-dc24-425b-9be8-6b86719f2865,2018-11-15 10:11:36.022,UNKNOWN,0,100,0,HDAC,WITHDRAWAL,,,,0,COMPLETED,0,sum-user-id,1816840.7,airdrop-20181115-hdac-sum-user-id-withdrawal,accac570-de75-11e8-bd11-2f9252c4dc2f,AIRDROP,0
airdrop-20181115-hdac-5e206267-0d2e-4cbc-bd40-2c0c0010a6d6-withdrawal-exchange,2018-11-15 10:11:36.050,UNKNOWN,,UNKNOWN-55c0f2b7-dc24-425b-9be8-6b86719f2865,2018-11-15 10:11:36.050,UNKNOWN,0,100,0,HDAC,WITHDRAWAL,,,,0,COMPLETED,0,sum-user-id,1816740.7,airdrop-20181115-hdac-sum-user-id-withdrawal,accac570-de75-11e8-bd11-2f9252c4dc2f,AIRDROP,0
airdrop-20181115-hdac-5e20e001-be14-4507-baa7-572372eeeee2-withdrawal-exchange,2018-11-15 10:11:36.082,UNKNOWN,,UNKNOWN-55c0f2b7-dc24-425b-9be8-6b86719f2865,2018-11-15 10:11:36.082,UNKNOWN,0,100,0,HDAC,WITHDRAWAL,,,,0,COMPLETED,0,sum-user-id,1816640.7,airdrop-20181115-hdac-sum-user-id-withdrawal,accac570-de75-11e8-bd11-2f9252c4dc2f,AIRDROP,0
airdrop-20181115-hdac-5e2d6b2d-e497-4582-b3ed-b22735a9909c-withdrawal-exchange,2018.11.15 10:11,UNKNOWN,,UNKNOWN-55c0f2b7-dc24-425b-9be8-6b86719f2865,2018.11.15 10:11,UNKNOWN,0,100,0,HDAC,WITHDRAWAL,,,,0,COMPLETED,0,sum-user-id,1816540.7,airdrop-20181115-hdac-sum-user-id-withdrawal,accac570-de75-11e8-bd11-2f9252c4dc2f,AIRDROP,0
airdrop-20181115-hdac-5e33860f-c057-4a27-a5f1-e62e3946979a-withdrawal-exchange,2018.11.15 10:11,UNKNOWN,,UNKNOWN-55c0f2b7-dc24-425b-9be8-6b86719f2865,2018.11.15 10:11,UNKNOWN,0,100,0,HDAC,WITHDRAWAL,,,,0,COMPLETED,0,sum-user-id,1816440.7,airdrop-20181115-hdac-sum-user-id-withdrawal,accac570-de75-11e8-bd11-2f9252c4dc2f,AIRDROP,0
airdrop-20181115-hdac-5e4a706d-ef91-48e6-876e-992d9fe0a500-withdrawal-exchange,2018.11.15 10:11,UNKNOWN,,UNKNOWN-55c0f2b7-dc24-425b-9be8-6b86719f2865,2018.11.15 10:11,UNKNOWN,0,100,0,HDAC,WITHDRAWAL,,,,0,COMPLETED,0,sum-user-id,1816340.7,airdrop-20181115-hdac-sum-user-id-withdrawal,accac570-de75-11e8-bd11-2f9252c4dc2f,AIRDROP,0
airdrop-20181115-hdac-5e6e7673-ca75-4334-83db-cd31371fec88-withdrawal-exchange,2018.11.15 10:11,UNKNOWN,,UNKNOWN-55c0f2b7-dc24-425b-9be8-6b86719f2865,2018.11.15 10:11,UNKNOWN,0,100,0,HDAC,WITHDRAWAL,,,,0,COMPLETED,0,sum-user-id,1816240.7,airdrop-20181115-hdac-sum-user-id-withdrawal,accac570-de75-11e8-bd11-2f9252c4dc2f,AIRDROP,0
airdrop-20181115-hdac-5e6fc39c-6f97-4cc3-aa99-9f65b4407775-withdrawal-exchange,2018.11.15 10:12,UNKNOWN,,UNKNOWN-55c0f2b7-dc24-425b-9be8-6b86719f2865,2018.11.15 10:12,UNKNOWN,0,3104.661784,0,HDAC,WITHDRAWAL,,,,0,COMPLETED,0,sum-user-id,1298106.472,airdrop-20181115-hdac-sum-user-id-withdrawal,accac570-de75-11e8-bd11-2f9252c4dc2f,AIRDROP,0
airdrop-20181115-hdac-5e7bedd3-fc67-42d7-a4b1-df6ba5e3b4e5-withdrawal-exchange,2018.11.15 10:11,UNKNOWN,,UNKNOWN-55c0f2b7-dc24-425b-9be8-6b86719f2865,2018.11.15 10:11,UNKNOWN,0,100,0,HDAC,WITHDRAWAL,,,,0,COMPLETED,0,sum-user-id,1816140.7,airdrop-20181115-hdac-sum-user-id-withdrawal,accac570-de75-11e8-bd11-2f9252c4dc2f,AIRDROP,0
airdrop-20181115-hdac-5e8bb534-13dc-403e-9d13-cd602514a7ae-withdrawal-exchange,2018.11.15 10:11,UNKNOWN,,UNKNOWN-55c0f2b7-dc24-425b-9be8-6b86719f2865,2018.11.15 10:11,UNKNOWN,0,100,0,HDAC,WITHDRAWAL,,,,0,COMPLETED,0,sum-user-id,1816040.7,airdrop-20181115-hdac-sum-user-id-withdrawal,accac570-de75-11e8-bd11-2f9252c4dc2f,AIRDROP,0
airdrop-20181115-hdac-5e948171-781e-4338-82cb-fe1d04330cb4-withdrawal-exchange,2018.11.15 10:11,UNKNOWN,,UNKNOWN-55c0f2b7-dc24-425b-9be8-6b86719f2865,2018.11.15 10:11,UNKNOWN,0,100,0,HDAC,WITHDRAWAL,,,,0,COMPLETED,0,sum-user-id,1815940.7,airdrop-20181115-hdac-sum-user-id-withdrawal,accac570-de75-11e8-bd11-2f9252c4dc2f,AIRDROP,0
airdrop-20181115-hdac-5ed64020-bae4-41f2-be8b-17d29c529376-withdrawal-exchange,2018.11.15 10:11,UNKNOWN,,UNKNOWN-55c0f2b7-dc24-425b-9be8-6b86719f2865,2018.11.15 10:11,UNKNOWN,0,100,0,HDAC,WITHDRAWAL,,,,0,COMPLETED,0,sum-user-id,1815840.7,airdrop-20181115-hdac-sum-user-id-withdrawal,accac570-de75-11e8-bd11-2f9252c4dc2f,AIRDROP,0
airdrop-20181115-hdac-5eee8235-67bf-4b5f-a8bc-af37e7081928-withdrawal-exchange,2018.11.15 10:11,UNKNOWN,,UNKNOWN-55c0f2b7-dc24-425b-9be8-6b86719f2865,2018.11.15 10:11,UNKNOWN,0,100,0,HDAC,WITHDRAWAL,,,,0,COMPLETED,0,sum-user-id,1815740.7,airdrop-20181115-hdac-sum-user-id-withdrawal,accac570-de75-11e8-bd11-2f9252c4dc2f,AIRDROP,0
airdrop-20181115-hdac-5f22fc01-2528-4106-8d4a-17330d6f055b-withdrawal-exchange,2018.11.15 10:11,UNKNOWN,,UNKNOWN-55c0f2b7-dc24-425b-9be8-6b86719f2865,2018.11.15 10:11,UNKNOWN,0,100,0,HDAC,WITHDRAWAL,,,,0,COMPLETED,0,sum-user-id,1815640.7,airdrop-20181115-hdac-sum-user-id-withdrawal,accac570-de75-11e8-bd11-2f9252c4dc2f,AIRDROP,0
airdrop-20181115-hdac-5f25b560-46c1-4007-bad0-1aa0b2833384-withdrawal-exchange,2018.11.15 10:11,UNKNOWN,,UNKNOWN-55c0f2b7-dc24-425b-9be8-6b86719f2865,2018.11.15 10:11,UNKNOWN,0,87849.83524,0,HDAC,WITHDRAWAL,,,,0,COMPLETED,0,sum-user-id,1727790.865,airdrop-20181115-hdac-sum-user-id-withdrawal,accac570-de75-11e8-bd11-2f9252c4dc2f,AIRDROP,0
airdrop-20181115-hdac-5f3e656f-16ec-4641-b81b-058cd0ea7c92-withdrawal-exchange,2018.11.15 10:11,UNKNOWN,,UNKNOWN-55c0f2b7-dc24-425b-9be8-6b86719f2865,2018.11.15 10:11,UNKNOWN,0,100,0,HDAC,WITHDRAWAL,,,,0,COMPLETED,0,sum-user-id,1727690.865,airdrop-20181115-hdac-sum-user-id-withdrawal,accac570-de75-11e8-bd11-2f9252c4dc2f,AIRDROP,0
airdrop-20181115-hdac-5f96688b-bf65-45a0-bbc2-9ccbcf44b68a-withdrawal-exchange,2018.11.15 10:11,UNKNOWN,,UNKNOWN-55c0f2b7-dc24-425b-9be8-6b86719f2865,2018.11.15 10:11,UNKNOWN,0,100,0,HDAC,WITHDRAWAL,,,,0,COMPLETED,0,sum-user-id,1727590.865,airdrop-20181115-hdac-sum-user-id-withdrawal,accac570-de75-11e8-bd11-2f9252c4dc2f,AIRDROP,0
airdrop-20181115-hdac-5faea405-1c5b-468b-bfb1-6d72638277e6-withdrawal-exchange,2018.11.15 10:11,UNKNOWN,,UNKNOWN-55c0f2b7-dc24-425b-9be8-6b86719f2865,2018.11.15 10:11,UNKNOWN,0,100,0,HDAC,WITHDRAWAL,,,,0,COMPLETED,0,sum-user-id,1727490.865,airdrop-20181115-hdac-sum-user-id-withdrawal,accac570-de75-11e8-bd11-2f9252c4dc2f,AIRDROP,0
airdrop-20181115-hdac-5fb111c0-a86e-4e98-9fe1-125ceab7bd04-withdrawal-exchange,2018.11.15 10:11,UNKNOWN,,UNKNOWN-55c0f2b7-dc24-425b-9be8-6b86719f2865,2018.11.15 10:11,UNKNOWN,0,100,0,HDAC,WITHDRAWAL,,,,0,COMPLETED,0,sum-user-id,1727390.865,airdrop-20181115-hdac-sum-user-id-withdrawal,accac570-de75-11e8-bd11-2f9252c4dc2f,AIRDROP,0
airdrop-20181115-hdac-5fb1c369-348f-4b04-a3bf-240e69d6d9ca-withdrawal-exchange,2018.11.15 10:11,UNKNOWN,,UNKNOWN-55c0f2b7-dc24-425b-9be8-6b86719f2865,2018.11.15 10:11,UNKNOWN,0,100,0,HDAC,WITHDRAWAL,,,,0,COMPLETED,0,sum-user-id,1727290.865,airdrop-20181115-hdac-sum-user-id-withdrawal,accac570-de75-11e8-bd11-2f9252c4dc2f,AIRDROP,0
airdrop-20181115-hdac-5fe5731e-f112-44c5-91a3-9e53c9e5c056-withdrawal-exchange,2018.11.15 10:11,UNKNOWN,,UNKNOWN-55c0f2b7-dc24-425b-9be8-6b86719f2865,2018.11.15 10:11,UNKNOWN,0,100,0,HDAC,WITHDRAWAL,,,,0,COMPLETED,0,sum-user-id,1727190.865,airdrop-20181115-hdac-sum-user-id-withdrawal,accac570-de75-11e8-bd11-2f9252c4dc2f,AIRDROP,0
airdrop-20181115-hdac-606e00f3-fb4b-4f2e-a416-d20c1c301fc4-withdrawal-exchange,2018.11.15 10:11,UNKNOWN,,UNKNOWN-55c0f2b7-dc24-425b-9be8-6b86719f2865,2018.11.15 10:11,UNKNOWN,0,100,0,HDAC,WITHDRAWAL,,,,0,COMPLETED,0,sum-user-id,1727090.865,airdrop-20181115-hdac-sum-user-id-withdrawal,accac570-de75-11e8-bd11-2f9252c4dc2f,AIRDROP,0
airdrop-20181115-hdac-6086e3b0-2a37-4875-8f28-f057a280be8c-withdrawal-exchange,2018.11.15 10:11,UNKNOWN,,UNKNOWN-55c0f2b7-dc24-425b-9be8-6b86719f2865,2018.11.15 10:11,UNKNOWN,0,100,0,HDAC,WITHDRAWAL,,,,0,COMPLETED,0,sum-user-id,1726990.865,airdrop-20181115-hdac-sum-user-id-withdrawal,accac570-de75-11e8-bd11-2f9252c4dc2f,AIRDROP,0
airdrop-20181115-hdac-60875d8c-417e-4d70-a24b-f46ee502f6a5-withdrawal-exchange,2018.11.15 10:11,UNKNOWN,,UNKNOWN-55c0f2b7-dc24-425b-9be8-6b86719f2865,2018.11.15 10:11,UNKNOWN,0,100,0,HDAC,WITHDRAWAL,,,,0,COMPLETED,0,sum-user-id,1726890.865,airdrop-20181115-hdac-sum-user-id-withdrawal,accac570-de75-11e8-bd11-2f9252c4dc2f,AIRDROP,0
airdrop-20181115-hdac-6094b2d3-ffaa-4217-9478-17e39dff63a0-withdrawal-exchange,2018.11.15 10:11,UNKNOWN,,UNKNOWN-55c0f2b7-dc24-425b-9be8-6b86719f2865,2018.11.15 10:11,UNKNOWN,0,100,0,HDAC,WITHDRAWAL,,,,0,COMPLETED,0,sum-user-id,1726790.865,airdrop-20181115-hdac-sum-user-id-withdrawal,accac570-de75-11e8-bd11-2f9252c4dc2f,AIRDROP,0
airdrop-20181115-hdac-60a82801-fe7d-41f6-88f8-fe51f8e2b89e-withdrawal-exchange,2018.11.15 10:11,UNKNOWN,,UNKNOWN-55c0f2b7-dc24-425b-9be8-6b86719f2865,2018.11.15 10:11,UNKNOWN,0,100,0,HDAC,WITHDRAWAL,,,,0,COMPLETED,0,sum-user-id,1726690.865,airdrop-20181115-hdac-sum-user-id-withdrawal,accac570-de75-11e8-bd11-2f9252c4dc2f,AIRDROP,0
airdrop-20181115-hdac-60e7fa0f-bc57-4a4d-858a-a6e57a823e1d-withdrawal-exchange,2018.11.15 10:11,UNKNOWN,,UNKNOWN-55c0f2b7-dc24-425b-9be8-6b86719f2865,2018.11.15 10:11,UNKNOWN,0,100,0,HDAC,WITHDRAWAL,,,,0,COMPLETED,0,sum-user-id,1726590.865,airdrop-20181115-hdac-sum-user-id-withdrawal,accac570-de75-11e8-bd11-2f9252c4dc2f,AIRDROP,0
airdrop-20181115-hdac-60f37fc2-93f0-4263-8cd2-740fdb7fb228-withdrawal-exchange,2018.11.15 10:11,UNKNOWN,,UNKNOWN-55c0f2b7-dc24-425b-9be8-6b86719f2865,2018.11.15 10:11,UNKNOWN,0,100,0,HDAC,WITHDRAWAL,,,,0,COMPLETED,0,sum-user-id,1726490.865,airdrop-20181115-hdac-sum-user-id-withdrawal,accac570-de75-11e8-bd11-2f9252c4dc2f,AIRDROP,0
airdrop-20181115-hdac-611f7655-d4df-4215-85e0-8379a0c7dc4d-withdrawal-exchange,2018.11.15 10:11,UNKNOWN,,UNKNOWN-55c0f2b7-dc24-425b-9be8-6b86719f2865,2018.11.15 10:11,UNKNOWN,0,100,0,HDAC,WITHDRAWAL,,,,0,COMPLETED,0,sum-user-id,1726390.865,airdrop-20181115-hdac-sum-user-id-withdrawal,accac570-de75-11e8-bd11-2f9252c4dc2f,AIRDROP,0
airdrop-20181115-hdac-61281a75-7a31-4e36-956d-25f6c17c4bf3-withdrawal-exchange,2018.11.15 10:11,UNKNOWN,,UNKNOWN-55c0f2b7-dc24-425b-9be8-6b86719f2865,2018.11.15 10:11,UNKNOWN,0,100,0,HDAC,WITHDRAWAL,,,,0,COMPLETED,0,sum-user-id,1726290.865,airdrop-20181115-hdac-sum-user-id-withdrawal,accac570-de75-11e8-bd11-2f9252c4dc2f,AIRDROP,0
airdrop-20181115-hdac-618f2b54-3611-4673-9369-03878d7eecaa-withdrawal-exchange,2018.11.15 10:11,UNKNOWN,,UNKNOWN-55c0f2b7-dc24-425b-9be8-6b86719f2865,2018.11.15 10:11,UNKNOWN,0,100,0,HDAC,WITHDRAWAL,,,,0,COMPLETED,0,sum-user-id,1726190.865,airdrop-20181115-hdac-sum-user-id-withdrawal,accac570-de75-11e8-bd11-2f9252c4dc2f,AIRDROP,0
airdrop-20181115-hdac-6190e327-3552-4590-aa68-dd6075913de0-withdrawal-exchange,2018.11.15 10:11,UNKNOWN,,UNKNOWN-55c0f2b7-dc24-425b-9be8-6b86719f2865,2018.11.15 10:11,UNKNOWN,0,100,0,HDAC,WITHDRAWAL,,,,0,COMPLETED,0,sum-user-id,1726090.865,airdrop-20181115-hdac-sum-user-id-withdrawal,accac570-de75-11e8-bd11-2f9252c4dc2f,AIRDROP,0
airdrop-20181115-hdac-61b5fa1a-9854-441e-8f85-63924a4080bf-withdrawal-exchange,2018-11-15 10:11:37.001,UNKNOWN,,UNKNOWN-55c0f2b7-dc24-425b-9be8-6b86719f2865,2018-11-15 10:11:37.001,UNKNOWN,0,100,0,HDAC,WITHDRAWAL,,,,0,COMPLETED,0,sum-user-id,1725990.865,airdrop-20181115-hdac-sum-user-id-withdrawal,accac570-de75-11e8-bd11-2f9252c4dc2f,AIRDROP,0
airdrop-20181115-hdac-61cf23ec-5984-4f95-83a1-9f0548414c42-withdrawal-exchange,2018-11-15 10:11:37.036,UNKNOWN,,UNKNOWN-55c0f2b7-dc24-425b-9be8-6b86719f2865,2018-11-15 10:11:37.036,UNKNOWN,0,100,0,HDAC,WITHDRAWAL,,,,0,COMPLETED,0,sum-user-id,1725890.865,airdrop-20181115-hdac-sum-user-id-withdrawal,accac570-de75-11e8-bd11-2f9252c4dc2f,AIRDROP,0
airdrop-20181115-hdac-61e31bba-17bf-4ba2-aacf-66ff76f9734d-withdrawal-exchange,2018-11-15 10:11:37.068,UNKNOWN,,UNKNOWN-55c0f2b7-dc24-425b-9be8-6b86719f2865,2018-11-15 10:11:37.068,UNKNOWN,0,100,0,HDAC,WITHDRAWAL,,,,0,COMPLETED,0,sum-user-id,1725790.865,airdrop-20181115-hdac-sum-user-id-withdrawal,accac570-de75-11e8-bd11-2f9252c4dc2f,AIRDROP,0
airdrop-20181115-hdac-6228c91a-fb1e-4182-a1a0-4801f53c0be3-withdrawal-exchange,2018-11-15 10:11:37.098,UNKNOWN,,UNKNOWN-55c0f2b7-dc24-425b-9be8-6b86719f2865,2018-11-15 10:11:37.098,UNKNOWN,0,100,0,HDAC,WITHDRAWAL,,,,0,COMPLETED,0,sum-user-id,1725690.865,airdrop-20181115-hdac-sum-user-id-withdrawal,accac570-de75-11e8-bd11-2f9252c4dc2f,AIRDROP,0
airdrop-20181115-hdac-622b71a0-efa9-4ce5-aeb3-2dde7d9ee474-withdrawal-exchange,2018.11.15 10:11,UNKNOWN,,UNKNOWN-55c0f2b7-dc24-425b-9be8-6b86719f2865,2018.11.15 10:11,UNKNOWN,0,100,0,HDAC,WITHDRAWAL,,,,0,COMPLETED,0,sum-user-id,1725590.865,airdrop-20181115-hdac-sum-user-id-withdrawal,accac570-de75-11e8-bd11-2f9252c4dc2f,AIRDROP,0
airdrop-20181115-hdac-623bf879-ce07-4c75-b5fa-c77e1ba74d7e-withdrawal-exchange,2018.11.15 10:11,UNKNOWN,,UNKNOWN-55c0f2b7-dc24-425b-9be8-6b86719f2865,2018.11.15 10:11,UNKNOWN,0,100,0,HDAC,WITHDRAWAL,,,,0,COMPLETED,0,sum-user-id,1725490.865,airdrop-20181115-hdac-sum-user-id-withdrawal,accac570-de75-11e8-bd11-2f9252c4dc2f,AIRDROP,0
airdrop-20181115-hdac-629921bc-bdbb-4bee-a1b8-2793600212bf-withdrawal-exchange,2018.11.15 10:11,UNKNOWN,,UNKNOWN-55c0f2b7-dc24-425b-9be8-6b86719f2865,2018.11.15 10:11,UNKNOWN,0,100,0,HDAC,WITHDRAWAL,,,,0,COMPLETED,0,sum-user-id,1725390.865,airdrop-20181115-hdac-sum-user-id-withdrawal,accac570-de75-11e8-bd11-2f9252c4dc2f,AIRDROP,0
airdrop-20181115-hdac-62c0c6c5-9b0d-4186-addb-e2aebd7af6e5-withdrawal-exchange,2018.11.15 10:11,UNKNOWN,,UNKNOWN-55c0f2b7-dc24-425b-9be8-6b86719f2865,2018.11.15 10:11,UNKNOWN,0,100,0,HDAC,WITHDRAWAL,,,,0,COMPLETED,0,sum-user-id,1725290.865,airdrop-20181115-hdac-sum-user-id-withdrawal,accac570-de75-11e8-bd11-2f9252c4dc2f,AIRDROP,0
airdrop-20181115-hdac-62c75249-c92b-4161-a12e-ccd404c54138-withdrawal-exchange,2018.11.15 10:11,UNKNOWN,,UNKNOWN-55c0f2b7-dc24-425b-9be8-6b86719f2865,2018.11.15 10:11,UNKNOWN,0,100,0,HDAC,WITHDRAWAL,,,,0,COMPLETED,0,sum-user-id,1725190.865,airdrop-20181115-hdac-sum-user-id-withdrawal,accac570-de75-11e8-bd11-2f9252c4dc2f,AIRDROP,0
airdrop-20181115-hdac-62cdbf56-201d-4871-9ca8-28773fd3a256-withdrawal-exchange,2018.11.15 10:11,UNKNOWN,,UNKNOWN-55c0f2b7-dc24-425b-9be8-6b86719f2865,2018.11.15 10:11,UNKNOWN,0,100,0,HDAC,WITHDRAWAL,,,,0,COMPLETED,0,sum-user-id,1725090.865,airdrop-20181115-hdac-sum-user-id-withdrawal,accac570-de75-11e8-bd11-2f9252c4dc2f,AIRDROP,0
airdrop-20181115-hdac-62cfdc18-7c01-4459-9ee1-d12d1ed5c682-withdrawal-exchange,2018.11.15 10:11,UNKNOWN,,UNKNOWN-55c0f2b7-dc24-425b-9be8-6b86719f2865,2018.11.15 10:11,UNKNOWN,0,444.197545,0,HDAC,WITHDRAWAL,,,,0,COMPLETED,0,sum-user-id,1724646.667,airdrop-20181115-hdac-sum-user-id-withdrawal,accac570-de75-11e8-bd11-2f9252c4dc2f,AIRDROP,0
airdrop-20181115-hdac-62e2217b-7131-42c1-850b-a54f6f66b54f-withdrawal-exchange,2018.11.15 10:11,UNKNOWN,,UNKNOWN-55c0f2b7-dc24-425b-9be8-6b86719f2865,2018.11.15 10:11,UNKNOWN,0,100,0,HDAC,WITHDRAWAL,,,,0,COMPLETED,0,sum-user-id,1724546.667,airdrop-20181115-hdac-sum-user-id-withdrawal,accac570-de75-11e8-bd11-2f9252c4dc2f,AIRDROP,0
airdrop-20181115-hdac-62e73c66-7d87-49de-9e8f-8480ec9c50b8-withdrawal-exchange,2018.11.15 10:11,UNKNOWN,,UNKNOWN-55c0f2b7-dc24-425b-9be8-6b86719f2865,2018.11.15 10:11,UNKNOWN,0,100,0,HDAC,WITHDRAWAL,,,,0,COMPLETED,0,sum-user-id,1724446.667,airdrop-20181115-hdac-sum-user-id-withdrawal,accac570-de75-11e8-bd11-2f9252c4dc2f,AIRDROP,0
airdrop-20181115-hdac-62e88512-8fd2-4425-a9b2-78cb914d59e0-withdrawal-exchange,2018.11.15 10:11,UNKNOWN,,UNKNOWN-55c0f2b7-dc24-425b-9be8-6b86719f2865,2018.11.15 10:11,UNKNOWN,0,100,0,HDAC,WITHDRAWAL,,,,0,COMPLETED,0,sum-user-id,1724346.667,airdrop-20181115-hdac-sum-user-id-withdrawal,accac570-de75-11e8-bd11-2f9252c4dc2f,AIRDROP,0
airdrop-20181115-hdac-630c54ff-672a-472a-86f1-d4ca8288d3db-withdrawal-exchange,2018.11.15 10:11,UNKNOWN,,UNKNOWN-55c0f2b7-dc24-425b-9be8-6b86719f2865,2018.11.15 10:11,UNKNOWN,0,100,0,HDAC,WITHDRAWAL,,,,0,COMPLETED,0,sum-user-id,1724246.667,airdrop-20181115-hdac-sum-user-id-withdrawal,accac570-de75-11e8-bd11-2f9252c4dc2f,AIRDROP,0
airdrop-20181115-hdac-6379cb55-77ae-4f11-9ca4-eeb6738d1ca2-withdrawal-exchange,2018.11.15 10:11,UNKNOWN,,UNKNOWN-55c0f2b7-dc24-425b-9be8-6b86719f2865,2018.11.15 10:11,UNKNOWN,0,100,0,HDAC,WITHDRAWAL,,,,0,COMPLETED,0,sum-user-id,1724146.667,airdrop-20181115-hdac-sum-user-id-withdrawal,accac570-de75-11e8-bd11-2f9252c4dc2f,AIRDROP,0
airdrop-20181115-hdac-6390d815-68fd-4c21-9c4a-780664476ff7-withdrawal-exchange,2018.11.15 10:11,UNKNOWN,,UNKNOWN-55c0f2b7-dc24-425b-9be8-6b86719f2865,2018.11.15 10:11,UNKNOWN,0,100,0,HDAC,WITHDRAWAL,,,,0,COMPLETED,0,sum-user-id,1724046.667,airdrop-20181115-hdac-sum-user-id-withdrawal,accac570-de75-11e8-bd11-2f9252c4dc2f,AIRDROP,0
airdrop-20181115-hdac-63c2a3a4-ca47-4361-952a-8a0b792cc280-withdrawal-exchange,2018.11.15 10:11,UNKNOWN,,UNKNOWN-55c0f2b7-dc24-425b-9be8-6b86719f2865,2018.11.15 10:11,UNKNOWN,0,100,0,HDAC,WITHDRAWAL,,,,0,COMPLETED,0,sum-user-id,1723946.667,airdrop-20181115-hdac-sum-user-id-withdrawal,accac570-de75-11e8-bd11-2f9252c4dc2f,AIRDROP,0
airdrop-20181115-hdac-63dae98f-67ba-45b6-b5fe-a9af2fdb2941-withdrawal-exchange,2018.11.15 10:11,UNKNOWN,,UNKNOWN-55c0f2b7-dc24-425b-9be8-6b86719f2865,2018.11.15 10:11,UNKNOWN,0,100,0,HDAC,WITHDRAWAL,,,,0,COMPLETED,0,sum-user-id,1723846.667,airdrop-20181115-hdac-sum-user-id-withdrawal,accac570-de75-11e8-bd11-2f9252c4dc2f,AIRDROP,0
airdrop-20181115-hdac-63db6e1d-6762-42d9-a14c-cac21439af19-withdrawal-exchange,2018.11.15 10:11,UNKNOWN,,UNKNOWN-55c0f2b7-dc24-425b-9be8-6b86719f2865,2018.11.15 10:11,UNKNOWN,0,100,0,HDAC,WITHDRAWAL,,,,0,COMPLETED,0,sum-user-id,1723746.667,airdrop-20181115-hdac-sum-user-id-withdrawal,accac570-de75-11e8-bd11-2f9252c4dc2f,AIRDROP,0
airdrop-20181115-hdac-640d5eb3-2cf5-4b01-b80f-1b7ebcc92f9d-withdrawal-exchange,2018.11.15 10:11,UNKNOWN,,UNKNOWN-55c0f2b7-dc24-425b-9be8-6b86719f2865,2018.11.15 10:11,UNKNOWN,0,100,0,HDAC,WITHDRAWAL,,,,0,COMPLETED,0,sum-user-id,1723646.667,airdrop-20181115-hdac-sum-user-id-withdrawal,accac570-de75-11e8-bd11-2f9252c4dc2f,AIRDROP,0
airdrop-20181115-hdac-6458753e-b4bd-4da6-b7ee-08d2dba18676-withdrawal-exchange,2018.11.15 10:11,UNKNOWN,,UNKNOWN-55c0f2b7-dc24-425b-9be8-6b86719f2865,2018.11.15 10:11,UNKNOWN,0,100,0,HDAC,WITHDRAWAL,,,,0,COMPLETED,0,sum-user-id,1723546.667,airdrop-20181115-hdac-sum-user-id-withdrawal,accac570-de75-11e8-bd11-2f9252c4dc2f,AIRDROP,0
airdrop-20181115-hdac-64649ebd-598b-4e2c-9fe8-5f40d79b512b-withdrawal-exchange,2018.11.15 10:11,UNKNOWN,,UNKNOWN-55c0f2b7-dc24-425b-9be8-6b86719f2865,2018.11.15 10:11,UNKNOWN,0,100,0,HDAC,WITHDRAWAL,,,,0,COMPLETED,0,sum-user-id,1723446.667,airdrop-20181115-hdac-sum-user-id-withdrawal,accac570-de75-11e8-bd11-2f9252c4dc2f,AIRDROP,0
airdrop-20181115-hdac-647a9a89-4952-42f6-97ee-1eeeb0cb209c-withdrawal-exchange,2018.11.15 10:11,UNKNOWN,,UNKNOWN-55c0f2b7-dc24-425b-9be8-6b86719f2865,2018.11.15 10:11,UNKNOWN,0,100,0,HDAC,WITHDRAWAL,,,,0,COMPLETED,0,sum-user-id,1723346.667,airdrop-20181115-hdac-sum-user-id-withdrawal,accac570-de75-11e8-bd11-2f9252c4dc2f,AIRDROP,0
airdrop-20181115-hdac-6480249f-849a-4df7-9f37-cd62c8b3e5af-withdrawal-exchange,2018.11.15 10:11,UNKNOWN,,UNKNOWN-55c0f2b7-dc24-425b-9be8-6b86719f2865,2018.11.15 10:11,UNKNOWN,0,100,0,HDAC,WITHDRAWAL,,,,0,COMPLETED,0,sum-user-id,1723246.667,airdrop-20181115-hdac-sum-user-id-withdrawal,accac570-de75-11e8-bd11-2f9252c4dc2f,AIRDROP,0
airdrop-20181115-hdac-64b92152-e80b-4abc-824f-b2168552f749-withdrawal-exchange,2018.11.15 10:11,UNKNOWN,,UNKNOWN-55c0f2b7-dc24-425b-9be8-6b86719f2865,2018.11.15 10:11,UNKNOWN,0,100,0,HDAC,WITHDRAWAL,,,,0,COMPLETED,0,sum-user-id,1723146.667,airdrop-20181115-hdac-sum-user-id-withdrawal,accac570-de75-11e8-bd11-2f9252c4dc2f,AIRDROP,0
airdrop-20181115-hdac-64cca157-5549-47b2-a7ec-e5be678f7a67-withdrawal-exchange,2018.11.15 10:11,UNKNOWN,,UNKNOWN-55c0f2b7-dc24-425b-9be8-6b86719f2865,2018.11.15 10:11,UNKNOWN,0,100,0,HDAC,WITHDRAWAL,,,,0,COMPLETED,0,sum-user-id,1723046.667,airdrop-20181115-hdac-sum-user-id-withdrawal,accac570-de75-11e8-bd11-2f9252c4dc2f,AIRDROP,0
airdrop-20181115-hdac-64f02c6d-8c82-4596-b899-631646364874-withdrawal-exchange,2018.11.15 10:11,UNKNOWN,,UNKNOWN-55c0f2b7-dc24-425b-9be8-6b86719f2865,2018.11.15 10:11,UNKNOWN,0,100,0,HDAC,WITHDRAWAL,,,,0,COMPLETED,0,sum-user-id,1722946.667,airdrop-20181115-hdac-sum-user-id-withdrawal,accac570-de75-11e8-bd11-2f9252c4dc2f,AIRDROP,0
airdrop-20181115-hdac-650dee13-2cdc-419d-8041-2d8dd76f4a67-withdrawal-exchange,2018.11.15 10:11,UNKNOWN,,UNKNOWN-55c0f2b7-dc24-425b-9be8-6b86719f2865,2018.11.15 10:11,UNKNOWN,0,100,0,HDAC,WITHDRAWAL,,,,0,COMPLETED,0,sum-user-id,1722846.667,airdrop-20181115-hdac-sum-user-id-withdrawal,accac570-de75-11e8-bd11-2f9252c4dc2f,AIRDROP,0
airdrop-20181115-hdac-6512ea61-94d5-4b9a-8931-3270d1694c1f-withdrawal-exchange,2018.11.15 10:11,UNKNOWN,,UNKNOWN-55c0f2b7-dc24-425b-9be8-6b86719f2865,2018.11.15 10:11,UNKNOWN,0,100,0,HDAC,WITHDRAWAL,,,,0,COMPLETED,0,sum-user-id,1722746.667,airdrop-20181115-hdac-sum-user-id-withdrawal,accac570-de75-11e8-bd11-2f9252c4dc2f,AIRDROP,0
airdrop-20181115-hdac-65291b49-c53d-49bf-b544-a9915000501a-withdrawal-exchange,2018.11.15 10:11,UNKNOWN,,UNKNOWN-55c0f2b7-dc24-425b-9be8-6b86719f2865,2018.11.15 10:11,UNKNOWN,0,100,0,HDAC,WITHDRAWAL,,,,0,COMPLETED,0,sum-user-id,1722646.667,airdrop-20181115-hdac-sum-user-id-withdrawal,accac570-de75-11e8-bd11-2f9252c4dc2f,AIRDROP,0
airdrop-20181115-hdac-65419eb7-4261-4fa0-81a0-d76bb6bed36f-withdrawal-exchange,2018.11.15 10:11,UNKNOWN,,UNKNOWN-55c0f2b7-dc24-425b-9be8-6b86719f2865,2018.11.15 10:11,UNKNOWN,0,100,0,HDAC,WITHDRAWAL,,,,0,COMPLETED,0,sum-user-id,1722546.667,airdrop-20181115-hdac-sum-user-id-withdrawal,accac570-de75-11e8-bd11-2f9252c4dc2f,AIRDROP,0
airdrop-20181115-hdac-65756af3-8ac8-47df-a062-2bc6b99aa21e-withdrawal-exchange,2018-11-15 10:11:38.020,UNKNOWN,,UNKNOWN-55c0f2b7-dc24-425b-9be8-6b86719f2865,2018-11-15 10:11:38.020,UNKNOWN,0,100,0,HDAC,WITHDRAWAL,,,,0,COMPLETED,0,sum-user-id,1722446.667,airdrop-20181115-hdac-sum-user-id-withdrawal,accac570-de75-11e8-bd11-2f9252c4dc2f,AIRDROP,0
airdrop-20181115-hdac-65922f2a-ca19-4fa9-a69c-ed97bc420761-withdrawal-exchange,2018-11-15 10:11:38.057,UNKNOWN,,UNKNOWN-55c0f2b7-dc24-425b-9be8-6b86719f2865,2018-11-15 10:11:38.057,UNKNOWN,0,100,0,HDAC,WITHDRAWAL,,,,0,COMPLETED,0,sum-user-id,1722346.667,airdrop-20181115-hdac-sum-user-id-withdrawal,accac570-de75-11e8-bd11-2f9252c4dc2f,AIRDROP,0
airdrop-20181115-hdac-65c1a3b0-17d3-4760-be65-46b4e49e9448-withdrawal-exchange,2018.11.15 10:12,UNKNOWN,,UNKNOWN-55c0f2b7-dc24-425b-9be8-6b86719f2865,2018.11.15 10:12,UNKNOWN,0,167.688125,0,HDAC,WITHDRAWAL,,,,0,COMPLETED,0,sum-user-id,1297938.783,airdrop-20181115-hdac-sum-user-id-withdrawal,accac570-de75-11e8-bd11-2f9252c4dc2f,AIRDROP,0
airdrop-20181115-hdac-65cb68bc-20fe-465a-bd0f-7db8f3ddf4b8-withdrawal-exchange,2018-11-15 10:11:38.089,UNKNOWN,,UNKNOWN-55c0f2b7-dc24-425b-9be8-6b86719f2865,2018-11-15 10:11:38.089,UNKNOWN,0,100,0,HDAC,WITHDRAWAL,,,,0,COMPLETED,0,sum-user-id,1722246.667,airdrop-20181115-hdac-sum-user-id-withdrawal,accac570-de75-11e8-bd11-2f9252c4dc2f,AIRDROP,0
airdrop-20181115-hdac-65d02af1-acd4-462d-aba8-2702ba122c63-withdrawal-exchange,2018.11.15 10:11,UNKNOWN,,UNKNOWN-55c0f2b7-dc24-425b-9be8-6b86719f2865,2018.11.15 10:11,UNKNOWN,0,100,0,HDAC,WITHDRAWAL,,,,0,COMPLETED,0,sum-user-id,1722146.667,airdrop-20181115-hdac-sum-user-id-withdrawal,accac570-de75-11e8-bd11-2f9252c4dc2f,AIRDROP,0
airdrop-20181115-hdac-65e161ed-d1c7-4823-90b4-68140c93b932-withdrawal-exchange,2018.11.15 10:11,UNKNOWN,,UNKNOWN-55c0f2b7-dc24-425b-9be8-6b86719f2865,2018.11.15 10:11,UNKNOWN,0,100,0,HDAC,WITHDRAWAL,,,,0,COMPLETED,0,sum-user-id,1722046.667,airdrop-20181115-hdac-sum-user-id-withdrawal,accac570-de75-11e8-bd11-2f9252c4dc2f,AIRDROP,0
airdrop-20181115-hdac-65e7d0be-0d19-4da7-8371-1357001da6eb-withdrawal-exchange,2018.11.15 10:11,UNKNOWN,,UNKNOWN-55c0f2b7-dc24-425b-9be8-6b86719f2865,2018.11.15 10:11,UNKNOWN,0,100,0,HDAC,WITHDRAWAL,,,,0,COMPLETED,0,sum-user-id,1721946.667,airdrop-20181115-hdac-sum-user-id-withdrawal,accac570-de75-11e8-bd11-2f9252c4dc2f,AIRDROP,0
airdrop-20181115-hdac-65fb2c6d-75b5-401b-accb-3e6561dc7d9e-withdrawal-exchange,2018.11.15 10:11,UNKNOWN,,UNKNOWN-55c0f2b7-dc24-425b-9be8-6b86719f2865,2018.11.15 10:11,UNKNOWN,0,100,0,HDAC,WITHDRAWAL,,,,0,COMPLETED,0,sum-user-id,1721846.667,airdrop-20181115-hdac-sum-user-id-withdrawal,accac570-de75-11e8-bd11-2f9252c4dc2f,AIRDROP,0
airdrop-20181115-hdac-660f9a2f-e407-4ef1-abb0-393d0480c655-withdrawal-exchange,2018.11.15 10:11,UNKNOWN,,UNKNOWN-55c0f2b7-dc24-425b-9be8-6b86719f2865,2018.11.15 10:11,UNKNOWN,0,100,0,HDAC,WITHDRAWAL,,,,0,COMPLETED,0,sum-user-id,1721746.667,airdrop-20181115-hdac-sum-user-id-withdrawal,accac570-de75-11e8-bd11-2f9252c4dc2f,AIRDROP,0
airdrop-20181115-hdac-661f5f6c-36cc-4b68-a5d4-25b23feec8e5-withdrawal-exchange,2018.11.15 10:11,UNKNOWN,,UNKNOWN-55c0f2b7-dc24-425b-9be8-6b86719f2865,2018.11.15 10:11,UNKNOWN,0,100,0,HDAC,WITHDRAWAL,,,,0,COMPLETED,0,sum-user-id,1721646.667,airdrop-20181115-hdac-sum-user-id-withdrawal,accac570-de75-11e8-bd11-2f9252c4dc2f,AIRDROP,0
airdrop-20181115-hdac-662856af-ecd7-40d8-903f-ebd94b75746c-withdrawal-exchange,2018.11.15 10:11,UNKNOWN,,UNKNOWN-55c0f2b7-dc24-425b-9be8-6b86719f2865,2018.11.15 10:11,UNKNOWN,0,100,0,HDAC,WITHDRAWAL,,,,0,COMPLETED,0,sum-user-id,1721546.667,airdrop-20181115-hdac-sum-user-id-withdrawal,accac570-de75-11e8-bd11-2f9252c4dc2f,AIRDROP,0
airdrop-20181115-hdac-66332411-c9e8-4c28-b3ea-e5cb2cddd136-withdrawal-exchange,2018.11.15 10:11,UNKNOWN,,UNKNOWN-55c0f2b7-dc24-425b-9be8-6b86719f2865,2018.11.15 10:11,UNKNOWN,0,100,0,HDAC,WITHDRAWAL,,,,0,COMPLETED,0,sum-user-id,1721446.667,airdrop-20181115-hdac-sum-user-id-withdrawal,accac570-de75-11e8-bd11-2f9252c4dc2f,AIRDROP,0
airdrop-20181115-hdac-66598062-3460-45bc-a84f-df9a0acbd31f-withdrawal-exchange,2018.11.15 10:11,UNKNOWN,,UNKNOWN-55c0f2b7-dc24-425b-9be8-6b86719f2865,2018.11.15 10:11,UNKNOWN,0,100,0,HDAC,WITHDRAWAL,,,,0,COMPLETED,0,sum-user-id,1721346.667,airdrop-20181115-hdac-sum-user-id-withdrawal,accac570-de75-11e8-bd11-2f9252c4dc2f,AIRDROP,0
airdrop-20181115-hdac-66681cbe-a8f5-4d40-b1ef-8402745c423f-withdrawal-exchange,2018.11.15 10:11,UNKNOWN,,UNKNOWN-55c0f2b7-dc24-425b-9be8-6b86719f2865,2018.11.15 10:11,UNKNOWN,0,100,0,HDAC,WITHDRAWAL,,,,0,COMPLETED,0,sum-user-id,1721246.667,airdrop-20181115-hdac-sum-user-id-withdrawal,accac570-de75-11e8-bd11-2f9252c4dc2f,AIRDROP,0
airdrop-20181115-hdac-66749496-0c40-4546-96ca-620c48d1377e-withdrawal-exchange,2018.11.15 10:11,UNKNOWN,,UNKNOWN-55c0f2b7-dc24-425b-9be8-6b86719f2865,2018.11.15 10:11,UNKNOWN,0,100,0,HDAC,WITHDRAWAL,,,,0,COMPLETED,0,sum-user-id,1721146.667,airdrop-20181115-hdac-sum-user-id-withdrawal,accac570-de75-11e8-bd11-2f9252c4dc2f,AIRDROP,0
airdrop-20181115-hdac-66bdaf54-8050-4a88-8235-c6217c61daf6-withdrawal-exchange,2018.11.15 10:11,UNKNOWN,,UNKNOWN-55c0f2b7-dc24-425b-9be8-6b86719f2865,2018.11.15 10:11,UNKNOWN,0,100,0,HDAC,WITHDRAWAL,,,,0,COMPLETED,0,sum-user-id,1721046.667,airdrop-20181115-hdac-sum-user-id-withdrawal,accac570-de75-11e8-bd11-2f9252c4dc2f,AIRDROP,0
airdrop-20181115-hdac-66c3450a-30dd-4314-a514-878c1c65ad99-withdrawal-exchange,2018.11.15 10:11,UNKNOWN,,UNKNOWN-55c0f2b7-dc24-425b-9be8-6b86719f2865,2018.11.15 10:11,UNKNOWN,0,100,0,HDAC,WITHDRAWAL,,,,0,COMPLETED,0,sum-user-id,1720946.667,airdrop-20181115-hdac-sum-user-id-withdrawal,accac570-de75-11e8-bd11-2f9252c4dc2f,AIRDROP,0
airdrop-20181115-hdac-66dc3239-c73c-465d-9d6a-f88e5c638892-withdrawal-exchange,2018.11.15 10:11,UNKNOWN,,UNKNOWN-55c0f2b7-dc24-425b-9be8-6b86719f2865,2018.11.15 10:11,UNKNOWN,0,100,0,HDAC,WITHDRAWAL,,,,0,COMPLETED,0,sum-user-id,1720846.667,airdrop-20181115-hdac-sum-user-id-withdrawal,accac570-de75-11e8-bd11-2f9252c4dc2f,AIRDROP,0
airdrop-20181115-hdac-66e8e54b-b10b-4dbe-95dd-948d43b292af-withdrawal-exchange,2018.11.15 10:11,UNKNOWN,,UNKNOWN-55c0f2b7-dc24-425b-9be8-6b86719f2865,2018.11.15 10:11,UNKNOWN,0,100,0,HDAC,WITHDRAWAL,,,,0,COMPLETED,0,sum-user-id,1720746.667,airdrop-20181115-hdac-sum-user-id-withdrawal,accac570-de75-11e8-bd11-2f9252c4dc2f,AIRDROP,0
airdrop-20181115-hdac-66e951e7-4323-43ce-a853-21a304b3cff4-withdrawal-exchange,2018.11.15 10:11,UNKNOWN,,UNKNOWN-55c0f2b7-dc24-425b-9be8-6b86719f2865,2018.11.15 10:11,UNKNOWN,0,100,0,HDAC,WITHDRAWAL,,,,0,COMPLETED,0,sum-user-id,1720646.667,airdrop-20181115-hdac-sum-user-id-withdrawal,accac570-de75-11e8-bd11-2f9252c4dc2f,AIRDROP,0
airdrop-20181115-hdac-66fd33fe-ad9c-404e-937b-02213a77534f-withdrawal-exchange,2018.11.15 10:11,UNKNOWN,,UNKNOWN-55c0f2b7-dc24-425b-9be8-6b86719f2865,2018.11.15 10:11,UNKNOWN,0,100,0,HDAC,WITHDRAWAL,,,,0,COMPLETED,0,sum-user-id,1720546.667,airdrop-20181115-hdac-sum-user-id-withdrawal,accac570-de75-11e8-bd11-2f9252c4dc2f,AIRDROP,0
airdrop-20181115-hdac-677857a9-316f-440f-8566-ae595bba1ee0-withdrawal-exchange,2018.11.15 10:11,UNKNOWN,,UNKNOWN-55c0f2b7-dc24-425b-9be8-6b86719f2865,2018.11.15 10:11,UNKNOWN,0,100,0,HDAC,WITHDRAWAL,,,,0,COMPLETED,0,sum-user-id,1720446.667,airdrop-20181115-hdac-sum-user-id-withdrawal,accac570-de75-11e8-bd11-2f9252c4dc2f,AIRDROP,0
airdrop-20181115-hdac-67843c12-4fe5-4676-a677-a2eb866a4321-withdrawal-exchange,2018.11.15 10:12,UNKNOWN,,UNKNOWN-55c0f2b7-dc24-425b-9be8-6b86719f2865,2018.11.15 10:12,UNKNOWN,0,381.549295,0,HDAC,WITHDRAWAL,,,,0,COMPLETED,0,sum-user-id,1297557.234,airdrop-20181115-hdac-sum-user-id-withdrawal,accac570-de75-11e8-bd11-2f9252c4dc2f,AIRDROP,0
airdrop-20181115-hdac-67cd6039-f466-4147-aa36-c2006b633aba-withdrawal-exchange,2018.11.15 10:11,UNKNOWN,,UNKNOWN-55c0f2b7-dc24-425b-9be8-6b86719f2865,2018.11.15 10:11,UNKNOWN,0,100,0,HDAC,WITHDRAWAL,,,,0,COMPLETED,0,sum-user-id,1720346.667,airdrop-20181115-hdac-sum-user-id-withdrawal,accac570-de75-11e8-bd11-2f9252c4dc2f,AIRDROP,0
airdrop-20181115-hdac-67deed70-295b-4574-88da-da06a68d1be2-withdrawal-exchange,2018.11.15 10:12,UNKNOWN,,UNKNOWN-55c0f2b7-dc24-425b-9be8-6b86719f2865,2018.11.15 10:12,UNKNOWN,0,20000,0,HDAC,WITHDRAWAL,,,,0,COMPLETED,0,sum-user-id,1277557.234,airdrop-20181115-hdac-sum-user-id-withdrawal,accac570-de75-11e8-bd11-2f9252c4dc2f,AIRDROP,0
airdrop-20181115-hdac-67e423d4-480a-488f-b82c-844b1ab342cb-withdrawal-exchange,2018.11.15 10:11,UNKNOWN,,UNKNOWN-55c0f2b7-dc24-425b-9be8-6b86719f2865,2018.11.15 10:11,UNKNOWN,0,100,0,HDAC,WITHDRAWAL,,,,0,COMPLETED,0,sum-user-id,1720246.667,airdrop-20181115-hdac-sum-user-id-withdrawal,accac570-de75-11e8-bd11-2f9252c4dc2f,AIRDROP,0
airdrop-20181115-hdac-6805fc6c-6c75-482c-a4b2-82eb703f711d-withdrawal-exchange,2018.11.15 10:11,UNKNOWN,,UNKNOWN-55c0f2b7-dc24-425b-9be8-6b86719f2865,2018.11.15 10:11,UNKNOWN,0,100,0,HDAC,WITHDRAWAL,,,,0,COMPLETED,0,sum-user-id,1720146.667,airdrop-20181115-hdac-sum-user-id-withdrawal,accac570-de75-11e8-bd11-2f9252c4dc2f,AIRDROP,0
airdrop-20181115-hdac-6809ea97-04e6-40b2-89de-75b29270b5f2-withdrawal-exchange,2018.11.15 10:11,UNKNOWN,,UNKNOWN-55c0f2b7-dc24-425b-9be8-6b86719f2865,2018.11.15 10:11,UNKNOWN,0,100,0,HDAC,WITHDRAWAL,,,,0,COMPLETED,0,sum-user-id,1720046.667,airdrop-20181115-hdac-sum-user-id-withdrawal,accac570-de75-11e8-bd11-2f9252c4dc2f,AIRDROP,0
airdrop-20181115-hdac-6832f5d9-53f4-4578-8055-d10e3ee40cf4-withdrawal-exchange,2018.11.15 10:11,UNKNOWN,,UNKNOWN-55c0f2b7-dc24-425b-9be8-6b86719f2865,2018.11.15 10:11,UNKNOWN,0,100,0,HDAC,WITHDRAWAL,,,,0,COMPLETED,0,sum-user-id,1719946.667,airdrop-20181115-hdac-sum-user-id-withdrawal,accac570-de75-11e8-bd11-2f9252c4dc2f,AIRDROP,0
airdrop-20181115-hdac-684b8b2c-efa6-4dc0-a186-43612db52031-withdrawal-exchange,2018.11.15 10:11,UNKNOWN,,UNKNOWN-55c0f2b7-dc24-425b-9be8-6b86719f2865,2018.11.15 10:11,UNKNOWN,0,100,0,HDAC,WITHDRAWAL,,,,0,COMPLETED,0,sum-user-id,1719846.667,airdrop-20181115-hdac-sum-user-id-withdrawal,accac570-de75-11e8-bd11-2f9252c4dc2f,AIRDROP,0
airdrop-20181115-hdac-68517ccd-39be-426c-987f-cf470e49b2de-withdrawal-exchange,2018.11.15 10:12,UNKNOWN,,UNKNOWN-55c0f2b7-dc24-425b-9be8-6b86719f2865,2018.11.15 10:12,UNKNOWN,0,174.07,0,HDAC,WITHDRAWAL,,,,0,COMPLETED,0,sum-user-id,1277383.164,airdrop-20181115-hdac-sum-user-id-withdrawal,accac570-de75-11e8-bd11-2f9252c4dc2f,AIRDROP,0
airdrop-20181115-hdac-6872e919-1e62-40f1-8cf3-85064a143553-withdrawal-exchange,2018.11.15 10:11,UNKNOWN,,UNKNOWN-55c0f2b7-dc24-425b-9be8-6b86719f2865,2018.11.15 10:11,UNKNOWN,0,100,0,HDAC,WITHDRAWAL,,,,0,COMPLETED,0,sum-user-id,1719746.667,airdrop-20181115-hdac-sum-user-id-withdrawal,accac570-de75-11e8-bd11-2f9252c4dc2f,AIRDROP,0
airdrop-20181115-hdac-688af1cd-e089-453c-962f-50ceb7984581-withdrawal-exchange,2018.11.15 10:11,UNKNOWN,,UNKNOWN-55c0f2b7-dc24-425b-9be8-6b86719f2865,2018.11.15 10:11,UNKNOWN,0,100,0,HDAC,WITHDRAWAL,,,,0,COMPLETED,0,sum-user-id,1719646.667,airdrop-20181115-hdac-sum-user-id-withdrawal,accac570-de75-11e8-bd11-2f9252c4dc2f,AIRDROP,0
airdrop-20181115-hdac-689f0cf3-98bb-41a1-baeb-b949462ecd75-withdrawal-exchange,2018.11.15 10:11,UNKNOWN,,UNKNOWN-55c0f2b7-dc24-425b-9be8-6b86719f2865,2018.11.15 10:11,UNKNOWN,0,100,0,HDAC,WITHDRAWAL,,,,0,COMPLETED,0,sum-user-id,1719546.667,airdrop-20181115-hdac-sum-user-id-withdrawal,accac570-de75-11e8-bd11-2f9252c4dc2f,AIRDROP,0
airdrop-20181115-hdac-68a7123c-25c4-4b25-b42d-f169f78701e1-withdrawal-exchange,2018.11.15 10:11,UNKNOWN,,UNKNOWN-55c0f2b7-dc24-425b-9be8-6b86719f2865,2018.11.15 10:11,UNKNOWN,0,100,0,HDAC,WITHDRAWAL,,,,0,COMPLETED,0,sum-user-id,1719446.667,airdrop-20181115-hdac-sum-user-id-withdrawal,accac570-de75-11e8-bd11-2f9252c4dc2f,AIRDROP,0
airdrop-20181115-hdac-68ab75cf-0cd9-4036-ad79-c4418c1a2f76-withdrawal-exchange,2018-11-15 10:11:39.020,UNKNOWN,,UNKNOWN-55c0f2b7-dc24-425b-9be8-6b86719f2865,2018-11-15 10:11:39.020,UNKNOWN,0,100,0,HDAC,WITHDRAWAL,,,,0,COMPLETED,0,sum-user-id,1719346.667,airdrop-20181115-hdac-sum-user-id-withdrawal,accac570-de75-11e8-bd11-2f9252c4dc2f,AIRDROP,0
airdrop-20181115-hdac-68b6d2d9-1f67-4eec-a2c9-a2bdee1fb8dc-withdrawal-exchange,2018-11-15 10:11:39.049,UNKNOWN,,UNKNOWN-55c0f2b7-dc24-425b-9be8-6b86719f2865,2018-11-15 10:11:39.049,UNKNOWN,0,100,0,HDAC,WITHDRAWAL,,,,0,COMPLETED,0,sum-user-id,1719246.667,airdrop-20181115-hdac-sum-user-id-withdrawal,accac570-de75-11e8-bd11-2f9252c4dc2f,AIRDROP,0
airdrop-20181115-hdac-68e10f6f-36d6-48fd-b390-494661fbab5e-withdrawal-exchange,2018-11-15 10:11:39.081,UNKNOWN,,UNKNOWN-55c0f2b7-dc24-425b-9be8-6b86719f2865,2018-11-15 10:11:39.081,UNKNOWN,0,100,0,HDAC,WITHDRAWAL,,,,0,COMPLETED,0,sum-user-id,1719146.667,airdrop-20181115-hdac-sum-user-id-withdrawal,accac570-de75-11e8-bd11-2f9252c4dc2f,AIRDROP,0
airdrop-20181115-hdac-690db039-9ee9-4be5-bc12-65bcf9c541d1-withdrawal-exchange,2018.11.15 10:11,UNKNOWN,,UNKNOWN-55c0f2b7-dc24-425b-9be8-6b86719f2865,2018.11.15 10:11,UNKNOWN,0,100,0,HDAC,WITHDRAWAL,,,,0,COMPLETED,0,sum-user-id,1719046.667,airdrop-20181115-hdac-sum-user-id-withdrawal,accac570-de75-11e8-bd11-2f9252c4dc2f,AIRDROP,0
airdrop-20181115-hdac-6931c27a-5723-44f5-abb2-ecc9eae991aa-withdrawal-exchange,2018.11.15 10:11,UNKNOWN,,UNKNOWN-55c0f2b7-dc24-425b-9be8-6b86719f2865,2018.11.15 10:11,UNKNOWN,0,100,0,HDAC,WITHDRAWAL,,,,0,COMPLETED,0,sum-user-id,1718946.667,airdrop-20181115-hdac-sum-user-id-withdrawal,accac570-de75-11e8-bd11-2f9252c4dc2f,AIRDROP,0
airdrop-20181115-hdac-694f7696-4ceb-47dd-969f-a44480db3b42-withdrawal-exchange,2018.11.15 10:11,UNKNOWN,,UNKNOWN-55c0f2b7-dc24-425b-9be8-6b86719f2865,2018.11.15 10:11,UNKNOWN,0,100,0,HDAC,WITHDRAWAL,,,,0,COMPLETED,0,sum-user-id,1718846.667,airdrop-20181115-hdac-sum-user-id-withdrawal,accac570-de75-11e8-bd11-2f9252c4dc2f,AIRDROP,0
airdrop-20181115-hdac-6953952d-601b-4e7a-b3d5-a567f1c179ee-withdrawal-exchange,2018.11.15 10:11,UNKNOWN,,UNKNOWN-55c0f2b7-dc24-425b-9be8-6b86719f2865,2018.11.15 10:11,UNKNOWN,0,100,0,HDAC,WITHDRAWAL,,,,0,COMPLETED,0,sum-user-id,1718746.667,airdrop-20181115-hdac-sum-user-id-withdrawal,accac570-de75-11e8-bd11-2f9252c4dc2f,AIRDROP,0
airdrop-20181115-hdac-69a015cc-a31c-4717-ad03-367abd22b0ae-withdrawal-exchange,2018.11.15 10:11,UNKNOWN,,UNKNOWN-55c0f2b7-dc24-425b-9be8-6b86719f2865,2018.11.15 10:11,UNKNOWN,0,100,0,HDAC,WITHDRAWAL,,,,0,COMPLETED,0,sum-user-id,1718646.667,airdrop-20181115-hdac-sum-user-id-withdrawal,accac570-de75-11e8-bd11-2f9252c4dc2f,AIRDROP,0
airdrop-20181115-hdac-69a9dc83-a2e7-4dff-99ec-3468125cea09-withdrawal-exchange,2018.11.15 10:11,UNKNOWN,,UNKNOWN-55c0f2b7-dc24-425b-9be8-6b86719f2865,2018.11.15 10:11,UNKNOWN,0,100,0,HDAC,WITHDRAWAL,,,,0,COMPLETED,0,sum-user-id,1718546.667,airdrop-20181115-hdac-sum-user-id-withdrawal,accac570-de75-11e8-bd11-2f9252c4dc2f,AIRDROP,0
airdrop-20181115-hdac-69d84d45-677d-48fb-94a2-715ef09576fa-withdrawal-exchange,2018.11.15 10:11,UNKNOWN,,UNKNOWN-55c0f2b7-dc24-425b-9be8-6b86719f2865,2018.11.15 10:11,UNKNOWN,0,100,0,HDAC,WITHDRAWAL,,,,0,COMPLETED,0,sum-user-id,1718446.667,airdrop-20181115-hdac-sum-user-id-withdrawal,accac570-de75-11e8-bd11-2f9252c4dc2f,AIRDROP,0
airdrop-20181115-hdac-6a071c17-35e5-4465-ad06-ebb94025be1b-withdrawal-exchange,2018.11.15 10:11,UNKNOWN,,UNKNOWN-55c0f2b7-dc24-425b-9be8-6b86719f2865,2018.11.15 10:11,UNKNOWN,0,100,0,HDAC,WITHDRAWAL,,,,0,COMPLETED,0,sum-user-id,1718346.667,airdrop-20181115-hdac-sum-user-id-withdrawal,accac570-de75-11e8-bd11-2f9252c4dc2f,AIRDROP,0
airdrop-20181115-hdac-6a080ae9-78d0-4b6f-81ab-cb23c923f417-withdrawal-exchange,2018.11.15 10:11,UNKNOWN,,UNKNOWN-55c0f2b7-dc24-425b-9be8-6b86719f2865,2018.11.15 10:11,UNKNOWN,0,100,0,HDAC,WITHDRAWAL,,,,0,COMPLETED,0,sum-user-id,1718246.667,airdrop-20181115-hdac-sum-user-id-withdrawal,accac570-de75-11e8-bd11-2f9252c4dc2f,AIRDROP,0
airdrop-20181115-hdac-6a08b48f-b1af-43e2-a580-85a012d5e6a7-withdrawal-exchange,2018.11.15 10:11,UNKNOWN,,UNKNOWN-55c0f2b7-dc24-425b-9be8-6b86719f2865,2018.11.15 10:11,UNKNOWN,0,100,0,HDAC,WITHDRAWAL,,,,0,COMPLETED,0,sum-user-id,1718146.667,airdrop-20181115-hdac-sum-user-id-withdrawal,accac570-de75-11e8-bd11-2f9252c4dc2f,AIRDROP,0
airdrop-20181115-hdac-6a5892a0-b9ba-4f86-9da5-d1e500d9c2a7-withdrawal-exchange,2018.11.15 10:11,UNKNOWN,,UNKNOWN-55c0f2b7-dc24-425b-9be8-6b86719f2865,2018.11.15 10:11,UNKNOWN,0,100,0,HDAC,WITHDRAWAL,,,,0,COMPLETED,0,sum-user-id,1718046.667,airdrop-20181115-hdac-sum-user-id-withdrawal,accac570-de75-11e8-bd11-2f9252c4dc2f,AIRDROP,0
airdrop-20181115-hdac-6a6108a8-b7fc-47fb-9162-48611d136dac-withdrawal-exchange,2018.11.15 10:11,UNKNOWN,,UNKNOWN-55c0f2b7-dc24-425b-9be8-6b86719f2865,2018.11.15 10:11,UNKNOWN,0,100,0,HDAC,WITHDRAWAL,,,,0,COMPLETED,0,sum-user-id,1717946.667,airdrop-20181115-hdac-sum-user-id-withdrawal,accac570-de75-11e8-bd11-2f9252c4dc2f,AIRDROP,0
airdrop-20181115-hdac-6a981c8a-c7a7-40b0-8141-f95a58c2ebbe-withdrawal-exchange,2018.11.15 10:11,UNKNOWN,,UNKNOWN-55c0f2b7-dc24-425b-9be8-6b86719f2865,2018.11.15 10:11,UNKNOWN,0,100,0,HDAC,WITHDRAWAL,,,,0,COMPLETED,0,sum-user-id,1717846.667,airdrop-20181115-hdac-sum-user-id-withdrawal,accac570-de75-11e8-bd11-2f9252c4dc2f,AIRDROP,0
airdrop-20181115-hdac-6afe2fbe-b53b-4cd7-844b-73a1d03058d4-withdrawal-exchange,2018.11.15 10:11,UNKNOWN,,UNKNOWN-55c0f2b7-dc24-425b-9be8-6b86719f2865,2018.11.15 10:11,UNKNOWN,0,100,0,HDAC,WITHDRAWAL,,,,0,COMPLETED,0,sum-user-id,1717746.667,airdrop-20181115-hdac-sum-user-id-withdrawal,accac570-de75-11e8-bd11-2f9252c4dc2f,AIRDROP,0
airdrop-20181115-hdac-6b0fb2d2-af20-4470-bcf8-84137c4268e2-withdrawal-exchange,2018.11.15 10:11,UNKNOWN,,UNKNOWN-55c0f2b7-dc24-425b-9be8-6b86719f2865,2018.11.15 10:11,UNKNOWN,0,100,0,HDAC,WITHDRAWAL,,,,0,COMPLETED,0,sum-user-id,1717646.667,airdrop-20181115-hdac-sum-user-id-withdrawal,accac570-de75-11e8-bd11-2f9252c4dc2f,AIRDROP,0
airdrop-20181115-hdac-6b62b14e-07d5-47d1-bf2f-83653eb1f4db-withdrawal-exchange,2018.11.15 10:11,UNKNOWN,,UNKNOWN-55c0f2b7-dc24-425b-9be8-6b86719f2865,2018.11.15 10:11,UNKNOWN,0,100,0,HDAC,WITHDRAWAL,,,,0,COMPLETED,0,sum-user-id,1717546.667,airdrop-20181115-hdac-sum-user-id-withdrawal,accac570-de75-11e8-bd11-2f9252c4dc2f,AIRDROP,0
airdrop-20181115-hdac-6b860ca1-40a7-40df-9e9b-cf59397a4b37-withdrawal-exchange,2018.11.15 10:11,UNKNOWN,,UNKNOWN-55c0f2b7-dc24-425b-9be8-6b86719f2865,2018.11.15 10:11,UNKNOWN,0,100,0,HDAC,WITHDRAWAL,,,,0,COMPLETED,0,sum-user-id,1717446.667,airdrop-20181115-hdac-sum-user-id-withdrawal,accac570-de75-11e8-bd11-2f9252c4dc2f,AIRDROP,0
airdrop-20181115-hdac-6bb583e2-24bb-479b-8d2f-e160318167ce-withdrawal-exchange,2018.11.15 10:11,UNKNOWN,,UNKNOWN-55c0f2b7-dc24-425b-9be8-6b86719f2865,2018.11.15 10:11,UNKNOWN,0,100,0,HDAC,WITHDRAWAL,,,,0,COMPLETED,0,sum-user-id,1717346.667,airdrop-20181115-hdac-sum-user-id-withdrawal,accac570-de75-11e8-bd11-2f9252c4dc2f,AIRDROP,0
airdrop-20181115-hdac-6bbd2cfe-0f63-482f-9aa7-0b3a66149ed6-withdrawal-exchange,2018.11.15 10:11,UNKNOWN,,UNKNOWN-55c0f2b7-dc24-425b-9be8-6b86719f2865,2018.11.15 10:11,UNKNOWN,0,100,0,HDAC,WITHDRAWAL,,,,0,COMPLETED,0,sum-user-id,1717246.667,airdrop-20181115-hdac-sum-user-id-withdrawal,accac570-de75-11e8-bd11-2f9252c4dc2f,AIRDROP,0
airdrop-20181115-hdac-6bc3f487-7c2d-4ac9-9a9f-5de500ec2022-withdrawal-exchange,2018.11.15 10:11,UNKNOWN,,UNKNOWN-55c0f2b7-dc24-425b-9be8-6b86719f2865,2018.11.15 10:11,UNKNOWN,0,100,0,HDAC,WITHDRAWAL,,,,0,COMPLETED,0,sum-user-id,1717146.667,airdrop-20181115-hdac-sum-user-id-withdrawal,accac570-de75-11e8-bd11-2f9252c4dc2f,AIRDROP,0
airdrop-20181115-hdac-6be978c9-9f81-4825-bbff-ac6311f1a5a2-withdrawal-exchange,2018.11.15 10:11,UNKNOWN,,UNKNOWN-55c0f2b7-dc24-425b-9be8-6b86719f2865,2018.11.15 10:11,UNKNOWN,0,100,0,HDAC,WITHDRAWAL,,,,0,COMPLETED,0,sum-user-id,1717046.667,airdrop-20181115-hdac-sum-user-id-withdrawal,accac570-de75-11e8-bd11-2f9252c4dc2f,AIRDROP,0
airdrop-20181115-hdac-6c633705-3b94-4435-8698-d79b64e1cae7-withdrawal-exchange,2018.11.15 10:11,UNKNOWN,,UNKNOWN-55c0f2b7-dc24-425b-9be8-6b86719f2865,2018.11.15 10:11,UNKNOWN,0,100,0,HDAC,WITHDRAWAL,,,,0,COMPLETED,0,sum-user-id,1716946.667,airdrop-20181115-hdac-sum-user-id-withdrawal,accac570-de75-11e8-bd11-2f9252c4dc2f,AIRDROP,0
airdrop-20181115-hdac-6c8871e4-6e39-4d84-9527-e492b10b60c5-withdrawal-exchange,2018.11.15 10:11,UNKNOWN,,UNKNOWN-55c0f2b7-dc24-425b-9be8-6b86719f2865,2018.11.15 10:11,UNKNOWN,0,100,0,HDAC,WITHDRAWAL,,,,0,COMPLETED,0,sum-user-id,1716846.667,airdrop-20181115-hdac-sum-user-id-withdrawal,accac570-de75-11e8-bd11-2f9252c4dc2f,AIRDROP,0
airdrop-20181115-hdac-6c8e7a72-05db-4a31-b01f-f82b715714c6-withdrawal-exchange,2018.11.15 10:11,UNKNOWN,,UNKNOWN-55c0f2b7-dc24-425b-9be8-6b86719f2865,2018.11.15 10:11,UNKNOWN,0,100,0,HDAC,WITHDRAWAL,,,,0,COMPLETED,0,sum-user-id,1716746.667,airdrop-20181115-hdac-sum-user-id-withdrawal,accac570-de75-11e8-bd11-2f9252c4dc2f,AIRDROP,0
airdrop-20181115-hdac-6c96a2b9-62d7-45a3-b009-113038046dbf-withdrawal-exchange,2018.11.15 10:11,UNKNOWN,,UNKNOWN-55c0f2b7-dc24-425b-9be8-6b86719f2865,2018.11.15 10:11,UNKNOWN,0,100,0,HDAC,WITHDRAWAL,,,,0,COMPLETED,0,sum-user-id,1716646.667,airdrop-20181115-hdac-sum-user-id-withdrawal,accac570-de75-11e8-bd11-2f9252c4dc2f,AIRDROP,0
airdrop-20181115-hdac-6cafc944-9ea5-46f2-9c1e-ae1886488f3a-withdrawal-exchange,2018.11.15 10:11,UNKNOWN,,UNKNOWN-55c0f2b7-dc24-425b-9be8-6b86719f2865,2018.11.15 10:11,UNKNOWN,0,100,0,HDAC,WITHDRAWAL,,,,0,COMPLETED,0,sum-user-id,1716546.667,airdrop-20181115-hdac-sum-user-id-withdrawal,accac570-de75-11e8-bd11-2f9252c4dc2f,AIRDROP,0
airdrop-20181115-hdac-6cb549db-3b85-4404-bb14-f5152c736f45-withdrawal-exchange,2018.11.15 10:11,UNKNOWN,,UNKNOWN-55c0f2b7-dc24-425b-9be8-6b86719f2865,2018.11.15 10:11,UNKNOWN,0,100,0,HDAC,WITHDRAWAL,,,,0,COMPLETED,0,sum-user-id,1716446.667,airdrop-20181115-hdac-sum-user-id-withdrawal,accac570-de75-11e8-bd11-2f9252c4dc2f,AIRDROP,0
airdrop-20181115-hdac-6cb87c5d-e010-4f89-8c07-95a2e1d7c097-withdrawal-exchange,2018.11.15 10:11,UNKNOWN,,UNKNOWN-55c0f2b7-dc24-425b-9be8-6b86719f2865,2018.11.15 10:11,UNKNOWN,0,100,0,HDAC,WITHDRAWAL,,,,0,COMPLETED,0,sum-user-id,1716346.667,airdrop-20181115-hdac-sum-user-id-withdrawal,accac570-de75-11e8-bd11-2f9252c4dc2f,AIRDROP,0
airdrop-20181115-hdac-6cbb462f-1c0c-451a-8b13-19de63abaefa-withdrawal-exchange,2018-11-15 10:11:40.004,UNKNOWN,,UNKNOWN-55c0f2b7-dc24-425b-9be8-6b86719f2865,2018-11-15 10:11:40.004,UNKNOWN,0,100,0,HDAC,WITHDRAWAL,,,,0,COMPLETED,0,sum-user-id,1716246.667,airdrop-20181115-hdac-sum-user-id-withdrawal,accac570-de75-11e8-bd11-2f9252c4dc2f,AIRDROP,0
airdrop-20181115-hdac-6ce51ead-7b95-4031-ba41-2f07f5d83d90-withdrawal-exchange,2018-11-15 10:11:40.037,UNKNOWN,,UNKNOWN-55c0f2b7-dc24-425b-9be8-6b86719f2865,2018-11-15 10:11:40.037,UNKNOWN,0,100,0,HDAC,WITHDRAWAL,,,,0,COMPLETED,0,sum-user-id,1716146.667,airdrop-20181115-hdac-sum-user-id-withdrawal,accac570-de75-11e8-bd11-2f9252c4dc2f,AIRDROP,0
airdrop-20181115-hdac-6d13b775-e209-40c4-8b03-56d5771cac1f-withdrawal-exchange,2018-11-15 10:11:40.067,UNKNOWN,,UNKNOWN-55c0f2b7-dc24-425b-9be8-6b86719f2865,2018-11-15 10:11:40.067,UNKNOWN,0,100,0,HDAC,WITHDRAWAL,,,,0,COMPLETED,0,sum-user-id,1716046.667,airdrop-20181115-hdac-sum-user-id-withdrawal,accac570-de75-11e8-bd11-2f9252c4dc2f,AIRDROP,0
airdrop-20181115-hdac-6d1bdeaa-715e-4762-8f00-e4ed56e55024-withdrawal-exchange,2018.11.15 10:11,UNKNOWN,,UNKNOWN-55c0f2b7-dc24-425b-9be8-6b86719f2865,2018.11.15 10:11,UNKNOWN,0,100,0,HDAC,WITHDRAWAL,,,,0,COMPLETED,0,sum-user-id,1715946.667,airdrop-20181115-hdac-sum-user-id-withdrawal,accac570-de75-11e8-bd11-2f9252c4dc2f,AIRDROP,0
airdrop-20181115-hdac-6d31cdcf-322c-4ffd-a982-458a972627f0-withdrawal-exchange,2018.11.15 10:11,UNKNOWN,,UNKNOWN-55c0f2b7-dc24-425b-9be8-6b86719f2865,2018.11.15 10:11,UNKNOWN,0,100,0,HDAC,WITHDRAWAL,,,,0,COMPLETED,0,sum-user-id,1715846.667,airdrop-20181115-hdac-sum-user-id-withdrawal,accac570-de75-11e8-bd11-2f9252c4dc2f,AIRDROP,0
airdrop-20181115-hdac-6d37e41e-ea15-4044-a842-e7440c708a1b-withdrawal-exchange,2018.11.15 10:11,UNKNOWN,,UNKNOWN-55c0f2b7-dc24-425b-9be8-6b86719f2865,2018.11.15 10:11,UNKNOWN,0,100,0,HDAC,WITHDRAWAL,,,,0,COMPLETED,0,sum-user-id,1715746.667,airdrop-20181115-hdac-sum-user-id-withdrawal,accac570-de75-11e8-bd11-2f9252c4dc2f,AIRDROP,0
airdrop-20181115-hdac-6d45dc14-283f-4726-80ee-6e3e9b86f75e-withdrawal-exchange,2018.11.15 10:11,UNKNOWN,,UNKNOWN-55c0f2b7-dc24-425b-9be8-6b86719f2865,2018.11.15 10:11,UNKNOWN,0,100,0,HDAC,WITHDRAWAL,,,,0,COMPLETED,0,sum-user-id,1715646.667,airdrop-20181115-hdac-sum-user-id-withdrawal,accac570-de75-11e8-bd11-2f9252c4dc2f,AIRDROP,0
airdrop-20181115-hdac-6d691c4e-98f3-4359-8442-cfe324b610db-withdrawal-exchange,2018.11.15 10:11,UNKNOWN,,UNKNOWN-55c0f2b7-dc24-425b-9be8-6b86719f2865,2018.11.15 10:11,UNKNOWN,0,100,0,HDAC,WITHDRAWAL,,,,0,COMPLETED,0,sum-user-id,1715546.667,airdrop-20181115-hdac-sum-user-id-withdrawal,accac570-de75-11e8-bd11-2f9252c4dc2f,AIRDROP,0
airdrop-20181115-hdac-6d79610c-474e-496f-98e4-fee4fdc77c21-withdrawal-exchange,2018.11.15 10:11,UNKNOWN,,UNKNOWN-55c0f2b7-dc24-425b-9be8-6b86719f2865,2018.11.15 10:11,UNKNOWN,0,100,0,HDAC,WITHDRAWAL,,,,0,COMPLETED,0,sum-user-id,1715446.667,airdrop-20181115-hdac-sum-user-id-withdrawal,accac570-de75-11e8-bd11-2f9252c4dc2f,AIRDROP,0
airdrop-20181115-hdac-6d7f471f-df8b-423d-81b9-3a7bd700b5d4-withdrawal-exchange,2018.11.15 10:11,UNKNOWN,,UNKNOWN-55c0f2b7-dc24-425b-9be8-6b86719f2865,2018.11.15 10:11,UNKNOWN,0,100,0,HDAC,WITHDRAWAL,,,,0,COMPLETED,0,sum-user-id,1715346.667,airdrop-20181115-hdac-sum-user-id-withdrawal,accac570-de75-11e8-bd11-2f9252c4dc2f,AIRDROP,0
airdrop-20181115-hdac-6d8154b4-1dd8-48bd-822a-d46affb8b02e-withdrawal-exchange,2018.11.15 10:11,UNKNOWN,,UNKNOWN-55c0f2b7-dc24-425b-9be8-6b86719f2865,2018.11.15 10:11,UNKNOWN,0,100,0,HDAC,WITHDRAWAL,,,,0,COMPLETED,0,sum-user-id,1715246.667,airdrop-20181115-hdac-sum-user-id-withdrawal,accac570-de75-11e8-bd11-2f9252c4dc2f,AIRDROP,0
airdrop-20181115-hdac-6d9b4cb8-50d8-486c-92c7-16dff5f7ff87-withdrawal-exchange,2018.11.15 10:11,UNKNOWN,,UNKNOWN-55c0f2b7-dc24-425b-9be8-6b86719f2865,2018.11.15 10:11,UNKNOWN,0,100,0,HDAC,WITHDRAWAL,,,,0,COMPLETED,0,sum-user-id,1715146.667,airdrop-20181115-hdac-sum-user-id-withdrawal,accac570-de75-11e8-bd11-2f9252c4dc2f,AIRDROP,0
airdrop-20181115-hdac-6dd6afa6-907b-4f67-aa67-1314c68b5bd3-withdrawal-exchange,2018.11.15 10:11,UNKNOWN,,UNKNOWN-55c0f2b7-dc24-425b-9be8-6b86719f2865,2018.11.15 10:11,UNKNOWN,0,100,0,HDAC,WITHDRAWAL,,,,0,COMPLETED,0,sum-user-id,1715046.667,airdrop-20181115-hdac-sum-user-id-withdrawal,accac570-de75-11e8-bd11-2f9252c4dc2f,AIRDROP,0
airdrop-20181115-hdac-6de5a745-9416-471b-8937-86f05109fa26-withdrawal-exchange,2018.11.15 10:11,UNKNOWN,,UNKNOWN-55c0f2b7-dc24-425b-9be8-6b86719f2865,2018.11.15 10:11,UNKNOWN,0,100,0,HDAC,WITHDRAWAL,,,,0,COMPLETED,0,sum-user-id,1714946.667,airdrop-20181115-hdac-sum-user-id-withdrawal,accac570-de75-11e8-bd11-2f9252c4dc2f,AIRDROP,0
airdrop-20181115-hdac-6df59f1f-4f8e-485c-b638-8a781d1d8fd1-withdrawal-exchange,2018.11.15 10:11,UNKNOWN,,UNKNOWN-55c0f2b7-dc24-425b-9be8-6b86719f2865,2018.11.15 10:11,UNKNOWN,0,100,0,HDAC,WITHDRAWAL,,,,0,COMPLETED,0,sum-user-id,1714846.667,airdrop-20181115-hdac-sum-user-id-withdrawal,accac570-de75-11e8-bd11-2f9252c4dc2f,AIRDROP,0
airdrop-20181115-hdac-6e0eae3c-7153-4e70-a3bf-072c718f77b1-withdrawal-exchange,2018.11.15 10:11,UNKNOWN,,UNKNOWN-55c0f2b7-dc24-425b-9be8-6b86719f2865,2018.11.15 10:11,UNKNOWN,0,100,0,HDAC,WITHDRAWAL,,,,0,COMPLETED,0,sum-user-id,1714746.667,airdrop-20181115-hdac-sum-user-id-withdrawal,accac570-de75-11e8-bd11-2f9252c4dc2f,AIRDROP,0
airdrop-20181115-hdac-6e28927e-ae7a-472d-ac53-0b29f2090ff7-withdrawal-exchange,2018.11.15 10:11,UNKNOWN,,UNKNOWN-55c0f2b7-dc24-425b-9be8-6b86719f2865,2018.11.15 10:11,UNKNOWN,0,100,0,HDAC,WITHDRAWAL,,,,0,COMPLETED,0,sum-user-id,1714646.667,airdrop-20181115-hdac-sum-user-id-withdrawal,accac570-de75-11e8-bd11-2f9252c4dc2f,AIRDROP,0
airdrop-20181115-hdac-6e33b91d-f782-47b7-bf24-91d971f4d26c-withdrawal-exchange,2018.11.15 10:11,UNKNOWN,,UNKNOWN-55c0f2b7-dc24-425b-9be8-6b86719f2865,2018.11.15 10:11,UNKNOWN,0,100,0,HDAC,WITHDRAWAL,,,,0,COMPLETED,0,sum-user-id,1714546.667,airdrop-20181115-hdac-sum-user-id-withdrawal,accac570-de75-11e8-bd11-2f9252c4dc2f,AIRDROP,0
airdrop-20181115-hdac-6e386f6f-54d5-45b7-8603-3641c59b9f7a-withdrawal-exchange,2018.11.15 10:11,UNKNOWN,,UNKNOWN-55c0f2b7-dc24-425b-9be8-6b86719f2865,2018.11.15 10:11,UNKNOWN,0,100,0,HDAC,WITHDRAWAL,,,,0,COMPLETED,0,sum-user-id,1714446.667,airdrop-20181115-hdac-sum-user-id-withdrawal,accac570-de75-11e8-bd11-2f9252c4dc2f,AIRDROP,0
airdrop-20181115-hdac-6e436d56-f844-4678-976c-a83fa447c79c-withdrawal-exchange,2018.11.15 10:11,UNKNOWN,,UNKNOWN-55c0f2b7-dc24-425b-9be8-6b86719f2865,2018.11.15 10:11,UNKNOWN,0,100,0,HDAC,WITHDRAWAL,,,,0,COMPLETED,0,sum-user-id,1714346.667,airdrop-20181115-hdac-sum-user-id-withdrawal,accac570-de75-11e8-bd11-2f9252c4dc2f,AIRDROP,0
airdrop-20181115-hdac-6e75c456-fa29-45e7-bdd0-5f9e074388af-withdrawal-exchange,2018.11.15 10:11,UNKNOWN,,UNKNOWN-55c0f2b7-dc24-425b-9be8-6b86719f2865,2018.11.15 10:11,UNKNOWN,0,100,0,HDAC,WITHDRAWAL,,,,0,COMPLETED,0,sum-user-id,1714246.667,airdrop-20181115-hdac-sum-user-id-withdrawal,accac570-de75-11e8-bd11-2f9252c4dc2f,AIRDROP,0
airdrop-20181115-hdac-6e769336-990f-4bb0-9833-c9f6609b7132-withdrawal-exchange,2018.11.15 10:11,UNKNOWN,,UNKNOWN-55c0f2b7-dc24-425b-9be8-6b86719f2865,2018.11.15 10:11,UNKNOWN,0,100,0,HDAC,WITHDRAWAL,,,,0,COMPLETED,0,sum-user-id,1714146.667,airdrop-20181115-hdac-sum-user-id-withdrawal,accac570-de75-11e8-bd11-2f9252c4dc2f,AIRDROP,0
airdrop-20181115-hdac-6e7aa5f9-2775-4a06-9ca4-a65f802f4937-withdrawal-exchange,2018.11.15 10:11,UNKNOWN,,UNKNOWN-55c0f2b7-dc24-425b-9be8-6b86719f2865,2018.11.15 10:11,UNKNOWN,0,100,0,HDAC,WITHDRAWAL,,,,0,COMPLETED,0,sum-user-id,1714046.667,airdrop-20181115-hdac-sum-user-id-withdrawal,accac570-de75-11e8-bd11-2f9252c4dc2f,AIRDROP,0
airdrop-20181115-hdac-6ea703df-433d-41b6-9d83-bfd3450739b0-withdrawal-exchange,2018.11.15 10:11,UNKNOWN,,UNKNOWN-55c0f2b7-dc24-425b-9be8-6b86719f2865,2018.11.15 10:11,UNKNOWN,0,100,0,HDAC,WITHDRAWAL,,,,0,COMPLETED,0,sum-user-id,1713946.667,airdrop-20181115-hdac-sum-user-id-withdrawal,accac570-de75-11e8-bd11-2f9252c4dc2f,AIRDROP,0
airdrop-20181115-hdac-6ea7ed8a-8d3c-4c82-8504-3366a445d041-withdrawal-exchange,2018.11.15 10:11,UNKNOWN,,UNKNOWN-55c0f2b7-dc24-425b-9be8-6b86719f2865,2018.11.15 10:11,UNKNOWN,0,100,0,HDAC,WITHDRAWAL,,,,0,COMPLETED,0,sum-user-id,1713846.667,airdrop-20181115-hdac-sum-user-id-withdrawal,accac570-de75-11e8-bd11-2f9252c4dc2f,AIRDROP,0
airdrop-20181115-hdac-6eadc319-7707-482e-8888-cc1dbd8b3078-withdrawal-exchange,2018.11.15 10:11,UNKNOWN,,UNKNOWN-55c0f2b7-dc24-425b-9be8-6b86719f2865,2018.11.15 10:11,UNKNOWN,0,100,0,HDAC,WITHDRAWAL,,,,0,COMPLETED,0,sum-user-id,1713746.667,airdrop-20181115-hdac-sum-user-id-withdrawal,accac570-de75-11e8-bd11-2f9252c4dc2f,AIRDROP,0
airdrop-20181115-hdac-6ee80abe-c7cd-42b2-bc34-b407a0397aea-withdrawal-exchange,2018.11.15 10:11,UNKNOWN,,UNKNOWN-55c0f2b7-dc24-425b-9be8-6b86719f2865,2018.11.15 10:11,UNKNOWN,0,100,0,HDAC,WITHDRAWAL,,,,0,COMPLETED,0,sum-user-id,1713646.667,airdrop-20181115-hdac-sum-user-id-withdrawal,accac570-de75-11e8-bd11-2f9252c4dc2f,AIRDROP,0
airdrop-20181115-hdac-6f000110-b49c-4b29-a5f1-df49c18ccfbb-withdrawal-exchange,2018.11.15 10:11,UNKNOWN,,UNKNOWN-55c0f2b7-dc24-425b-9be8-6b86719f2865,2018.11.15 10:11,UNKNOWN,0,100,0,HDAC,WITHDRAWAL,,,,0,COMPLETED,0,sum-user-id,1713546.667,airdrop-20181115-hdac-sum-user-id-withdrawal,accac570-de75-11e8-bd11-2f9252c4dc2f,AIRDROP,0
airdrop-20181115-hdac-6f0b83ab-45ab-4c6b-b65b-cc0a0a090e2f-withdrawal-exchange,2018.11.15 10:11,UNKNOWN,,UNKNOWN-55c0f2b7-dc24-425b-9be8-6b86719f2865,2018.11.15 10:11,UNKNOWN,0,100,0,HDAC,WITHDRAWAL,,,,0,COMPLETED,0,sum-user-id,1713446.667,airdrop-20181115-hdac-sum-user-id-withdrawal,accac570-de75-11e8-bd11-2f9252c4dc2f,AIRDROP,0
airdrop-20181115-hdac-6f2f8fb9-14dd-4a5c-bbe6-52f82d8e57bc-withdrawal-exchange,2018.11.15 10:11,UNKNOWN,,UNKNOWN-55c0f2b7-dc24-425b-9be8-6b86719f2865,2018.11.15 10:11,UNKNOWN,0,100,0,HDAC,WITHDRAWAL,,,,0,COMPLETED,0,sum-user-id,1713346.667,airdrop-20181115-hdac-sum-user-id-withdrawal,accac570-de75-11e8-bd11-2f9252c4dc2f,AIRDROP,0
airdrop-20181115-hdac-6f308dfe-768d-4417-81c3-26517c96d731-withdrawal-exchange,2018.11.15 10:11,UNKNOWN,,UNKNOWN-55c0f2b7-dc24-425b-9be8-6b86719f2865,2018.11.15 10:11,UNKNOWN,0,100,0,HDAC,WITHDRAWAL,,,,0,COMPLETED,0,sum-user-id,1713246.667,airdrop-20181115-hdac-sum-user-id-withdrawal,accac570-de75-11e8-bd11-2f9252c4dc2f,AIRDROP,0
airdrop-20181115-hdac-6f6ca9d4-19e7-47c9-a62e-8c4315257717-withdrawal-exchange,2018-11-15 10:11:41.031,UNKNOWN,,UNKNOWN-55c0f2b7-dc24-425b-9be8-6b86719f2865,2018-11-15 10:11:41.031,UNKNOWN,0,100,0,HDAC,WITHDRAWAL,,,,0,COMPLETED,0,sum-user-id,1713146.667,airdrop-20181115-hdac-sum-user-id-withdrawal,accac570-de75-11e8-bd11-2f9252c4dc2f,AIRDROP,0
airdrop-20181115-hdac-6f8e06ab-55a4-480b-b2f3-955a32610e96-withdrawal-exchange,2018-11-15 10:11:41.063,UNKNOWN,,UNKNOWN-55c0f2b7-dc24-425b-9be8-6b86719f2865,2018-11-15 10:11:41.063,UNKNOWN,0,100,0,HDAC,WITHDRAWAL,,,,0,COMPLETED,0,sum-user-id,1713046.667,airdrop-20181115-hdac-sum-user-id-withdrawal,accac570-de75-11e8-bd11-2f9252c4dc2f,AIRDROP,0
airdrop-20181115-hdac-6f8fbbc2-4a5f-44a2-b53a-0032717c16d8-withdrawal-exchange,2018-11-15 10:11:41.094,UNKNOWN,,UNKNOWN-55c0f2b7-dc24-425b-9be8-6b86719f2865,2018-11-15 10:11:41.094,UNKNOWN,0,100,0,HDAC,WITHDRAWAL,,,,0,COMPLETED,0,sum-user-id,1712946.667,airdrop-20181115-hdac-sum-user-id-withdrawal,accac570-de75-11e8-bd11-2f9252c4dc2f,AIRDROP,0
airdrop-20181115-hdac-6faf7216-f1d9-452c-b96f-ac6a6daa682f-withdrawal-exchange,2018.11.15 10:12,UNKNOWN,,UNKNOWN-55c0f2b7-dc24-425b-9be8-6b86719f2865,2018.11.15 10:12,UNKNOWN,0,10100,0,HDAC,WITHDRAWAL,,,,0,COMPLETED,0,sum-user-id,1267283.164,airdrop-20181115-hdac-sum-user-id-withdrawal,accac570-de75-11e8-bd11-2f9252c4dc2f,AIRDROP,0
airdrop-20181115-hdac-6fbd403a-1ff2-4b93-8ec5-2bf043f6f85a-withdrawal-exchange,2018.11.15 10:11,UNKNOWN,,UNKNOWN-55c0f2b7-dc24-425b-9be8-6b86719f2865,2018.11.15 10:11,UNKNOWN,0,100,0,HDAC,WITHDRAWAL,,,,0,COMPLETED,0,sum-user-id,1712846.667,airdrop-20181115-hdac-sum-user-id-withdrawal,accac570-de75-11e8-bd11-2f9252c4dc2f,AIRDROP,0
airdrop-20181115-hdac-6fd9b289-ded5-4626-93eb-0d7e6514b753-withdrawal-exchange,2018.11.15 10:11,UNKNOWN,,UNKNOWN-55c0f2b7-dc24-425b-9be8-6b86719f2865,2018.11.15 10:11,UNKNOWN,0,100,0,HDAC,WITHDRAWAL,,,,0,COMPLETED,0,sum-user-id,1712746.667,airdrop-20181115-hdac-sum-user-id-withdrawal,accac570-de75-11e8-bd11-2f9252c4dc2f,AIRDROP,0
airdrop-20181115-hdac-700f768d-cfc3-4dd6-a033-21356a1c3e65-withdrawal-exchange,2018.11.15 10:11,UNKNOWN,,UNKNOWN-55c0f2b7-dc24-425b-9be8-6b86719f2865,2018.11.15 10:11,UNKNOWN,0,100,0,HDAC,WITHDRAWAL,,,,0,COMPLETED,0,sum-user-id,1712646.667,airdrop-20181115-hdac-sum-user-id-withdrawal,accac570-de75-11e8-bd11-2f9252c4dc2f,AIRDROP,0
airdrop-20181115-hdac-70100841-4ec6-4d84-a792-9bd08ffe61b9-withdrawal-exchange,2018.11.15 10:11,UNKNOWN,,UNKNOWN-55c0f2b7-dc24-425b-9be8-6b86719f2865,2018.11.15 10:11,UNKNOWN,0,100,0,HDAC,WITHDRAWAL,,,,0,COMPLETED,0,sum-user-id,1712546.667,airdrop-20181115-hdac-sum-user-id-withdrawal,accac570-de75-11e8-bd11-2f9252c4dc2f,AIRDROP,0
airdrop-20181115-hdac-702bbca7-66cb-47c1-b90b-410e440f7814-withdrawal-exchange,2018.11.15 10:11,UNKNOWN,,UNKNOWN-55c0f2b7-dc24-425b-9be8-6b86719f2865,2018.11.15 10:11,UNKNOWN,0,100,0,HDAC,WITHDRAWAL,,,,0,COMPLETED,0,sum-user-id,1712446.667,airdrop-20181115-hdac-sum-user-id-withdrawal,accac570-de75-11e8-bd11-2f9252c4dc2f,AIRDROP,0
airdrop-20181115-hdac-70340506-95e6-4e8d-87d7-7c6811dd370e-withdrawal-exchange,2018.11.15 10:11,UNKNOWN,,UNKNOWN-55c0f2b7-dc24-425b-9be8-6b86719f2865,2018.11.15 10:11,UNKNOWN,0,100,0,HDAC,WITHDRAWAL,,,,0,COMPLETED,0,sum-user-id,1712346.667,airdrop-20181115-hdac-sum-user-id-withdrawal,accac570-de75-11e8-bd11-2f9252c4dc2f,AIRDROP,0
airdrop-20181115-hdac-704c090f-df48-44d7-917c-cb0b2dd60415-withdrawal-exchange,2018.11.15 10:11,UNKNOWN,,UNKNOWN-55c0f2b7-dc24-425b-9be8-6b86719f2865,2018.11.15 10:11,UNKNOWN,0,100,0,HDAC,WITHDRAWAL,,,,0,COMPLETED,0,sum-user-id,1712246.667,airdrop-20181115-hdac-sum-user-id-withdrawal,accac570-de75-11e8-bd11-2f9252c4dc2f,AIRDROP,0
airdrop-20181115-hdac-704cbd5c-1703-4f61-8b15-fd6bc9cb233a-withdrawal-exchange,2018.11.15 10:11,UNKNOWN,,UNKNOWN-55c0f2b7-dc24-425b-9be8-6b86719f2865,2018.11.15 10:11,UNKNOWN,0,100,0,HDAC,WITHDRAWAL,,,,0,COMPLETED,0,sum-user-id,1712146.667,airdrop-20181115-hdac-sum-user-id-withdrawal,accac570-de75-11e8-bd11-2f9252c4dc2f,AIRDROP,0
airdrop-20181115-hdac-70922770-2315-4283-82b8-a5ce936aa6c5-withdrawal-exchange,2018.11.15 10:11,UNKNOWN,,UNKNOWN-55c0f2b7-dc24-425b-9be8-6b86719f2865,2018.11.15 10:11,UNKNOWN,0,100,0,HDAC,WITHDRAWAL,,,,0,COMPLETED,0,sum-user-id,1712046.667,airdrop-20181115-hdac-sum-user-id-withdrawal,accac570-de75-11e8-bd11-2f9252c4dc2f,AIRDROP,0
airdrop-20181115-hdac-70a86d67-8d25-4802-a7e5-2c5fa189a834-withdrawal-exchange,2018.11.15 10:11,UNKNOWN,,UNKNOWN-55c0f2b7-dc24-425b-9be8-6b86719f2865,2018.11.15 10:11,UNKNOWN,0,100,0,HDAC,WITHDRAWAL,,,,0,COMPLETED,0,sum-user-id,1711946.667,airdrop-20181115-hdac-sum-user-id-withdrawal,accac570-de75-11e8-bd11-2f9252c4dc2f,AIRDROP,0
airdrop-20181115-hdac-716197aa-084a-4032-b04b-d7ed593bfda7-withdrawal-exchange,2018.11.15 10:11,UNKNOWN,,UNKNOWN-55c0f2b7-dc24-425b-9be8-6b86719f2865,2018.11.15 10:11,UNKNOWN,0,100,0,HDAC,WITHDRAWAL,,,,0,COMPLETED,0,sum-user-id,1711846.667,airdrop-20181115-hdac-sum-user-id-withdrawal,accac570-de75-11e8-bd11-2f9252c4dc2f,AIRDROP,0
airdrop-20181115-hdac-71a2c917-8f6c-40f0-85ad-7da69fe451b7-withdrawal-exchange,2018.11.15 10:11,UNKNOWN,,UNKNOWN-55c0f2b7-dc24-425b-9be8-6b86719f2865,2018.11.15 10:11,UNKNOWN,0,100,0,HDAC,WITHDRAWAL,,,,0,COMPLETED,0,sum-user-id,1711746.667,airdrop-20181115-hdac-sum-user-id-withdrawal,accac570-de75-11e8-bd11-2f9252c4dc2f,AIRDROP,0
airdrop-20181115-hdac-71b4704d-632e-4dc6-ba5f-0ddc731eac8f-withdrawal-exchange,2018.11.15 10:11,UNKNOWN,,UNKNOWN-55c0f2b7-dc24-425b-9be8-6b86719f2865,2018.11.15 10:11,UNKNOWN,0,100,0,HDAC,WITHDRAWAL,,,,0,COMPLETED,0,sum-user-id,1711646.667,airdrop-20181115-hdac-sum-user-id-withdrawal,accac570-de75-11e8-bd11-2f9252c4dc2f,AIRDROP,0
airdrop-20181115-hdac-71de6131-1621-4ed9-9808-a8bb0e9bf1b3-withdrawal-exchange,2018.11.15 10:11,UNKNOWN,,UNKNOWN-55c0f2b7-dc24-425b-9be8-6b86719f2865,2018.11.15 10:11,UNKNOWN,0,100,0,HDAC,WITHDRAWAL,,,,0,COMPLETED,0,sum-user-id,1711546.667,airdrop-20181115-hdac-sum-user-id-withdrawal,accac570-de75-11e8-bd11-2f9252c4dc2f,AIRDROP,0
airdrop-20181115-hdac-71fc38ad-726e-418a-92d9-080782b29225-withdrawal-exchange,2018.11.15 10:11,UNKNOWN,,UNKNOWN-55c0f2b7-dc24-425b-9be8-6b86719f2865,2018.11.15 10:11,UNKNOWN,0,100,0,HDAC,WITHDRAWAL,,,,0,COMPLETED,0,sum-user-id,1711446.667,airdrop-20181115-hdac-sum-user-id-withdrawal,accac570-de75-11e8-bd11-2f9252c4dc2f,AIRDROP,0
airdrop-20181115-hdac-721da2f0-1e62-4a69-970a-9c0165d5941c-withdrawal-exchange,2018.11.15 10:11,UNKNOWN,,UNKNOWN-55c0f2b7-dc24-425b-9be8-6b86719f2865,2018.11.15 10:11,UNKNOWN,0,100,0,HDAC,WITHDRAWAL,,,,0,COMPLETED,0,sum-user-id,1711346.667,airdrop-20181115-hdac-sum-user-id-withdrawal,accac570-de75-11e8-bd11-2f9252c4dc2f,AIRDROP,0
airdrop-20181115-hdac-725d733e-ce0a-4067-92de-7c9d1dd9f00b-withdrawal-exchange,2018.11.15 10:12,UNKNOWN,,UNKNOWN-55c0f2b7-dc24-425b-9be8-6b86719f2865,2018.11.15 10:12,UNKNOWN,0,1195.64,0,HDAC,WITHDRAWAL,,,,0,COMPLETED,0,sum-user-id,1266087.524,airdrop-20181115-hdac-sum-user-id-withdrawal,accac570-de75-11e8-bd11-2f9252c4dc2f,AIRDROP,0
airdrop-20181115-hdac-7262ed97-5ed6-43d4-b205-bb8feff2c00c-withdrawal-exchange,2018.11.15 10:11,UNKNOWN,,UNKNOWN-55c0f2b7-dc24-425b-9be8-6b86719f2865,2018.11.15 10:11,UNKNOWN,0,100,0,HDAC,WITHDRAWAL,,,,0,COMPLETED,0,sum-user-id,1711246.667,airdrop-20181115-hdac-sum-user-id-withdrawal,accac570-de75-11e8-bd11-2f9252c4dc2f,AIRDROP,0
airdrop-20181115-hdac-72b13e89-584e-41ee-a894-b442d8619cb3-withdrawal-exchange,2018.11.15 10:11,UNKNOWN,,UNKNOWN-55c0f2b7-dc24-425b-9be8-6b86719f2865,2018.11.15 10:11,UNKNOWN,0,100,0,HDAC,WITHDRAWAL,,,,0,COMPLETED,0,sum-user-id,1711146.667,airdrop-20181115-hdac-sum-user-id-withdrawal,accac570-de75-11e8-bd11-2f9252c4dc2f,AIRDROP,0
airdrop-20181115-hdac-72be52af-2537-4e0b-81ca-ffb5730cb4de-withdrawal-exchange,2018.11.15 10:11,UNKNOWN,,UNKNOWN-55c0f2b7-dc24-425b-9be8-6b86719f2865,2018.11.15 10:11,UNKNOWN,0,968.52,0,HDAC,WITHDRAWAL,,,,0,COMPLETED,0,sum-user-id,1710178.147,airdrop-20181115-hdac-sum-user-id-withdrawal,accac570-de75-11e8-bd11-2f9252c4dc2f,AIRDROP,0
airdrop-20181115-hdac-72c1f352-5a48-481f-bd8b-c033c795f261-withdrawal-exchange,2018.11.15 10:11,UNKNOWN,,UNKNOWN-55c0f2b7-dc24-425b-9be8-6b86719f2865,2018.11.15 10:11,UNKNOWN,0,100,0,HDAC,WITHDRAWAL,,,,0,COMPLETED,0,sum-user-id,1710078.147,airdrop-20181115-hdac-sum-user-id-withdrawal,accac570-de75-11e8-bd11-2f9252c4dc2f,AIRDROP,0
airdrop-20181115-hdac-72cbfd51-e625-402a-82c3-c9576607a5a8-withdrawal-exchange,2018.11.15 10:11,UNKNOWN,,UNKNOWN-55c0f2b7-dc24-425b-9be8-6b86719f2865,2018.11.15 10:11,UNKNOWN,0,100,0,HDAC,WITHDRAWAL,,,,0,COMPLETED,0,sum-user-id,1709978.147,airdrop-20181115-hdac-sum-user-id-withdrawal,accac570-de75-11e8-bd11-2f9252c4dc2f,AIRDROP,0
airdrop-20181115-hdac-72d1c4ae-5278-45d0-bce7-5d664d49c644-withdrawal-exchange,2018.11.15 10:11,UNKNOWN,,UNKNOWN-55c0f2b7-dc24-425b-9be8-6b86719f2865,2018.11.15 10:11,UNKNOWN,0,100,0,HDAC,WITHDRAWAL,,,,0,COMPLETED,0,sum-user-id,1709878.147,airdrop-20181115-hdac-sum-user-id-withdrawal,accac570-de75-11e8-bd11-2f9252c4dc2f,AIRDROP,0
airdrop-20181115-hdac-72e48653-586a-4f31-ba2d-122d97e8a2e4-withdrawal-exchange,2018.11.15 10:11,UNKNOWN,,UNKNOWN-55c0f2b7-dc24-425b-9be8-6b86719f2865,2018.11.15 10:11,UNKNOWN,0,100,0,HDAC,WITHDRAWAL,,,,0,COMPLETED,0,sum-user-id,1709778.147,airdrop-20181115-hdac-sum-user-id-withdrawal,accac570-de75-11e8-bd11-2f9252c4dc2f,AIRDROP,0
airdrop-20181115-hdac-72e497a8-fab4-440d-9114-d5772758d50f-withdrawal-exchange,2018.11.15 10:11,UNKNOWN,,UNKNOWN-55c0f2b7-dc24-425b-9be8-6b86719f2865,2018.11.15 10:11,UNKNOWN,0,100,0,HDAC,WITHDRAWAL,,,,0,COMPLETED,0,sum-user-id,1709678.147,airdrop-20181115-hdac-sum-user-id-withdrawal,accac570-de75-11e8-bd11-2f9252c4dc2f,AIRDROP,0
airdrop-20181115-hdac-7312f486-052b-425b-b9f2-ca3d1f02b5be-withdrawal-exchange,2018.11.15 10:11,UNKNOWN,,UNKNOWN-55c0f2b7-dc24-425b-9be8-6b86719f2865,2018.11.15 10:11,UNKNOWN,0,100,0,HDAC,WITHDRAWAL,,,,0,COMPLETED,0,sum-user-id,1709578.147,airdrop-20181115-hdac-sum-user-id-withdrawal,accac570-de75-11e8-bd11-2f9252c4dc2f,AIRDROP,0
airdrop-20181115-hdac-73249515-2de5-44fc-97ca-6b5feb26abb2-withdrawal-exchange,2018.11.15 10:11,UNKNOWN,,UNKNOWN-55c0f2b7-dc24-425b-9be8-6b86719f2865,2018.11.15 10:11,UNKNOWN,0,100,0,HDAC,WITHDRAWAL,,,,0,COMPLETED,0,sum-user-id,1709478.147,airdrop-20181115-hdac-sum-user-id-withdrawal,accac570-de75-11e8-bd11-2f9252c4dc2f,AIRDROP,0
airdrop-20181115-hdac-7341de07-21e7-4e73-b71f-a8680680cb3f-withdrawal-exchange,2018.11.15 10:11,UNKNOWN,,UNKNOWN-55c0f2b7-dc24-425b-9be8-6b86719f2865,2018.11.15 10:11,UNKNOWN,0,100,0,HDAC,WITHDRAWAL,,,,0,COMPLETED,0,sum-user-id,1709378.147,airdrop-20181115-hdac-sum-user-id-withdrawal,accac570-de75-11e8-bd11-2f9252c4dc2f,AIRDROP,0
airdrop-20181115-hdac-7347724a-2fe7-4759-85f9-84db242ea921-withdrawal-exchange,2018.11.15 10:11,UNKNOWN,,UNKNOWN-55c0f2b7-dc24-425b-9be8-6b86719f2865,2018.11.15 10:11,UNKNOWN,0,100,0,HDAC,WITHDRAWAL,,,,0,COMPLETED,0,sum-user-id,1709278.147,airdrop-20181115-hdac-sum-user-id-withdrawal,accac570-de75-11e8-bd11-2f9252c4dc2f,AIRDROP,0
airdrop-20181115-hdac-7364a1e5-bf8a-4b9a-9e70-adf0a5185772-withdrawal-exchange,2018-11-15 10:11:42.022,UNKNOWN,,UNKNOWN-55c0f2b7-dc24-425b-9be8-6b86719f2865,2018-11-15 10:11:42.022,UNKNOWN,0,100,0,HDAC,WITHDRAWAL,,,,0,COMPLETED,0,sum-user-id,1709178.147,airdrop-20181115-hdac-sum-user-id-withdrawal,accac570-de75-11e8-bd11-2f9252c4dc2f,AIRDROP,0
airdrop-20181115-hdac-73948448-beba-4b22-8185-62a506ae0477-withdrawal-exchange,2018-11-15 10:11:42.055,UNKNOWN,,UNKNOWN-55c0f2b7-dc24-425b-9be8-6b86719f2865,2018-11-15 10:11:42.055,UNKNOWN,0,100,0,HDAC,WITHDRAWAL,,,,0,COMPLETED,0,sum-user-id,1709078.147,airdrop-20181115-hdac-sum-user-id-withdrawal,accac570-de75-11e8-bd11-2f9252c4dc2f,AIRDROP,0
airdrop-20181115-hdac-73c8b6bd-0e5c-4b8f-b2c2-04ac0cc77617-withdrawal-exchange,2018-11-15 10:11:42.087,UNKNOWN,,UNKNOWN-55c0f2b7-dc24-425b-9be8-6b86719f2865,2018-11-15 10:11:42.087,UNKNOWN,0,100,0,HDAC,WITHDRAWAL,,,,0,COMPLETED,0,sum-user-id,1708978.147,airdrop-20181115-hdac-sum-user-id-withdrawal,accac570-de75-11e8-bd11-2f9252c4dc2f,AIRDROP,0
airdrop-20181115-hdac-73c901f1-5b11-40b0-a83c-005965d9430d-withdrawal-exchange,2018.11.15 10:11,UNKNOWN,,UNKNOWN-55c0f2b7-dc24-425b-9be8-6b86719f2865,2018.11.15 10:11,UNKNOWN,0,100,0,HDAC,WITHDRAWAL,,,,0,COMPLETED,0,sum-user-id,1708878.147,airdrop-20181115-hdac-sum-user-id-withdrawal,accac570-de75-11e8-bd11-2f9252c4dc2f,AIRDROP,0
airdrop-20181115-hdac-73cb0acf-2c73-46b1-aee9-711f46f0fdf1-withdrawal-exchange,2018.11.15 10:11,UNKNOWN,,UNKNOWN-55c0f2b7-dc24-425b-9be8-6b86719f2865,2018.11.15 10:11,UNKNOWN,0,100,0,HDAC,WITHDRAWAL,,,,0,COMPLETED,0,sum-user-id,1708778.147,airdrop-20181115-hdac-sum-user-id-withdrawal,accac570-de75-11e8-bd11-2f9252c4dc2f,AIRDROP,0
airdrop-20181115-hdac-73cc90a6-5193-4090-940c-41427905fae8-withdrawal-exchange,2018.11.15 10:11,UNKNOWN,,UNKNOWN-55c0f2b7-dc24-425b-9be8-6b86719f2865,2018.11.15 10:11,UNKNOWN,0,100,0,HDAC,WITHDRAWAL,,,,0,COMPLETED,0,sum-user-id,1708678.147,airdrop-20181115-hdac-sum-user-id-withdrawal,accac570-de75-11e8-bd11-2f9252c4dc2f,AIRDROP,0
airdrop-20181115-hdac-74016bef-3c90-4aac-8adf-4d1cbaf84f76-withdrawal-exchange,2018.11.15 10:11,UNKNOWN,,UNKNOWN-55c0f2b7-dc24-425b-9be8-6b86719f2865,2018.11.15 10:11,UNKNOWN,0,100,0,HDAC,WITHDRAWAL,,,,0,COMPLETED,0,sum-user-id,1708578.147,airdrop-20181115-hdac-sum-user-id-withdrawal,accac570-de75-11e8-bd11-2f9252c4dc2f,AIRDROP,0
airdrop-20181115-hdac-74143ea7-0818-48dc-a427-6d5c65d0db09-withdrawal-exchange,2018.11.15 10:11,UNKNOWN,,UNKNOWN-55c0f2b7-dc24-425b-9be8-6b86719f2865,2018.11.15 10:11,UNKNOWN,0,100,0,HDAC,WITHDRAWAL,,,,0,COMPLETED,0,sum-user-id,1708478.147,airdrop-20181115-hdac-sum-user-id-withdrawal,accac570-de75-11e8-bd11-2f9252c4dc2f,AIRDROP,0
airdrop-20181115-hdac-7415a564-72b1-467e-9864-21d99f816dc8-withdrawal-exchange,2018.11.15 10:11,UNKNOWN,,UNKNOWN-55c0f2b7-dc24-425b-9be8-6b86719f2865,2018.11.15 10:11,UNKNOWN,0,100,0,HDAC,WITHDRAWAL,,,,0,COMPLETED,0,sum-user-id,1708378.147,airdrop-20181115-hdac-sum-user-id-withdrawal,accac570-de75-11e8-bd11-2f9252c4dc2f,AIRDROP,0
airdrop-20181115-hdac-741ad5de-75fc-41ae-93b0-75fdce9a7006-withdrawal-exchange,2018.11.15 10:11,UNKNOWN,,UNKNOWN-55c0f2b7-dc24-425b-9be8-6b86719f2865,2018.11.15 10:11,UNKNOWN,0,100,0,HDAC,WITHDRAWAL,,,,0,COMPLETED,0,sum-user-id,1708278.147,airdrop-20181115-hdac-sum-user-id-withdrawal,accac570-de75-11e8-bd11-2f9252c4dc2f,AIRDROP,0
airdrop-20181115-hdac-7447162b-1828-463b-a167-6a42ab9469d2-withdrawal-exchange,2018.11.15 10:11,UNKNOWN,,UNKNOWN-55c0f2b7-dc24-425b-9be8-6b86719f2865,2018.11.15 10:11,UNKNOWN,0,100,0,HDAC,WITHDRAWAL,,,,0,COMPLETED,0,sum-user-id,1708178.147,airdrop-20181115-hdac-sum-user-id-withdrawal,accac570-de75-11e8-bd11-2f9252c4dc2f,AIRDROP,0
airdrop-20181115-hdac-744db3c6-9293-4b02-adb8-351dc35529f2-withdrawal-exchange,2018.11.15 10:11,UNKNOWN,,UNKNOWN-55c0f2b7-dc24-425b-9be8-6b86719f2865,2018.11.15 10:11,UNKNOWN,0,100,0,HDAC,WITHDRAWAL,,,,0,COMPLETED,0,sum-user-id,1708078.147,airdrop-20181115-hdac-sum-user-id-withdrawal,accac570-de75-11e8-bd11-2f9252c4dc2f,AIRDROP,0
airdrop-20181115-hdac-7459af56-4e59-4e22-9fe8-fc0e7e2e441f-withdrawal-exchange,2018.11.15 10:11,UNKNOWN,,UNKNOWN-55c0f2b7-dc24-425b-9be8-6b86719f2865,2018.11.15 10:11,UNKNOWN,0,93.703125,0,HDAC,WITHDRAWAL,,,,0,COMPLETED,0,sum-user-id,1707984.444,airdrop-20181115-hdac-sum-user-id-withdrawal,accac570-de75-11e8-bd11-2f9252c4dc2f,AIRDROP,0
airdrop-20181115-hdac-745f24f4-a671-41b5-8e7e-be94f28024e0-withdrawal-exchange,2018.11.15 10:11,UNKNOWN,,UNKNOWN-55c0f2b7-dc24-425b-9be8-6b86719f2865,2018.11.15 10:11,UNKNOWN,0,100,0,HDAC,WITHDRAWAL,,,,0,COMPLETED,0,sum-user-id,1707884.444,airdrop-20181115-hdac-sum-user-id-withdrawal,accac570-de75-11e8-bd11-2f9252c4dc2f,AIRDROP,0
airdrop-20181115-hdac-7474056f-8500-460c-9eae-bdecad87334b-withdrawal-exchange,2018.11.15 10:11,UNKNOWN,,UNKNOWN-55c0f2b7-dc24-425b-9be8-6b86719f2865,2018.11.15 10:11,UNKNOWN,0,100,0,HDAC,WITHDRAWAL,,,,0,COMPLETED,0,sum-user-id,1707784.444,airdrop-20181115-hdac-sum-user-id-withdrawal,accac570-de75-11e8-bd11-2f9252c4dc2f,AIRDROP,0
airdrop-20181115-hdac-74883098-f8c1-431b-9ffd-471164c320ea-withdrawal-exchange,2018.11.15 10:11,UNKNOWN,,UNKNOWN-55c0f2b7-dc24-425b-9be8-6b86719f2865,2018.11.15 10:11,UNKNOWN,0,100,0,HDAC,WITHDRAWAL,,,,0,COMPLETED,0,sum-user-id,1707684.444,airdrop-20181115-hdac-sum-user-id-withdrawal,accac570-de75-11e8-bd11-2f9252c4dc2f,AIRDROP,0
airdrop-20181115-hdac-748c3910-e964-463f-a952-3d03a1e5a0f3-withdrawal-exchange,2018.11.15 10:11,UNKNOWN,,UNKNOWN-55c0f2b7-dc24-425b-9be8-6b86719f2865,2018.11.15 10:11,UNKNOWN,0,100,0,HDAC,WITHDRAWAL,,,,0,COMPLETED,0,sum-user-id,1707584.444,airdrop-20181115-hdac-sum-user-id-withdrawal,accac570-de75-11e8-bd11-2f9252c4dc2f,AIRDROP,0
airdrop-20181115-hdac-7495372c-bb23-4125-9283-1d35b20ddbcd-withdrawal-exchange,2018.11.15 10:11,UNKNOWN,,UNKNOWN-55c0f2b7-dc24-425b-9be8-6b86719f2865,2018.11.15 10:11,UNKNOWN,0,100,0,HDAC,WITHDRAWAL,,,,0,COMPLETED,0,sum-user-id,1707484.444,airdrop-20181115-hdac-sum-user-id-withdrawal,accac570-de75-11e8-bd11-2f9252c4dc2f,AIRDROP,0
airdrop-20181115-hdac-74976e6b-fceb-4ca5-a3cb-86301c8ba4b2-withdrawal-exchange,2018.11.15 10:11,UNKNOWN,,UNKNOWN-55c0f2b7-dc24-425b-9be8-6b86719f2865,2018.11.15 10:11,UNKNOWN,0,100,0,HDAC,WITHDRAWAL,,,,0,COMPLETED,0,sum-user-id,1707384.444,airdrop-20181115-hdac-sum-user-id-withdrawal,accac570-de75-11e8-bd11-2f9252c4dc2f,AIRDROP,0
airdrop-20181115-hdac-74ad71dd-d6b1-44a1-aad0-0bb58c7b6389-withdrawal-exchange,2018.11.15 10:11,UNKNOWN,,UNKNOWN-55c0f2b7-dc24-425b-9be8-6b86719f2865,2018.11.15 10:11,UNKNOWN,0,100,0,HDAC,WITHDRAWAL,,,,0,COMPLETED,0,sum-user-id,1707284.444,airdrop-20181115-hdac-sum-user-id-withdrawal,accac570-de75-11e8-bd11-2f9252c4dc2f,AIRDROP,0
airdrop-20181115-hdac-74b366d9-858f-4291-860f-2805b6654208-withdrawal-exchange,2018.11.15 10:11,UNKNOWN,,UNKNOWN-55c0f2b7-dc24-425b-9be8-6b86719f2865,2018.11.15 10:11,UNKNOWN,0,100,0,HDAC,WITHDRAWAL,,,,0,COMPLETED,0,sum-user-id,1707184.444,airdrop-20181115-hdac-sum-user-id-withdrawal,accac570-de75-11e8-bd11-2f9252c4dc2f,AIRDROP,0
airdrop-20181115-hdac-74b46c4d-ea2e-42eb-b0d8-8734c9108e35-withdrawal-exchange,2018.11.15 10:11,UNKNOWN,,UNKNOWN-55c0f2b7-dc24-425b-9be8-6b86719f2865,2018.11.15 10:11,UNKNOWN,0,100,0,HDAC,WITHDRAWAL,,,,0,COMPLETED,0,sum-user-id,1707084.444,airdrop-20181115-hdac-sum-user-id-withdrawal,accac570-de75-11e8-bd11-2f9252c4dc2f,AIRDROP,0
airdrop-20181115-hdac-74e21824-5b29-4972-ac23-aa1134293e54-withdrawal-exchange,2018.11.15 10:11,UNKNOWN,,UNKNOWN-55c0f2b7-dc24-425b-9be8-6b86719f2865,2018.11.15 10:11,UNKNOWN,0,100,0,HDAC,WITHDRAWAL,,,,0,COMPLETED,0,sum-user-id,1706984.444,airdrop-20181115-hdac-sum-user-id-withdrawal,accac570-de75-11e8-bd11-2f9252c4dc2f,AIRDROP,0
airdrop-20181115-hdac-750de2f3-0168-405b-a465-6e4690409d18-withdrawal-exchange,2018.11.15 10:11,UNKNOWN,,UNKNOWN-55c0f2b7-dc24-425b-9be8-6b86719f2865,2018.11.15 10:11,UNKNOWN,0,100,0,HDAC,WITHDRAWAL,,,,0,COMPLETED,0,sum-user-id,1706884.444,airdrop-20181115-hdac-sum-user-id-withdrawal,accac570-de75-11e8-bd11-2f9252c4dc2f,AIRDROP,0
airdrop-20181115-hdac-7518a097-bf3b-41dd-b9ff-320c2b341455-withdrawal-exchange,2018.11.15 10:11,UNKNOWN,,UNKNOWN-55c0f2b7-dc24-425b-9be8-6b86719f2865,2018.11.15 10:11,UNKNOWN,0,100,0,HDAC,WITHDRAWAL,,,,0,COMPLETED,0,sum-user-id,1706784.444,airdrop-20181115-hdac-sum-user-id-withdrawal,accac570-de75-11e8-bd11-2f9252c4dc2f,AIRDROP,0
airdrop-20181115-hdac-752f9c17-22ff-4555-9b9c-a71377aee685-withdrawal-exchange,2018.11.15 10:11,UNKNOWN,,UNKNOWN-55c0f2b7-dc24-425b-9be8-6b86719f2865,2018.11.15 10:11,UNKNOWN,0,100,0,HDAC,WITHDRAWAL,,,,0,COMPLETED,0,sum-user-id,1706684.444,airdrop-20181115-hdac-sum-user-id-withdrawal,accac570-de75-11e8-bd11-2f9252c4dc2f,AIRDROP,0
airdrop-20181115-hdac-752fba1b-fb2b-4615-8d69-583210c38cb3-withdrawal-exchange,2018.11.15 10:11,UNKNOWN,,UNKNOWN-55c0f2b7-dc24-425b-9be8-6b86719f2865,2018.11.15 10:11,UNKNOWN,0,100,0,HDAC,WITHDRAWAL,,,,0,COMPLETED,0,sum-user-id,1706584.444,airdrop-20181115-hdac-sum-user-id-withdrawal,accac570-de75-11e8-bd11-2f9252c4dc2f,AIRDROP,0
airdrop-20181115-hdac-75343c52-7a85-4a48-b767-8d52e8e5bf9b-withdrawal-exchange,2018.11.15 10:11,UNKNOWN,,UNKNOWN-55c0f2b7-dc24-425b-9be8-6b86719f2865,2018.11.15 10:11,UNKNOWN,0,100,0,HDAC,WITHDRAWAL,,,,0,COMPLETED,0,sum-user-id,1706484.444,airdrop-20181115-hdac-sum-user-id-withdrawal,accac570-de75-11e8-bd11-2f9252c4dc2f,AIRDROP,0
airdrop-20181115-hdac-755376d0-3e15-48d2-b091-a1adc48dab97-withdrawal-exchange,2018.11.15 10:11,UNKNOWN,,UNKNOWN-55c0f2b7-dc24-425b-9be8-6b86719f2865,2018.11.15 10:11,UNKNOWN,0,100,0,HDAC,WITHDRAWAL,,,,0,COMPLETED,0,sum-user-id,1706384.444,airdrop-20181115-hdac-sum-user-id-withdrawal,accac570-de75-11e8-bd11-2f9252c4dc2f,AIRDROP,0
airdrop-20181115-hdac-755d9444-d2ce-48ee-99cf-0e287ba1828e-withdrawal-exchange,2018.11.15 10:11,UNKNOWN,,UNKNOWN-55c0f2b7-dc24-425b-9be8-6b86719f2865,2018.11.15 10:11,UNKNOWN,0,100,0,HDAC,WITHDRAWAL,,,,0,COMPLETED,0,sum-user-id,1706284.444,airdrop-20181115-hdac-sum-user-id-withdrawal,accac570-de75-11e8-bd11-2f9252c4dc2f,AIRDROP,0
airdrop-20181115-hdac-75a9bf88-72b2-45fd-a515-43b8572e0827-withdrawal-exchange,2018-11-15 10:11:43.014,UNKNOWN,,UNKNOWN-55c0f2b7-dc24-425b-9be8-6b86719f2865,2018-11-15 10:11:43.014,UNKNOWN,0,100,0,HDAC,WITHDRAWAL,,,,0,COMPLETED,0,sum-user-id,1706184.444,airdrop-20181115-hdac-sum-user-id-withdrawal,accac570-de75-11e8-bd11-2f9252c4dc2f,AIRDROP,0
airdrop-20181115-hdac-75f35688-0d0d-4678-b588-356fcc0d4d94-withdrawal-exchange,2018-11-15 10:11:43.049,UNKNOWN,,UNKNOWN-55c0f2b7-dc24-425b-9be8-6b86719f2865,2018-11-15 10:11:43.049,UNKNOWN,0,100,0,HDAC,WITHDRAWAL,,,,0,COMPLETED,0,sum-user-id,1706084.444,airdrop-20181115-hdac-sum-user-id-withdrawal,accac570-de75-11e8-bd11-2f9252c4dc2f,AIRDROP,0
airdrop-20181115-hdac-7611fcd4-25d3-4094-b6fc-8c463736cd66-withdrawal-exchange,2018-11-15 10:11:43.082,UNKNOWN,,UNKNOWN-55c0f2b7-dc24-425b-9be8-6b86719f2865,2018-11-15 10:11:43.082,UNKNOWN,0,100,0,HDAC,WITHDRAWAL,,,,0,COMPLETED,0,sum-user-id,1705984.444,airdrop-20181115-hdac-sum-user-id-withdrawal,accac570-de75-11e8-bd11-2f9252c4dc2f,AIRDROP,0
airdrop-20181115-hdac-7623ea7c-c12c-4956-bb1d-6aa7106f75e4-withdrawal-exchange,2018.11.15 10:11,UNKNOWN,,UNKNOWN-55c0f2b7-dc24-425b-9be8-6b86719f2865,2018.11.15 10:11,UNKNOWN,0,100,0,HDAC,WITHDRAWAL,,,,0,COMPLETED,0,sum-user-id,1705884.444,airdrop-20181115-hdac-sum-user-id-withdrawal,accac570-de75-11e8-bd11-2f9252c4dc2f,AIRDROP,0
airdrop-20181115-hdac-763bd183-4ff1-405f-b438-73269ca87ee2-withdrawal-exchange,2018.11.15 10:11,UNKNOWN,,UNKNOWN-55c0f2b7-dc24-425b-9be8-6b86719f2865,2018.11.15 10:11,UNKNOWN,0,100,0,HDAC,WITHDRAWAL,,,,0,COMPLETED,0,sum-user-id,1705784.444,airdrop-20181115-hdac-sum-user-id-withdrawal,accac570-de75-11e8-bd11-2f9252c4dc2f,AIRDROP,0
airdrop-20181115-hdac-76660ec3-d506-4b23-959c-6f649436ff4c-withdrawal-exchange,2018.11.15 10:11,UNKNOWN,,UNKNOWN-55c0f2b7-dc24-425b-9be8-6b86719f2865,2018.11.15 10:11,UNKNOWN,0,100,0,HDAC,WITHDRAWAL,,,,0,COMPLETED,0,sum-user-id,1705684.444,airdrop-20181115-hdac-sum-user-id-withdrawal,accac570-de75-11e8-bd11-2f9252c4dc2f,AIRDROP,0
airdrop-20181115-hdac-76864300-9759-480e-962f-62609ee92918-withdrawal-exchange,2018.11.15 10:11,UNKNOWN,,UNKNOWN-55c0f2b7-dc24-425b-9be8-6b86719f2865,2018.11.15 10:11,UNKNOWN,0,100,0,HDAC,WITHDRAWAL,,,,0,COMPLETED,0,sum-user-id,1705584.444,airdrop-20181115-hdac-sum-user-id-withdrawal,accac570-de75-11e8-bd11-2f9252c4dc2f,AIRDROP,0
airdrop-20181115-hdac-76907a88-80cf-4257-bffb-8bf520572557-withdrawal-exchange,2018.11.15 10:11,UNKNOWN,,UNKNOWN-55c0f2b7-dc24-425b-9be8-6b86719f2865,2018.11.15 10:11,UNKNOWN,0,100,0,HDAC,WITHDRAWAL,,,,0,COMPLETED,0,sum-user-id,1705484.444,airdrop-20181115-hdac-sum-user-id-withdrawal,accac570-de75-11e8-bd11-2f9252c4dc2f,AIRDROP,0
airdrop-20181115-hdac-769a228a-a6ed-47d1-a103-324276d803da-withdrawal-exchange,2018.11.15 10:11,UNKNOWN,,UNKNOWN-55c0f2b7-dc24-425b-9be8-6b86719f2865,2018.11.15 10:11,UNKNOWN,0,100,0,HDAC,WITHDRAWAL,,,,0,COMPLETED,0,sum-user-id,1705384.444,airdrop-20181115-hdac-sum-user-id-withdrawal,accac570-de75-11e8-bd11-2f9252c4dc2f,AIRDROP,0
airdrop-20181115-hdac-77377221-b662-44d2-91d4-31b1de1bcf17-withdrawal-exchange,2018.11.15 10:11,UNKNOWN,,UNKNOWN-55c0f2b7-dc24-425b-9be8-6b86719f2865,2018.11.15 10:11,UNKNOWN,0,100,0,HDAC,WITHDRAWAL,,,,0,COMPLETED,0,sum-user-id,1705284.444,airdrop-20181115-hdac-sum-user-id-withdrawal,accac570-de75-11e8-bd11-2f9252c4dc2f,AIRDROP,0
airdrop-20181115-hdac-773af967-6a60-4719-a5a9-c0b220e4ed8f-withdrawal-exchange,2018.11.15 10:11,UNKNOWN,,UNKNOWN-55c0f2b7-dc24-425b-9be8-6b86719f2865,2018.11.15 10:11,UNKNOWN,0,100,0,HDAC,WITHDRAWAL,,,,0,COMPLETED,0,sum-user-id,1705184.444,airdrop-20181115-hdac-sum-user-id-withdrawal,accac570-de75-11e8-bd11-2f9252c4dc2f,AIRDROP,0
airdrop-20181115-hdac-773cd3fa-e201-4aca-abbe-6d26f0114899-withdrawal-exchange,2018.11.15 10:11,UNKNOWN,,UNKNOWN-55c0f2b7-dc24-425b-9be8-6b86719f2865,2018.11.15 10:11,UNKNOWN,0,148.074074,0,HDAC,WITHDRAWAL,,,,0,COMPLETED,0,sum-user-id,1705036.37,airdrop-20181115-hdac-sum-user-id-withdrawal,accac570-de75-11e8-bd11-2f9252c4dc2f,AIRDROP,0
airdrop-20181115-hdac-774b3a43-c165-4c7f-806b-bd585c36bb2b-withdrawal-exchange,2018.11.15 10:11,UNKNOWN,,UNKNOWN-55c0f2b7-dc24-425b-9be8-6b86719f2865,2018.11.15 10:11,UNKNOWN,0,270.314556,0,HDAC,WITHDRAWAL,,,,0,COMPLETED,0,sum-user-id,1704766.056,airdrop-20181115-hdac-sum-user-id-withdrawal,accac570-de75-11e8-bd11-2f9252c4dc2f,AIRDROP,0
airdrop-20181115-hdac-77671ab4-29be-4b4e-8249-5a2bce355d93-withdrawal-exchange,2018.11.15 10:11,UNKNOWN,,UNKNOWN-55c0f2b7-dc24-425b-9be8-6b86719f2865,2018.11.15 10:11,UNKNOWN,0,100,0,HDAC,WITHDRAWAL,,,,0,COMPLETED,0,sum-user-id,1704666.056,airdrop-20181115-hdac-sum-user-id-withdrawal,accac570-de75-11e8-bd11-2f9252c4dc2f,AIRDROP,0
airdrop-20181115-hdac-778c3293-dc05-44f3-b21e-8aa6747128b0-withdrawal-exchange,2018.11.15 10:11,UNKNOWN,,UNKNOWN-55c0f2b7-dc24-425b-9be8-6b86719f2865,2018.11.15 10:11,UNKNOWN,0,100,0,HDAC,WITHDRAWAL,,,,0,COMPLETED,0,sum-user-id,1704566.056,airdrop-20181115-hdac-sum-user-id-withdrawal,accac570-de75-11e8-bd11-2f9252c4dc2f,AIRDROP,0
airdrop-20181115-hdac-77914784-f476-4f90-959b-11d46cd8444a-withdrawal-exchange,2018.11.15 10:11,UNKNOWN,,UNKNOWN-55c0f2b7-dc24-425b-9be8-6b86719f2865,2018.11.15 10:11,UNKNOWN,0,100,0,HDAC,WITHDRAWAL,,,,0,COMPLETED,0,sum-user-id,1704466.056,airdrop-20181115-hdac-sum-user-id-withdrawal,accac570-de75-11e8-bd11-2f9252c4dc2f,AIRDROP,0
airdrop-20181115-hdac-779d856d-abd5-4e0a-9833-aa0b381d94cd-withdrawal-exchange,2018.11.15 10:11,UNKNOWN,,UNKNOWN-55c0f2b7-dc24-425b-9be8-6b86719f2865,2018.11.15 10:11,UNKNOWN,0,100,0,HDAC,WITHDRAWAL,,,,0,COMPLETED,0,sum-user-id,1704366.056,airdrop-20181115-hdac-sum-user-id-withdrawal,accac570-de75-11e8-bd11-2f9252c4dc2f,AIRDROP,0
airdrop-20181115-hdac-78133c18-0586-416f-a76c-f1d796af10bb-withdrawal-exchange,2018.11.15 10:11,UNKNOWN,,UNKNOWN-55c0f2b7-dc24-425b-9be8-6b86719f2865,2018.11.15 10:11,UNKNOWN,0,100,0,HDAC,WITHDRAWAL,,,,0,COMPLETED,0,sum-user-id,1704266.056,airdrop-20181115-hdac-sum-user-id-withdrawal,accac570-de75-11e8-bd11-2f9252c4dc2f,AIRDROP,0
airdrop-20181115-hdac-7844118a-4b4f-4825-b27e-c3200e1afd8e-withdrawal-exchange,2018.11.15 10:11,UNKNOWN,,UNKNOWN-55c0f2b7-dc24-425b-9be8-6b86719f2865,2018.11.15 10:11,UNKNOWN,0,100,0,HDAC,WITHDRAWAL,,,,0,COMPLETED,0,sum-user-id,1704166.056,airdrop-20181115-hdac-sum-user-id-withdrawal,accac570-de75-11e8-bd11-2f9252c4dc2f,AIRDROP,0
airdrop-20181115-hdac-784f838b-a6c8-4de9-bd4e-48a691296fd4-withdrawal-exchange,2018.11.15 10:11,UNKNOWN,,UNKNOWN-55c0f2b7-dc24-425b-9be8-6b86719f2865,2018.11.15 10:11,UNKNOWN,0,100,0,HDAC,WITHDRAWAL,,,,0,COMPLETED,0,sum-user-id,1704066.056,airdrop-20181115-hdac-sum-user-id-withdrawal,accac570-de75-11e8-bd11-2f9252c4dc2f,AIRDROP,0
airdrop-20181115-hdac-785bd7a5-ad31-4946-84f8-699673f2ea33-withdrawal-exchange,2018.11.15 10:11,UNKNOWN,,UNKNOWN-55c0f2b7-dc24-425b-9be8-6b86719f2865,2018.11.15 10:11,UNKNOWN,0,100,0,HDAC,WITHDRAWAL,,,,0,COMPLETED,0,sum-user-id,1703966.056,airdrop-20181115-hdac-sum-user-id-withdrawal,accac570-de75-11e8-bd11-2f9252c4dc2f,AIRDROP,0
airdrop-20181115-hdac-78de830e-ec2c-4727-b895-5f1bcde5da20-withdrawal-exchange,2018.11.15 10:11,UNKNOWN,,UNKNOWN-55c0f2b7-dc24-425b-9be8-6b86719f2865,2018.11.15 10:11,UNKNOWN,0,100,0,HDAC,WITHDRAWAL,,,,0,COMPLETED,0,sum-user-id,1703866.056,airdrop-20181115-hdac-sum-user-id-withdrawal,accac570-de75-11e8-bd11-2f9252c4dc2f,AIRDROP,0
airdrop-20181115-hdac-78e582ce-6fb9-4536-998e-c87940250d17-withdrawal-exchange,2018.11.15 10:11,UNKNOWN,,UNKNOWN-55c0f2b7-dc24-425b-9be8-6b86719f2865,2018.11.15 10:11,UNKNOWN,0,100,0,HDAC,WITHDRAWAL,,,,0,COMPLETED,0,sum-user-id,1703766.056,airdrop-20181115-hdac-sum-user-id-withdrawal,accac570-de75-11e8-bd11-2f9252c4dc2f,AIRDROP,0
airdrop-20181115-hdac-78ed060c-c56e-4bf9-a4fa-09cec09e644f-withdrawal-exchange,2018.11.15 10:11,UNKNOWN,,UNKNOWN-55c0f2b7-dc24-425b-9be8-6b86719f2865,2018.11.15 10:11,UNKNOWN,0,100,0,HDAC,WITHDRAWAL,,,,0,COMPLETED,0,sum-user-id,1703666.056,airdrop-20181115-hdac-sum-user-id-withdrawal,accac570-de75-11e8-bd11-2f9252c4dc2f,AIRDROP,0
airdrop-20181115-hdac-78f0079a-5721-4680-85bb-82726b3bede3-withdrawal-exchange,2018.11.15 10:11,UNKNOWN,,UNKNOWN-55c0f2b7-dc24-425b-9be8-6b86719f2865,2018.11.15 10:11,UNKNOWN,0,100,0,HDAC,WITHDRAWAL,,,,0,COMPLETED,0,sum-user-id,1703566.056,airdrop-20181115-hdac-sum-user-id-withdrawal,accac570-de75-11e8-bd11-2f9252c4dc2f,AIRDROP,0
airdrop-20181115-hdac-78f7b38d-74e5-440b-975e-c6a639aab156-withdrawal-exchange,2018.11.15 10:11,UNKNOWN,,UNKNOWN-55c0f2b7-dc24-425b-9be8-6b86719f2865,2018.11.15 10:11,UNKNOWN,0,100,0,HDAC,WITHDRAWAL,,,,0,COMPLETED,0,sum-user-id,1703466.056,airdrop-20181115-hdac-sum-user-id-withdrawal,accac570-de75-11e8-bd11-2f9252c4dc2f,AIRDROP,0
airdrop-20181115-hdac-79073fd9-e01b-495c-820b-c534001f92e2-withdrawal-exchange,2018.11.15 10:11,UNKNOWN,,UNKNOWN-55c0f2b7-dc24-425b-9be8-6b86719f2865,2018.11.15 10:11,UNKNOWN,0,100,0,HDAC,WITHDRAWAL,,,,0,COMPLETED,0,sum-user-id,1703366.056,airdrop-20181115-hdac-sum-user-id-withdrawal,accac570-de75-11e8-bd11-2f9252c4dc2f,AIRDROP,0
airdrop-20181115-hdac-790bd092-4536-4f46-880f-9627856712fe-withdrawal-exchange,2018.11.15 10:11,UNKNOWN,,UNKNOWN-55c0f2b7-dc24-425b-9be8-6b86719f2865,2018.11.15 10:11,UNKNOWN,0,100,0,HDAC,WITHDRAWAL,,,,0,COMPLETED,0,sum-user-id,1703266.056,airdrop-20181115-hdac-sum-user-id-withdrawal,accac570-de75-11e8-bd11-2f9252c4dc2f,AIRDROP,0
airdrop-20181115-hdac-7926f416-400c-4f68-9cfc-335e604a2f92-withdrawal-exchange,2018.11.15 10:11,UNKNOWN,,UNKNOWN-55c0f2b7-dc24-425b-9be8-6b86719f2865,2018.11.15 10:11,UNKNOWN,0,100,0,HDAC,WITHDRAWAL,,,,0,COMPLETED,0,sum-user-id,1703166.056,airdrop-20181115-hdac-sum-user-id-withdrawal,accac570-de75-11e8-bd11-2f9252c4dc2f,AIRDROP,0
airdrop-20181115-hdac-7934698e-f4e3-41af-a824-dd9db0a7e0b2-withdrawal-exchange,2018-11-15 10:11:44.015,UNKNOWN,,UNKNOWN-55c0f2b7-dc24-425b-9be8-6b86719f2865,2018-11-15 10:11:44.015,UNKNOWN,0,100,0,HDAC,WITHDRAWAL,,,,0,COMPLETED,0,sum-user-id,1703066.056,airdrop-20181115-hdac-sum-user-id-withdrawal,accac570-de75-11e8-bd11-2f9252c4dc2f,AIRDROP,0
airdrop-20181115-hdac-79dc2066-8251-49b1-aa73-dc5aed09a75e-withdrawal-exchange,2018-11-15 10:11:44.047,UNKNOWN,,UNKNOWN-55c0f2b7-dc24-425b-9be8-6b86719f2865,2018-11-15 10:11:44.047,UNKNOWN,0,100,0,HDAC,WITHDRAWAL,,,,0,COMPLETED,0,sum-user-id,1702966.056,airdrop-20181115-hdac-sum-user-id-withdrawal,accac570-de75-11e8-bd11-2f9252c4dc2f,AIRDROP,0
airdrop-20181115-hdac-79e79039-8dfc-4974-8b96-ae3fca4f8b3f-withdrawal-exchange,2018-11-15 10:11:44.084,UNKNOWN,,UNKNOWN-55c0f2b7-dc24-425b-9be8-6b86719f2865,2018-11-15 10:11:44.084,UNKNOWN,0,100,0,HDAC,WITHDRAWAL,,,,0,COMPLETED,0,sum-user-id,1702866.056,airdrop-20181115-hdac-sum-user-id-withdrawal,accac570-de75-11e8-bd11-2f9252c4dc2f,AIRDROP,0
airdrop-20181115-hdac-79ed6298-f07a-44d1-b1fa-a54fb3d12e6a-withdrawal-exchange,2018.11.15 10:11,UNKNOWN,,UNKNOWN-55c0f2b7-dc24-425b-9be8-6b86719f2865,2018.11.15 10:11,UNKNOWN,0,100,0,HDAC,WITHDRAWAL,,,,0,COMPLETED,0,sum-user-id,1702766.056,airdrop-20181115-hdac-sum-user-id-withdrawal,accac570-de75-11e8-bd11-2f9252c4dc2f,AIRDROP,0
airdrop-20181115-hdac-79f2d65c-79e3-4b29-adc6-df1797feab67-withdrawal-exchange,2018.11.15 10:11,UNKNOWN,,UNKNOWN-55c0f2b7-dc24-425b-9be8-6b86719f2865,2018.11.15 10:11,UNKNOWN,0,100,0,HDAC,WITHDRAWAL,,,,0,COMPLETED,0,sum-user-id,1702666.056,airdrop-20181115-hdac-sum-user-id-withdrawal,accac570-de75-11e8-bd11-2f9252c4dc2f,AIRDROP,0
airdrop-20181115-hdac-79fb48a9-258b-4c7f-8f51-83be592f8055-withdrawal-exchange,2018.11.15 10:11,UNKNOWN,,UNKNOWN-55c0f2b7-dc24-425b-9be8-6b86719f2865,2018.11.15 10:11,UNKNOWN,0,100,0,HDAC,WITHDRAWAL,,,,0,COMPLETED,0,sum-user-id,1702566.056,airdrop-20181115-hdac-sum-user-id-withdrawal,accac570-de75-11e8-bd11-2f9252c4dc2f,AIRDROP,0
airdrop-20181115-hdac-79fbf466-814a-4628-8aca-2c0ed343c0bd-withdrawal-exchange,2018.11.15 10:11,UNKNOWN,,UNKNOWN-55c0f2b7-dc24-425b-9be8-6b86719f2865,2018.11.15 10:11,UNKNOWN,0,100,0,HDAC,WITHDRAWAL,,,,0,COMPLETED,0,sum-user-id,1702466.056,airdrop-20181115-hdac-sum-user-id-withdrawal,accac570-de75-11e8-bd11-2f9252c4dc2f,AIRDROP,0
airdrop-20181115-hdac-79fc8e9b-226f-4549-a473-1738295e67c1-withdrawal-exchange,2018.11.15 10:11,UNKNOWN,,UNKNOWN-55c0f2b7-dc24-425b-9be8-6b86719f2865,2018.11.15 10:11,UNKNOWN,0,100,0,HDAC,WITHDRAWAL,,,,0,COMPLETED,0,sum-user-id,1702366.056,airdrop-20181115-hdac-sum-user-id-withdrawal,accac570-de75-11e8-bd11-2f9252c4dc2f,AIRDROP,0
airdrop-20181115-hdac-7a0183ca-fb12-4ecf-8d08-10591fb9e9b1-withdrawal-exchange,2018.11.15 10:11,UNKNOWN,,UNKNOWN-55c0f2b7-dc24-425b-9be8-6b86719f2865,2018.11.15 10:11,UNKNOWN,0,100,0,HDAC,WITHDRAWAL,,,,0,COMPLETED,0,sum-user-id,1702266.056,airdrop-20181115-hdac-sum-user-id-withdrawal,accac570-de75-11e8-bd11-2f9252c4dc2f,AIRDROP,0
airdrop-20181115-hdac-7a3f67d3-5787-46d9-a32b-8262e7f775cd-withdrawal-exchange,2018.11.15 10:11,UNKNOWN,,UNKNOWN-55c0f2b7-dc24-425b-9be8-6b86719f2865,2018.11.15 10:11,UNKNOWN,0,100,0,HDAC,WITHDRAWAL,,,,0,COMPLETED,0,sum-user-id,1702166.056,airdrop-20181115-hdac-sum-user-id-withdrawal,accac570-de75-11e8-bd11-2f9252c4dc2f,AIRDROP,0
airdrop-20181115-hdac-7ae26900-bb25-48e2-a3e6-259cc293043f-withdrawal-exchange,2018.11.15 10:11,UNKNOWN,,UNKNOWN-55c0f2b7-dc24-425b-9be8-6b86719f2865,2018.11.15 10:11,UNKNOWN,0,100,0,HDAC,WITHDRAWAL,,,,0,COMPLETED,0,sum-user-id,1702066.056,airdrop-20181115-hdac-sum-user-id-withdrawal,accac570-de75-11e8-bd11-2f9252c4dc2f,AIRDROP,0
airdrop-20181115-hdac-7afd1d47-ad0b-4692-8529-c4194a248ded-withdrawal-exchange,2018.11.15 10:11,UNKNOWN,,UNKNOWN-55c0f2b7-dc24-425b-9be8-6b86719f2865,2018.11.15 10:11,UNKNOWN,0,100,0,HDAC,WITHDRAWAL,,,,0,COMPLETED,0,sum-user-id,1701966.056,airdrop-20181115-hdac-sum-user-id-withdrawal,accac570-de75-11e8-bd11-2f9252c4dc2f,AIRDROP,0
airdrop-20181115-hdac-7b159f4e-3dd0-4e1d-863a-5594cc746ece-withdrawal-exchange,2018.11.15 10:11,UNKNOWN,,UNKNOWN-55c0f2b7-dc24-425b-9be8-6b86719f2865,2018.11.15 10:11,UNKNOWN,0,100,0,HDAC,WITHDRAWAL,,,,0,COMPLETED,0,sum-user-id,1701866.056,airdrop-20181115-hdac-sum-user-id-withdrawal,accac570-de75-11e8-bd11-2f9252c4dc2f,AIRDROP,0
airdrop-20181115-hdac-7b18d619-c441-44b8-adc3-949187e785a3-withdrawal-exchange,2018.11.15 10:11,UNKNOWN,,UNKNOWN-55c0f2b7-dc24-425b-9be8-6b86719f2865,2018.11.15 10:11,UNKNOWN,0,100,0,HDAC,WITHDRAWAL,,,,0,COMPLETED,0,sum-user-id,1701766.056,airdrop-20181115-hdac-sum-user-id-withdrawal,accac570-de75-11e8-bd11-2f9252c4dc2f,AIRDROP,0
airdrop-20181115-hdac-7b4ec466-acf8-4947-8e0a-7af6a65873a7-withdrawal-exchange,2018.11.15 10:11,UNKNOWN,,UNKNOWN-55c0f2b7-dc24-425b-9be8-6b86719f2865,2018.11.15 10:11,UNKNOWN,0,100,0,HDAC,WITHDRAWAL,,,,0,COMPLETED,0,sum-user-id,1701666.056,airdrop-20181115-hdac-sum-user-id-withdrawal,accac570-de75-11e8-bd11-2f9252c4dc2f,AIRDROP,0
airdrop-20181115-hdac-7b5a347d-c276-4efb-8367-f7549f07b129-withdrawal-exchange,2018.11.15 10:11,UNKNOWN,,UNKNOWN-55c0f2b7-dc24-425b-9be8-6b86719f2865,2018.11.15 10:11,UNKNOWN,0,100,0,HDAC,WITHDRAWAL,,,,0,COMPLETED,0,sum-user-id,1701566.056,airdrop-20181115-hdac-sum-user-id-withdrawal,accac570-de75-11e8-bd11-2f9252c4dc2f,AIRDROP,0
airdrop-20181115-hdac-7b6318ec-db7e-4fb4-9224-dd5a985f6c44-withdrawal-exchange,2018.11.15 10:11,UNKNOWN,,UNKNOWN-55c0f2b7-dc24-425b-9be8-6b86719f2865,2018.11.15 10:11,UNKNOWN,0,100,0,HDAC,WITHDRAWAL,,,,0,COMPLETED,0,sum-user-id,1701466.056,airdrop-20181115-hdac-sum-user-id-withdrawal,accac570-de75-11e8-bd11-2f9252c4dc2f,AIRDROP,0
airdrop-20181115-hdac-7b67c949-b115-4c9f-a226-6084cdd5bbef-withdrawal-exchange,2018.11.15 10:11,UNKNOWN,,UNKNOWN-55c0f2b7-dc24-425b-9be8-6b86719f2865,2018.11.15 10:11,UNKNOWN,0,100,0,HDAC,WITHDRAWAL,,,,0,COMPLETED,0,sum-user-id,1701366.056,airdrop-20181115-hdac-sum-user-id-withdrawal,accac570-de75-11e8-bd11-2f9252c4dc2f,AIRDROP,0
airdrop-20181115-hdac-7b6bcf12-fd47-4ab8-aac8-fe8164dd4319-withdrawal-exchange,2018.11.15 10:11,UNKNOWN,,UNKNOWN-55c0f2b7-dc24-425b-9be8-6b86719f2865,2018.11.15 10:11,UNKNOWN,0,100,0,HDAC,WITHDRAWAL,,,,0,COMPLETED,0,sum-user-id,1701266.056,airdrop-20181115-hdac-sum-user-id-withdrawal,accac570-de75-11e8-bd11-2f9252c4dc2f,AIRDROP,0
airdrop-20181115-hdac-7b797e1c-7cfe-4bea-a7f7-7f3c4c0fa0ee-withdrawal-exchange,2018.11.15 10:11,UNKNOWN,,UNKNOWN-55c0f2b7-dc24-425b-9be8-6b86719f2865,2018.11.15 10:11,UNKNOWN,0,100,0,HDAC,WITHDRAWAL,,,,0,COMPLETED,0,sum-user-id,1701166.056,airdrop-20181115-hdac-sum-user-id-withdrawal,accac570-de75-11e8-bd11-2f9252c4dc2f,AIRDROP,0
airdrop-20181115-hdac-7ba62af7-360a-481f-90bd-4738004574c3-withdrawal-exchange,2018.11.15 10:11,UNKNOWN,,UNKNOWN-55c0f2b7-dc24-425b-9be8-6b86719f2865,2018.11.15 10:11,UNKNOWN,0,100,0,HDAC,WITHDRAWAL,,,,0,COMPLETED,0,sum-user-id,1701066.056,airdrop-20181115-hdac-sum-user-id-withdrawal,accac570-de75-11e8-bd11-2f9252c4dc2f,AIRDROP,0
airdrop-20181115-hdac-7bc27afd-878d-4147-afbd-98a51fa11748-withdrawal-exchange,2018.11.15 10:11,UNKNOWN,,UNKNOWN-55c0f2b7-dc24-425b-9be8-6b86719f2865,2018.11.15 10:11,UNKNOWN,0,100,0,HDAC,WITHDRAWAL,,,,0,COMPLETED,0,sum-user-id,1700966.056,airdrop-20181115-hdac-sum-user-id-withdrawal,accac570-de75-11e8-bd11-2f9252c4dc2f,AIRDROP,0
airdrop-20181115-hdac-7bcd9902-f394-4a5d-9c8d-11977ec436d1-withdrawal-exchange,2018.11.15 10:11,UNKNOWN,,UNKNOWN-55c0f2b7-dc24-425b-9be8-6b86719f2865,2018.11.15 10:11,UNKNOWN,0,100,0,HDAC,WITHDRAWAL,,,,0,COMPLETED,0,sum-user-id,1700866.056,airdrop-20181115-hdac-sum-user-id-withdrawal,accac570-de75-11e8-bd11-2f9252c4dc2f,AIRDROP,0
airdrop-20181115-hdac-7c1d1429-ad19-4f68-b4c9-2f202bfb1109-withdrawal-exchange,2018.11.15 10:11,UNKNOWN,,UNKNOWN-55c0f2b7-dc24-425b-9be8-6b86719f2865,2018.11.15 10:11,UNKNOWN,0,100,0,HDAC,WITHDRAWAL,,,,0,COMPLETED,0,sum-user-id,1700766.056,airdrop-20181115-hdac-sum-user-id-withdrawal,accac570-de75-11e8-bd11-2f9252c4dc2f,AIRDROP,0
airdrop-20181115-hdac-7c4fc844-31a5-4427-9f0d-d7f13e90693e-withdrawal-exchange,2018.11.15 10:11,UNKNOWN,,UNKNOWN-55c0f2b7-dc24-425b-9be8-6b86719f2865,2018.11.15 10:11,UNKNOWN,0,100,0,HDAC,WITHDRAWAL,,,,0,COMPLETED,0,sum-user-id,1700666.056,airdrop-20181115-hdac-sum-user-id-withdrawal,accac570-de75-11e8-bd11-2f9252c4dc2f,AIRDROP,0
airdrop-20181115-hdac-7c579022-7402-49ce-8934-cb729412477e-withdrawal-exchange,2018.11.15 10:11,UNKNOWN,,UNKNOWN-55c0f2b7-dc24-425b-9be8-6b86719f2865,2018.11.15 10:11,UNKNOWN,0,100,0,HDAC,WITHDRAWAL,,,,0,COMPLETED,0,sum-user-id,1700566.056,airdrop-20181115-hdac-sum-user-id-withdrawal,accac570-de75-11e8-bd11-2f9252c4dc2f,AIRDROP,0
airdrop-20181115-hdac-7c61c765-a8ce-447e-ad18-cd9cb04ae3eb-withdrawal-exchange,2018.11.15 10:11,UNKNOWN,,UNKNOWN-55c0f2b7-dc24-425b-9be8-6b86719f2865,2018.11.15 10:11,UNKNOWN,0,100,0,HDAC,WITHDRAWAL,,,,0,COMPLETED,0,sum-user-id,1700466.056,airdrop-20181115-hdac-sum-user-id-withdrawal,accac570-de75-11e8-bd11-2f9252c4dc2f,AIRDROP,0
airdrop-20181115-hdac-7caada79-b1d9-45da-9b94-7a8c094f75c6-withdrawal-exchange,2018.11.15 10:11,UNKNOWN,,UNKNOWN-55c0f2b7-dc24-425b-9be8-6b86719f2865,2018.11.15 10:11,UNKNOWN,0,100,0,HDAC,WITHDRAWAL,,,,0,COMPLETED,0,sum-user-id,1700366.056,airdrop-20181115-hdac-sum-user-id-withdrawal,accac570-de75-11e8-bd11-2f9252c4dc2f,AIRDROP,0
airdrop-20181115-hdac-7cb65e9b-1d87-46b4-a477-4a35cb0236de-withdrawal-exchange,2018.11.15 10:11,UNKNOWN,,UNKNOWN-55c0f2b7-dc24-425b-9be8-6b86719f2865,2018.11.15 10:11,UNKNOWN,0,100,0,HDAC,WITHDRAWAL,,,,0,COMPLETED,0,sum-user-id,1700266.056,airdrop-20181115-hdac-sum-user-id-withdrawal,accac570-de75-11e8-bd11-2f9252c4dc2f,AIRDROP,0
airdrop-20181115-hdac-7cc736d4-45b5-42e5-b16c-d910c9df7fff-withdrawal-exchange,2018.11.15 10:11,UNKNOWN,,UNKNOWN-55c0f2b7-dc24-425b-9be8-6b86719f2865,2018.11.15 10:11,UNKNOWN,0,100,0,HDAC,WITHDRAWAL,,,,0,COMPLETED,0,sum-user-id,1700166.056,airdrop-20181115-hdac-sum-user-id-withdrawal,accac570-de75-11e8-bd11-2f9252c4dc2f,AIRDROP,0
airdrop-20181115-hdac-7cebacc7-5db7-4ba5-b99a-15b8edae600b-withdrawal-exchange,2018.11.15 10:11,UNKNOWN,,UNKNOWN-55c0f2b7-dc24-425b-9be8-6b86719f2865,2018.11.15 10:11,UNKNOWN,0,100,0,HDAC,WITHDRAWAL,,,,0,COMPLETED,0,sum-user-id,1700066.056,airdrop-20181115-hdac-sum-user-id-withdrawal,accac570-de75-11e8-bd11-2f9252c4dc2f,AIRDROP,0
airdrop-20181115-hdac-7cfe081c-5314-4550-b8a3-211dbe07a9d7-withdrawal-exchange,2018-11-15 10:11:45.015,UNKNOWN,,UNKNOWN-55c0f2b7-dc24-425b-9be8-6b86719f2865,2018-11-15 10:11:45.015,UNKNOWN,0,100,0,HDAC,WITHDRAWAL,,,,0,COMPLETED,0,sum-user-id,1699966.056,airdrop-20181115-hdac-sum-user-id-withdrawal,accac570-de75-11e8-bd11-2f9252c4dc2f,AIRDROP,0
airdrop-20181115-hdac-7d01b3d7-5082-4cf4-9b2e-7e160003d3a7-withdrawal-exchange,2018-11-15 10:11:45.047,UNKNOWN,,UNKNOWN-55c0f2b7-dc24-425b-9be8-6b86719f2865,2018-11-15 10:11:45.047,UNKNOWN,0,100,0,HDAC,WITHDRAWAL,,,,0,COMPLETED,0,sum-user-id,1699866.056,airdrop-20181115-hdac-sum-user-id-withdrawal,accac570-de75-11e8-bd11-2f9252c4dc2f,AIRDROP,0
airdrop-20181115-hdac-7d0f32de-464d-4a47-957b-2c8a8db86067-withdrawal-exchange,2018-11-15 10:11:45.081,UNKNOWN,,UNKNOWN-55c0f2b7-dc24-425b-9be8-6b86719f2865,2018-11-15 10:11:45.081,UNKNOWN,0,100,0,HDAC,WITHDRAWAL,,,,0,COMPLETED,0,sum-user-id,1699766.056,airdrop-20181115-hdac-sum-user-id-withdrawal,accac570-de75-11e8-bd11-2f9252c4dc2f,AIRDROP,0
airdrop-20181115-hdac-7d14666d-ac39-4324-8624-b1c68b9b361a-withdrawal-exchange,2018.11.15 10:11,UNKNOWN,,UNKNOWN-55c0f2b7-dc24-425b-9be8-6b86719f2865,2018.11.15 10:11,UNKNOWN,0,100,0,HDAC,WITHDRAWAL,,,,0,COMPLETED,0,sum-user-id,1699666.056,airdrop-20181115-hdac-sum-user-id-withdrawal,accac570-de75-11e8-bd11-2f9252c4dc2f,AIRDROP,0
airdrop-20181115-hdac-7d16baf9-346f-45c3-a263-ba2e277ee8f8-withdrawal-exchange,2018.11.15 10:11,UNKNOWN,,UNKNOWN-55c0f2b7-dc24-425b-9be8-6b86719f2865,2018.11.15 10:11,UNKNOWN,0,100,0,HDAC,WITHDRAWAL,,,,0,COMPLETED,0,sum-user-id,1699566.056,airdrop-20181115-hdac-sum-user-id-withdrawal,accac570-de75-11e8-bd11-2f9252c4dc2f,AIRDROP,0
airdrop-20181115-hdac-7d1d4431-425d-4704-b037-d8b9d7870dd7-withdrawal-exchange,2018.11.15 10:11,UNKNOWN,,UNKNOWN-55c0f2b7-dc24-425b-9be8-6b86719f2865,2018.11.15 10:11,UNKNOWN,0,100,0,HDAC,WITHDRAWAL,,,,0,COMPLETED,0,sum-user-id,1699466.056,airdrop-20181115-hdac-sum-user-id-withdrawal,accac570-de75-11e8-bd11-2f9252c4dc2f,AIRDROP,0
airdrop-20181115-hdac-7d3603a1-e5ce-4fd1-8723-7bd295eec93d-withdrawal-exchange,2018.11.15 10:11,UNKNOWN,,UNKNOWN-55c0f2b7-dc24-425b-9be8-6b86719f2865,2018.11.15 10:11,UNKNOWN,0,100,0,HDAC,WITHDRAWAL,,,,0,COMPLETED,0,sum-user-id,1699366.056,airdrop-20181115-hdac-sum-user-id-withdrawal,accac570-de75-11e8-bd11-2f9252c4dc2f,AIRDROP,0
airdrop-20181115-hdac-7d3dac23-433a-4f26-bbb8-c8cc82cb0068-withdrawal-exchange,2018.11.15 10:11,UNKNOWN,,UNKNOWN-55c0f2b7-dc24-425b-9be8-6b86719f2865,2018.11.15 10:11,UNKNOWN,0,100,0,HDAC,WITHDRAWAL,,,,0,COMPLETED,0,sum-user-id,1699266.056,airdrop-20181115-hdac-sum-user-id-withdrawal,accac570-de75-11e8-bd11-2f9252c4dc2f,AIRDROP,0
airdrop-20181115-hdac-7d60648d-d41f-410a-a7f4-5a835b526aa0-withdrawal-exchange,2018.11.15 10:11,UNKNOWN,,UNKNOWN-55c0f2b7-dc24-425b-9be8-6b86719f2865,2018.11.15 10:11,UNKNOWN,0,100,0,HDAC,WITHDRAWAL,,,,0,COMPLETED,0,sum-user-id,1699166.056,airdrop-20181115-hdac-sum-user-id-withdrawal,accac570-de75-11e8-bd11-2f9252c4dc2f,AIRDROP,0
airdrop-20181115-hdac-7d7e7823-13ea-4eb7-a2db-2774b1644dc9-withdrawal-exchange,2018.11.15 10:11,UNKNOWN,,UNKNOWN-55c0f2b7-dc24-425b-9be8-6b86719f2865,2018.11.15 10:11,UNKNOWN,0,100,0,HDAC,WITHDRAWAL,,,,0,COMPLETED,0,sum-user-id,1699066.056,airdrop-20181115-hdac-sum-user-id-withdrawal,accac570-de75-11e8-bd11-2f9252c4dc2f,AIRDROP,0
airdrop-20181115-hdac-7d9a5841-6b04-4413-878e-c2052dd967f8-withdrawal-exchange,2018.11.15 10:11,UNKNOWN,,UNKNOWN-55c0f2b7-dc24-425b-9be8-6b86719f2865,2018.11.15 10:11,UNKNOWN,0,100,0,HDAC,WITHDRAWAL,,,,0,COMPLETED,0,sum-user-id,1698966.056,airdrop-20181115-hdac-sum-user-id-withdrawal,accac570-de75-11e8-bd11-2f9252c4dc2f,AIRDROP,0
airdrop-20181115-hdac-7d9e49f4-f4e9-48ec-9065-927ea44d06f6-withdrawal-exchange,2018.11.15 10:11,UNKNOWN,,UNKNOWN-55c0f2b7-dc24-425b-9be8-6b86719f2865,2018.11.15 10:11,UNKNOWN,0,100,0,HDAC,WITHDRAWAL,,,,0,COMPLETED,0,sum-user-id,1698866.056,airdrop-20181115-hdac-sum-user-id-withdrawal,accac570-de75-11e8-bd11-2f9252c4dc2f,AIRDROP,0
airdrop-20181115-hdac-7da5215b-a01c-4201-8d68-0f7fb1290862-withdrawal-exchange,2018.11.15 10:11,UNKNOWN,,UNKNOWN-55c0f2b7-dc24-425b-9be8-6b86719f2865,2018.11.15 10:11,UNKNOWN,0,100,0,HDAC,WITHDRAWAL,,,,0,COMPLETED,0,sum-user-id,1698766.056,airdrop-20181115-hdac-sum-user-id-withdrawal,accac570-de75-11e8-bd11-2f9252c4dc2f,AIRDROP,0
airdrop-20181115-hdac-7dc19b20-254b-4a4e-927c-21f000a072ef-withdrawal-exchange,2018.11.15 10:11,UNKNOWN,,UNKNOWN-55c0f2b7-dc24-425b-9be8-6b86719f2865,2018.11.15 10:11,UNKNOWN,0,100,0,HDAC,WITHDRAWAL,,,,0,COMPLETED,0,sum-user-id,1698666.056,airdrop-20181115-hdac-sum-user-id-withdrawal,accac570-de75-11e8-bd11-2f9252c4dc2f,AIRDROP,0
airdrop-20181115-hdac-7dddbfa4-48e2-401e-890e-5e6d5763c668-withdrawal-exchange,2018.11.15 10:11,UNKNOWN,,UNKNOWN-55c0f2b7-dc24-425b-9be8-6b86719f2865,2018.11.15 10:11,UNKNOWN,0,100,0,HDAC,WITHDRAWAL,,,,0,COMPLETED,0,sum-user-id,1698566.056,airdrop-20181115-hdac-sum-user-id-withdrawal,accac570-de75-11e8-bd11-2f9252c4dc2f,AIRDROP,0
airdrop-20181115-hdac-7e0096b1-8dab-4fb4-8edd-a9b6c1294256-withdrawal-exchange,2018.11.15 10:11,UNKNOWN,,UNKNOWN-55c0f2b7-dc24-425b-9be8-6b86719f2865,2018.11.15 10:11,UNKNOWN,0,100,0,HDAC,WITHDRAWAL,,,,0,COMPLETED,0,sum-user-id,1698466.056,airdrop-20181115-hdac-sum-user-id-withdrawal,accac570-de75-11e8-bd11-2f9252c4dc2f,AIRDROP,0
airdrop-20181115-hdac-7e4e39a7-48a9-429d-b7c4-b63cabe6a5a0-withdrawal-exchange,2018.11.15 10:11,UNKNOWN,,UNKNOWN-55c0f2b7-dc24-425b-9be8-6b86719f2865,2018.11.15 10:11,UNKNOWN,0,100,0,HDAC,WITHDRAWAL,,,,0,COMPLETED,0,sum-user-id,1698366.056,airdrop-20181115-hdac-sum-user-id-withdrawal,accac570-de75-11e8-bd11-2f9252c4dc2f,AIRDROP,0
airdrop-20181115-hdac-7e899d85-cfe5-4bfd-b2a8-732bedfd567a-withdrawal-exchange,2018.11.15 10:11,UNKNOWN,,UNKNOWN-55c0f2b7-dc24-425b-9be8-6b86719f2865,2018.11.15 10:11,UNKNOWN,0,100,0,HDAC,WITHDRAWAL,,,,0,COMPLETED,0,sum-user-id,1698266.056,airdrop-20181115-hdac-sum-user-id-withdrawal,accac570-de75-11e8-bd11-2f9252c4dc2f,AIRDROP,0
airdrop-20181115-hdac-7eb92890-fb15-4d7c-a7d2-f8965c0b843d-withdrawal-exchange,2018.11.15 10:11,UNKNOWN,,UNKNOWN-55c0f2b7-dc24-425b-9be8-6b86719f2865,2018.11.15 10:11,UNKNOWN,0,100,0,HDAC,WITHDRAWAL,,,,0,COMPLETED,0,sum-user-id,1698166.056,airdrop-20181115-hdac-sum-user-id-withdrawal,accac570-de75-11e8-bd11-2f9252c4dc2f,AIRDROP,0
airdrop-20181115-hdac-7ebe1903-8f9c-4516-9d15-e577507935c4-withdrawal-exchange,2018.11.15 10:11,UNKNOWN,,UNKNOWN-55c0f2b7-dc24-425b-9be8-6b86719f2865,2018.11.15 10:11,UNKNOWN,0,100,0,HDAC,WITHDRAWAL,,,,0,COMPLETED,0,sum-user-id,1698066.056,airdrop-20181115-hdac-sum-user-id-withdrawal,accac570-de75-11e8-bd11-2f9252c4dc2f,AIRDROP,0
airdrop-20181115-hdac-7ecf6cf6-8f8d-4e8b-bc96-a4abdcf11c15-withdrawal-exchange,2018.11.15 10:11,UNKNOWN,,UNKNOWN-55c0f2b7-dc24-425b-9be8-6b86719f2865,2018.11.15 10:11,UNKNOWN,0,100,0,HDAC,WITHDRAWAL,,,,0,COMPLETED,0,sum-user-id,1697966.056,airdrop-20181115-hdac-sum-user-id-withdrawal,accac570-de75-11e8-bd11-2f9252c4dc2f,AIRDROP,0
airdrop-20181115-hdac-7efc99eb-b5aa-4d2a-8b0e-adc85d39f0fc-withdrawal-exchange,2018.11.15 10:11,UNKNOWN,,UNKNOWN-55c0f2b7-dc24-425b-9be8-6b86719f2865,2018.11.15 10:11,UNKNOWN,0,100,0,HDAC,WITHDRAWAL,,,,0,COMPLETED,0,sum-user-id,1697866.056,airdrop-20181115-hdac-sum-user-id-withdrawal,accac570-de75-11e8-bd11-2f9252c4dc2f,AIRDROP,0
airdrop-20181115-hdac-7efe38eb-bc55-4d81-83d6-ae40d248e49e-withdrawal-exchange,2018.11.15 10:11,UNKNOWN,,UNKNOWN-55c0f2b7-dc24-425b-9be8-6b86719f2865,2018.11.15 10:11,UNKNOWN,0,100,0,HDAC,WITHDRAWAL,,,,0,COMPLETED,0,sum-user-id,1697766.056,airdrop-20181115-hdac-sum-user-id-withdrawal,accac570-de75-11e8-bd11-2f9252c4dc2f,AIRDROP,0
airdrop-20181115-hdac-7f30584b-c098-4a3d-b65f-6ef0b2a48060-withdrawal-exchange,2018.11.15 10:11,UNKNOWN,,UNKNOWN-55c0f2b7-dc24-425b-9be8-6b86719f2865,2018.11.15 10:11,UNKNOWN,0,100,0,HDAC,WITHDRAWAL,,,,0,COMPLETED,0,sum-user-id,1697666.056,airdrop-20181115-hdac-sum-user-id-withdrawal,accac570-de75-11e8-bd11-2f9252c4dc2f,AIRDROP,0
airdrop-20181115-hdac-7f52c5ca-47ae-4080-8001-8e3d81b1bcea-withdrawal-exchange,2018.11.15 10:11,UNKNOWN,,UNKNOWN-55c0f2b7-dc24-425b-9be8-6b86719f2865,2018.11.15 10:11,UNKNOWN,0,100,0,HDAC,WITHDRAWAL,,,,0,COMPLETED,0,sum-user-id,1697566.056,airdrop-20181115-hdac-sum-user-id-withdrawal,accac570-de75-11e8-bd11-2f9252c4dc2f,AIRDROP,0
airdrop-20181115-hdac-7f62e8a2-f6d9-455a-b115-995fec5df6d4-withdrawal-exchange,2018.11.15 10:11,UNKNOWN,,UNKNOWN-55c0f2b7-dc24-425b-9be8-6b86719f2865,2018.11.15 10:11,UNKNOWN,0,100,0,HDAC,WITHDRAWAL,,,,0,COMPLETED,0,sum-user-id,1697466.056,airdrop-20181115-hdac-sum-user-id-withdrawal,accac570-de75-11e8-bd11-2f9252c4dc2f,AIRDROP,0
airdrop-20181115-hdac-7f776ae7-7914-43c3-84aa-f73f83985702-withdrawal-exchange,2018.11.15 10:11,UNKNOWN,,UNKNOWN-55c0f2b7-dc24-425b-9be8-6b86719f2865,2018.11.15 10:11,UNKNOWN,0,100,0,HDAC,WITHDRAWAL,,,,0,COMPLETED,0,sum-user-id,1697366.056,airdrop-20181115-hdac-sum-user-id-withdrawal,accac570-de75-11e8-bd11-2f9252c4dc2f,AIRDROP,0
airdrop-20181115-hdac-7fa26f04-fc29-483a-9297-649cd793ef7e-withdrawal-exchange,2018.11.15 10:11,UNKNOWN,,UNKNOWN-55c0f2b7-dc24-425b-9be8-6b86719f2865,2018.11.15 10:11,UNKNOWN,0,100,0,HDAC,WITHDRAWAL,,,,0,COMPLETED,0,sum-user-id,1697266.056,airdrop-20181115-hdac-sum-user-id-withdrawal,accac570-de75-11e8-bd11-2f9252c4dc2f,AIRDROP,0
airdrop-20181115-hdac-7fa80fd6-d39c-4b55-9e7f-d83b12e143ee-withdrawal-exchange,2018.11.15 10:11,UNKNOWN,,UNKNOWN-55c0f2b7-dc24-425b-9be8-6b86719f2865,2018.11.15 10:11,UNKNOWN,0,100,0,HDAC,WITHDRAWAL,,,,0,COMPLETED,0,sum-user-id,1697166.056,airdrop-20181115-hdac-sum-user-id-withdrawal,accac570-de75-11e8-bd11-2f9252c4dc2f,AIRDROP,0
airdrop-20181115-hdac-7fd695f3-0831-453c-a5f7-1cf481bc1f56-withdrawal-exchange,2018.11.15 10:11,UNKNOWN,,UNKNOWN-55c0f2b7-dc24-425b-9be8-6b86719f2865,2018.11.15 10:11,UNKNOWN,0,100,0,HDAC,WITHDRAWAL,,,,0,COMPLETED,0,sum-user-id,1697066.056,airdrop-20181115-hdac-sum-user-id-withdrawal,accac570-de75-11e8-bd11-2f9252c4dc2f,AIRDROP,0
airdrop-20181115-hdac-7fdd528d-c673-4f63-b276-5dd53d6560d5-withdrawal-exchange,2018.11.15 10:11,UNKNOWN,,UNKNOWN-55c0f2b7-dc24-425b-9be8-6b86719f2865,2018.11.15 10:11,UNKNOWN,0,100,0,HDAC,WITHDRAWAL,,,,0,COMPLETED,0,sum-user-id,1696966.056,airdrop-20181115-hdac-sum-user-id-withdrawal,accac570-de75-11e8-bd11-2f9252c4dc2f,AIRDROP,0
airdrop-20181115-hdac-7fe7b60a-4426-432c-8e11-a78771a71b8a-withdrawal-exchange,2018-11-15 10:11:46.027,UNKNOWN,,UNKNOWN-55c0f2b7-dc24-425b-9be8-6b86719f2865,2018-11-15 10:11:46.027,UNKNOWN,0,100,0,HDAC,WITHDRAWAL,,,,0,COMPLETED,0,sum-user-id,1696866.056,airdrop-20181115-hdac-sum-user-id-withdrawal,accac570-de75-11e8-bd11-2f9252c4dc2f,AIRDROP,0
airdrop-20181115-hdac-80007b94-3737-421b-b781-eec1ead5a829-withdrawal-exchange,2018-11-15 10:11:46.061,UNKNOWN,,UNKNOWN-55c0f2b7-dc24-425b-9be8-6b86719f2865,2018-11-15 10:11:46.061,UNKNOWN,0,100,0,HDAC,WITHDRAWAL,,,,0,COMPLETED,0,sum-user-id,1696766.056,airdrop-20181115-hdac-sum-user-id-withdrawal,accac570-de75-11e8-bd11-2f9252c4dc2f,AIRDROP,0
airdrop-20181115-hdac-8007feb8-92a3-471a-ac95-2e297caba98d-withdrawal-exchange,2018-11-15 10:11:46.091,UNKNOWN,,UNKNOWN-55c0f2b7-dc24-425b-9be8-6b86719f2865,2018-11-15 10:11:46.091,UNKNOWN,0,100,0,HDAC,WITHDRAWAL,,,,0,COMPLETED,0,sum-user-id,1696666.056,airdrop-20181115-hdac-sum-user-id-withdrawal,accac570-de75-11e8-bd11-2f9252c4dc2f,AIRDROP,0
airdrop-20181115-hdac-8019a933-5411-4829-b9da-cf9ab5806506-withdrawal-exchange,2018.11.15 10:11,UNKNOWN,,UNKNOWN-55c0f2b7-dc24-425b-9be8-6b86719f2865,2018.11.15 10:11,UNKNOWN,0,100,0,HDAC,WITHDRAWAL,,,,0,COMPLETED,0,sum-user-id,1696566.056,airdrop-20181115-hdac-sum-user-id-withdrawal,accac570-de75-11e8-bd11-2f9252c4dc2f,AIRDROP,0
airdrop-20181115-hdac-80285272-2b75-449c-8688-50fdd2fdfd8d-withdrawal-exchange,2018.11.15 10:11,UNKNOWN,,UNKNOWN-55c0f2b7-dc24-425b-9be8-6b86719f2865,2018.11.15 10:11,UNKNOWN,0,100,0,HDAC,WITHDRAWAL,,,,0,COMPLETED,0,sum-user-id,1696466.056,airdrop-20181115-hdac-sum-user-id-withdrawal,accac570-de75-11e8-bd11-2f9252c4dc2f,AIRDROP,0
airdrop-20181115-hdac-803492cd-1128-42c8-8749-d3c438e8b811-withdrawal-exchange,2018.11.15 10:11,UNKNOWN,,UNKNOWN-55c0f2b7-dc24-425b-9be8-6b86719f2865,2018.11.15 10:11,UNKNOWN,0,100,0,HDAC,WITHDRAWAL,,,,0,COMPLETED,0,sum-user-id,1696366.056,airdrop-20181115-hdac-sum-user-id-withdrawal,accac570-de75-11e8-bd11-2f9252c4dc2f,AIRDROP,0
airdrop-20181115-hdac-80427103-942a-4dc7-8d09-6037bb241195-withdrawal-exchange,2018.11.15 10:11,UNKNOWN,,UNKNOWN-55c0f2b7-dc24-425b-9be8-6b86719f2865,2018.11.15 10:11,UNKNOWN,0,100,0,HDAC,WITHDRAWAL,,,,0,COMPLETED,0,sum-user-id,1696266.056,airdrop-20181115-hdac-sum-user-id-withdrawal,accac570-de75-11e8-bd11-2f9252c4dc2f,AIRDROP,0
airdrop-20181115-hdac-804b3629-1375-4fc1-b6d8-c2fbe37ff9c9-withdrawal-exchange,2018.11.15 10:11,UNKNOWN,,UNKNOWN-55c0f2b7-dc24-425b-9be8-6b86719f2865,2018.11.15 10:11,UNKNOWN,0,100,0,HDAC,WITHDRAWAL,,,,0,COMPLETED,0,sum-user-id,1696166.056,airdrop-20181115-hdac-sum-user-id-withdrawal,accac570-de75-11e8-bd11-2f9252c4dc2f,AIRDROP,0
airdrop-20181115-hdac-80507957-7d4a-41bf-9355-458bc17136d8-withdrawal-exchange,2018.11.15 10:11,UNKNOWN,,UNKNOWN-55c0f2b7-dc24-425b-9be8-6b86719f2865,2018.11.15 10:11,UNKNOWN,0,100,0,HDAC,WITHDRAWAL,,,,0,COMPLETED,0,sum-user-id,1696066.056,airdrop-20181115-hdac-sum-user-id-withdrawal,accac570-de75-11e8-bd11-2f9252c4dc2f,AIRDROP,0
airdrop-20181115-hdac-805fdbb7-3ef9-441c-a980-2fcfa5456bfc-withdrawal-exchange,2018.11.15 10:12,UNKNOWN,,UNKNOWN-55c0f2b7-dc24-425b-9be8-6b86719f2865,2018.11.15 10:12,UNKNOWN,0,872.268496,0,HDAC,WITHDRAWAL,,,,0,COMPLETED,0,sum-user-id,1265215.256,airdrop-20181115-hdac-sum-user-id-withdrawal,accac570-de75-11e8-bd11-2f9252c4dc2f,AIRDROP,0
airdrop-20181115-hdac-809ee5cb-d6bb-473a-9820-db765670991e-withdrawal-exchange,2018.11.15 10:11,UNKNOWN,,UNKNOWN-55c0f2b7-dc24-425b-9be8-6b86719f2865,2018.11.15 10:11,UNKNOWN,0,100,0,HDAC,WITHDRAWAL,,,,0,COMPLETED,0,sum-user-id,1695966.056,airdrop-20181115-hdac-sum-user-id-withdrawal,accac570-de75-11e8-bd11-2f9252c4dc2f,AIRDROP,0
airdrop-20181115-hdac-80a88e47-69d4-4d07-b9be-28f2531da826-withdrawal-exchange,2018.11.15 10:12,UNKNOWN,,UNKNOWN-55c0f2b7-dc24-425b-9be8-6b86719f2865,2018.11.15 10:12,UNKNOWN,0,480.68,0,HDAC,WITHDRAWAL,,,,0,COMPLETED,0,sum-user-id,1264734.576,airdrop-20181115-hdac-sum-user-id-withdrawal,accac570-de75-11e8-bd11-2f9252c4dc2f,AIRDROP,0
airdrop-20181115-hdac-80bce3fa-c768-4f51-a906-71f88a1bc234-withdrawal-exchange,2018.11.15 10:12,UNKNOWN,,UNKNOWN-55c0f2b7-dc24-425b-9be8-6b86719f2865,2018.11.15 10:12,UNKNOWN,0,10100,0,HDAC,WITHDRAWAL,,,,0,COMPLETED,0,sum-user-id,1254634.576,airdrop-20181115-hdac-sum-user-id-withdrawal,accac570-de75-11e8-bd11-2f9252c4dc2f,AIRDROP,0
airdrop-20181115-hdac-80d1d446-6bfd-46d3-ac3d-7011dd49ee92-withdrawal-exchange,2018.11.15 10:11,UNKNOWN,,UNKNOWN-55c0f2b7-dc24-425b-9be8-6b86719f2865,2018.11.15 10:11,UNKNOWN,0,100,0,HDAC,WITHDRAWAL,,,,0,COMPLETED,0,sum-user-id,1695866.056,airdrop-20181115-hdac-sum-user-id-withdrawal,accac570-de75-11e8-bd11-2f9252c4dc2f,AIRDROP,0
airdrop-20181115-hdac-80efa779-3057-40b5-aff6-d51531ffbba2-withdrawal-exchange,2018.11.15 10:11,UNKNOWN,,UNKNOWN-55c0f2b7-dc24-425b-9be8-6b86719f2865,2018.11.15 10:11,UNKNOWN,0,100,0,HDAC,WITHDRAWAL,,,,0,COMPLETED,0,sum-user-id,1695766.056,airdrop-20181115-hdac-sum-user-id-withdrawal,accac570-de75-11e8-bd11-2f9252c4dc2f,AIRDROP,0
airdrop-20181115-hdac-80fd7476-41c1-47c8-b2ee-4f6a20df3a33-withdrawal-exchange,2018.11.15 10:11,UNKNOWN,,UNKNOWN-55c0f2b7-dc24-425b-9be8-6b86719f2865,2018.11.15 10:11,UNKNOWN,0,100,0,HDAC,WITHDRAWAL,,,,0,COMPLETED,0,sum-user-id,1695666.056,airdrop-20181115-hdac-sum-user-id-withdrawal,accac570-de75-11e8-bd11-2f9252c4dc2f,AIRDROP,0
airdrop-20181115-hdac-816c58cd-a283-4c66-8195-a3c770df95c5-withdrawal-exchange,2018.11.15 10:11,UNKNOWN,,UNKNOWN-55c0f2b7-dc24-425b-9be8-6b86719f2865,2018.11.15 10:11,UNKNOWN,0,100,0,HDAC,WITHDRAWAL,,,,0,COMPLETED,0,sum-user-id,1695566.056,airdrop-20181115-hdac-sum-user-id-withdrawal,accac570-de75-11e8-bd11-2f9252c4dc2f,AIRDROP,0
airdrop-20181115-hdac-8181b85c-77ed-4a9f-b36c-47606186742b-withdrawal-exchange,2018.11.15 10:11,UNKNOWN,,UNKNOWN-55c0f2b7-dc24-425b-9be8-6b86719f2865,2018.11.15 10:11,UNKNOWN,0,100,0,HDAC,WITHDRAWAL,,,,0,COMPLETED,0,sum-user-id,1695466.056,airdrop-20181115-hdac-sum-user-id-withdrawal,accac570-de75-11e8-bd11-2f9252c4dc2f,AIRDROP,0
airdrop-20181115-hdac-81a5270e-7517-497a-8eb9-aa42a730aa1c-withdrawal-exchange,2018.11.15 10:11,UNKNOWN,,UNKNOWN-55c0f2b7-dc24-425b-9be8-6b86719f2865,2018.11.15 10:11,UNKNOWN,0,100,0,HDAC,WITHDRAWAL,,,,0,COMPLETED,0,sum-user-id,1695366.056,airdrop-20181115-hdac-sum-user-id-withdrawal,accac570-de75-11e8-bd11-2f9252c4dc2f,AIRDROP,0
airdrop-20181115-hdac-81c3861d-297f-4bba-a637-115dc0827b2e-withdrawal-exchange,2018.11.15 10:11,UNKNOWN,,UNKNOWN-55c0f2b7-dc24-425b-9be8-6b86719f2865,2018.11.15 10:11,UNKNOWN,0,100,0,HDAC,WITHDRAWAL,,,,0,COMPLETED,0,sum-user-id,1695266.056,airdrop-20181115-hdac-sum-user-id-withdrawal,accac570-de75-11e8-bd11-2f9252c4dc2f,AIRDROP,0
airdrop-20181115-hdac-81dcbe71-a36f-469c-a5d4-a568eb4bf7c4-withdrawal-exchange,2018.11.15 10:11,UNKNOWN,,UNKNOWN-55c0f2b7-dc24-425b-9be8-6b86719f2865,2018.11.15 10:11,UNKNOWN,0,100,0,HDAC,WITHDRAWAL,,,,0,COMPLETED,0,sum-user-id,1695166.056,airdrop-20181115-hdac-sum-user-id-withdrawal,accac570-de75-11e8-bd11-2f9252c4dc2f,AIRDROP,0
airdrop-20181115-hdac-81de39f6-d2ca-470e-ba85-b8bd7cf9a01c-withdrawal-exchange,2018.11.15 10:11,UNKNOWN,,UNKNOWN-55c0f2b7-dc24-425b-9be8-6b86719f2865,2018.11.15 10:11,UNKNOWN,0,100,0,HDAC,WITHDRAWAL,,,,0,COMPLETED,0,sum-user-id,1695066.056,airdrop-20181115-hdac-sum-user-id-withdrawal,accac570-de75-11e8-bd11-2f9252c4dc2f,AIRDROP,0
airdrop-20181115-hdac-81e0000d-4897-4d27-958e-0d30d93b5666-withdrawal-exchange,2018.11.15 10:11,UNKNOWN,,UNKNOWN-55c0f2b7-dc24-425b-9be8-6b86719f2865,2018.11.15 10:11,UNKNOWN,0,100,0,HDAC,WITHDRAWAL,,,,0,COMPLETED,0,sum-user-id,1694966.056,airdrop-20181115-hdac-sum-user-id-withdrawal,accac570-de75-11e8-bd11-2f9252c4dc2f,AIRDROP,0
airdrop-20181115-hdac-820922db-aee3-4b8c-b3f7-44a89c818ff5-withdrawal-exchange,2018.11.15 10:11,UNKNOWN,,UNKNOWN-55c0f2b7-dc24-425b-9be8-6b86719f2865,2018.11.15 10:11,UNKNOWN,0,100,0,HDAC,WITHDRAWAL,,,,0,COMPLETED,0,sum-user-id,1694866.056,airdrop-20181115-hdac-sum-user-id-withdrawal,accac570-de75-11e8-bd11-2f9252c4dc2f,AIRDROP,0
airdrop-20181115-hdac-8215e80f-cde8-4ff1-9b18-0cb4008f4618-withdrawal-exchange,2018.11.15 10:11,UNKNOWN,,UNKNOWN-55c0f2b7-dc24-425b-9be8-6b86719f2865,2018.11.15 10:11,UNKNOWN,0,100,0,HDAC,WITHDRAWAL,,,,0,COMPLETED,0,sum-user-id,1694766.056,airdrop-20181115-hdac-sum-user-id-withdrawal,accac570-de75-11e8-bd11-2f9252c4dc2f,AIRDROP,0
airdrop-20181115-hdac-82445cfe-f555-4107-b0be-05b683007165-withdrawal-exchange,2018.11.15 10:11,UNKNOWN,,UNKNOWN-55c0f2b7-dc24-425b-9be8-6b86719f2865,2018.11.15 10:11,UNKNOWN,0,100,0,HDAC,WITHDRAWAL,,,,0,COMPLETED,0,sum-user-id,1694666.056,airdrop-20181115-hdac-sum-user-id-withdrawal,accac570-de75-11e8-bd11-2f9252c4dc2f,AIRDROP,0
airdrop-20181115-hdac-825285b2-93fa-479b-8c76-21e42c24b18a-withdrawal-exchange,2018.11.15 10:11,UNKNOWN,,UNKNOWN-55c0f2b7-dc24-425b-9be8-6b86719f2865,2018.11.15 10:11,UNKNOWN,0,100,0,HDAC,WITHDRAWAL,,,,0,COMPLETED,0,sum-user-id,1694566.056,airdrop-20181115-hdac-sum-user-id-withdrawal,accac570-de75-11e8-bd11-2f9252c4dc2f,AIRDROP,0
airdrop-20181115-hdac-825b6c12-0237-4bda-80c4-f2c31ea115c2-withdrawal-exchange,2018.11.15 10:11,UNKNOWN,,UNKNOWN-55c0f2b7-dc24-425b-9be8-6b86719f2865,2018.11.15 10:11,UNKNOWN,0,100,0,HDAC,WITHDRAWAL,,,,0,COMPLETED,0,sum-user-id,1694466.056,airdrop-20181115-hdac-sum-user-id-withdrawal,accac570-de75-11e8-bd11-2f9252c4dc2f,AIRDROP,0
airdrop-20181115-hdac-8262c6e3-65e1-41d4-b89e-f51d1092df04-withdrawal-exchange,2018.11.15 10:11,UNKNOWN,,UNKNOWN-55c0f2b7-dc24-425b-9be8-6b86719f2865,2018.11.15 10:11,UNKNOWN,0,100,0,HDAC,WITHDRAWAL,,,,0,COMPLETED,0,sum-user-id,1694366.056,airdrop-20181115-hdac-sum-user-id-withdrawal,accac570-de75-11e8-bd11-2f9252c4dc2f,AIRDROP,0
airdrop-20181115-hdac-8263fc12-d100-4357-9386-b36ad3d990f9-withdrawal-exchange,2018.11.15 10:11,UNKNOWN,,UNKNOWN-55c0f2b7-dc24-425b-9be8-6b86719f2865,2018.11.15 10:11,UNKNOWN,0,100,0,HDAC,WITHDRAWAL,,,,0,COMPLETED,0,sum-user-id,1694266.056,airdrop-20181115-hdac-sum-user-id-withdrawal,accac570-de75-11e8-bd11-2f9252c4dc2f,AIRDROP,0
airdrop-20181115-hdac-82753d8d-08c5-4f64-aad8-e761e9a783e2-withdrawal-exchange,2018.11.15 10:11,UNKNOWN,,UNKNOWN-55c0f2b7-dc24-425b-9be8-6b86719f2865,2018.11.15 10:11,UNKNOWN,0,100,0,HDAC,WITHDRAWAL,,,,0,COMPLETED,0,sum-user-id,1694166.056,airdrop-20181115-hdac-sum-user-id-withdrawal,accac570-de75-11e8-bd11-2f9252c4dc2f,AIRDROP,0
airdrop-20181115-hdac-8278e115-4982-473c-9b93-140210f0bbae-withdrawal-exchange,2018.11.15 10:11,UNKNOWN,,UNKNOWN-55c0f2b7-dc24-425b-9be8-6b86719f2865,2018.11.15 10:11,UNKNOWN,0,100,0,HDAC,WITHDRAWAL,,,,0,COMPLETED,0,sum-user-id,1694066.056,airdrop-20181115-hdac-sum-user-id-withdrawal,accac570-de75-11e8-bd11-2f9252c4dc2f,AIRDROP,0
airdrop-20181115-hdac-82850be8-a9a9-45ff-9261-94602ad2e50b-withdrawal-exchange,2018.11.15 10:11,UNKNOWN,,UNKNOWN-55c0f2b7-dc24-425b-9be8-6b86719f2865,2018.11.15 10:11,UNKNOWN,0,100,0,HDAC,WITHDRAWAL,,,,0,COMPLETED,0,sum-user-id,1693966.056,airdrop-20181115-hdac-sum-user-id-withdrawal,accac570-de75-11e8-bd11-2f9252c4dc2f,AIRDROP,0
airdrop-20181115-hdac-82bfe602-6d79-4834-bdb7-47a7988e0427-withdrawal-exchange,2018.11.15 10:11,UNKNOWN,,UNKNOWN-55c0f2b7-dc24-425b-9be8-6b86719f2865,2018.11.15 10:11,UNKNOWN,0,100,0,HDAC,WITHDRAWAL,,,,0,COMPLETED,0,sum-user-id,1693866.056,airdrop-20181115-hdac-sum-user-id-withdrawal,accac570-de75-11e8-bd11-2f9252c4dc2f,AIRDROP,0
airdrop-20181115-hdac-82c95e9e-359e-4480-b900-0301d256583c-withdrawal-exchange,2018-11-15 10:11:47.007,UNKNOWN,,UNKNOWN-55c0f2b7-dc24-425b-9be8-6b86719f2865,2018-11-15 10:11:47.007,UNKNOWN,0,100,0,HDAC,WITHDRAWAL,,,,0,COMPLETED,0,sum-user-id,1693766.056,airdrop-20181115-hdac-sum-user-id-withdrawal,accac570-de75-11e8-bd11-2f9252c4dc2f,AIRDROP,0
airdrop-20181115-hdac-83299a4d-7ba7-4210-9141-d87519b057d7-withdrawal-exchange,2018-11-15 10:11:47.040,UNKNOWN,,UNKNOWN-55c0f2b7-dc24-425b-9be8-6b86719f2865,2018-11-15 10:11:47.040,UNKNOWN,0,100,0,HDAC,WITHDRAWAL,,,,0,COMPLETED,0,sum-user-id,1693666.056,airdrop-20181115-hdac-sum-user-id-withdrawal,accac570-de75-11e8-bd11-2f9252c4dc2f,AIRDROP,0
airdrop-20181115-hdac-8370d73c-67b9-4a55-8a20-81a1a6b9b38e-withdrawal-exchange,2018-11-15 10:11:47.070,UNKNOWN,,UNKNOWN-55c0f2b7-dc24-425b-9be8-6b86719f2865,2018-11-15 10:11:47.070,UNKNOWN,0,100,0,HDAC,WITHDRAWAL,,,,0,COMPLETED,0,sum-user-id,1693566.056,airdrop-20181115-hdac-sum-user-id-withdrawal,accac570-de75-11e8-bd11-2f9252c4dc2f,AIRDROP,0
airdrop-20181115-hdac-8372948c-8dab-4c08-bdbe-119a85a113ef-withdrawal-exchange,2018.11.15 10:11,UNKNOWN,,UNKNOWN-55c0f2b7-dc24-425b-9be8-6b86719f2865,2018.11.15 10:11,UNKNOWN,0,100,0,HDAC,WITHDRAWAL,,,,0,COMPLETED,0,sum-user-id,1693466.056,airdrop-20181115-hdac-sum-user-id-withdrawal,accac570-de75-11e8-bd11-2f9252c4dc2f,AIRDROP,0
airdrop-20181115-hdac-8375de4e-3ea2-498b-8e85-d2b09f65f739-withdrawal-exchange,2018.11.15 10:11,UNKNOWN,,UNKNOWN-55c0f2b7-dc24-425b-9be8-6b86719f2865,2018.11.15 10:11,UNKNOWN,0,100,0,HDAC,WITHDRAWAL,,,,0,COMPLETED,0,sum-user-id,1693366.056,airdrop-20181115-hdac-sum-user-id-withdrawal,accac570-de75-11e8-bd11-2f9252c4dc2f,AIRDROP,0
airdrop-20181115-hdac-83e5a9ec-e511-431c-93ae-9fb31f4d7134-withdrawal-exchange,2018.11.15 10:11,UNKNOWN,,UNKNOWN-55c0f2b7-dc24-425b-9be8-6b86719f2865,2018.11.15 10:11,UNKNOWN,0,100,0,HDAC,WITHDRAWAL,,,,0,COMPLETED,0,sum-user-id,1693266.056,airdrop-20181115-hdac-sum-user-id-withdrawal,accac570-de75-11e8-bd11-2f9252c4dc2f,AIRDROP,0
airdrop-20181115-hdac-83f76ace-247d-40a6-a503-0260daa83049-withdrawal-exchange,2018.11.15 10:11,UNKNOWN,,UNKNOWN-55c0f2b7-dc24-425b-9be8-6b86719f2865,2018.11.15 10:11,UNKNOWN,0,100,0,HDAC,WITHDRAWAL,,,,0,COMPLETED,0,sum-user-id,1693166.056,airdrop-20181115-hdac-sum-user-id-withdrawal,accac570-de75-11e8-bd11-2f9252c4dc2f,AIRDROP,0
airdrop-20181115-hdac-84291074-6373-4d31-b50f-580117e0c27d-withdrawal-exchange,2018.11.15 10:11,UNKNOWN,,UNKNOWN-55c0f2b7-dc24-425b-9be8-6b86719f2865,2018.11.15 10:11,UNKNOWN,0,100,0,HDAC,WITHDRAWAL,,,,0,COMPLETED,0,sum-user-id,1693066.056,airdrop-20181115-hdac-sum-user-id-withdrawal,accac570-de75-11e8-bd11-2f9252c4dc2f,AIRDROP,0
airdrop-20181115-hdac-8431afef-8448-46b8-82f5-c5f13fcdfc48-withdrawal-exchange,2018.11.15 10:11,UNKNOWN,,UNKNOWN-55c0f2b7-dc24-425b-9be8-6b86719f2865,2018.11.15 10:11,UNKNOWN,0,100,0,HDAC,WITHDRAWAL,,,,0,COMPLETED,0,sum-user-id,1692966.056,airdrop-20181115-hdac-sum-user-id-withdrawal,accac570-de75-11e8-bd11-2f9252c4dc2f,AIRDROP,0
airdrop-20181115-hdac-843f5c3b-304c-4bf9-95f4-7381c9baad97-withdrawal-exchange,2018.11.15 10:11,UNKNOWN,,UNKNOWN-55c0f2b7-dc24-425b-9be8-6b86719f2865,2018.11.15 10:11,UNKNOWN,0,100,0,HDAC,WITHDRAWAL,,,,0,COMPLETED,0,sum-user-id,1692866.056,airdrop-20181115-hdac-sum-user-id-withdrawal,accac570-de75-11e8-bd11-2f9252c4dc2f,AIRDROP,0
airdrop-20181115-hdac-844053b8-e1cb-49d7-b84c-55a7f679446f-withdrawal-exchange,2018.11.15 10:11,UNKNOWN,,UNKNOWN-55c0f2b7-dc24-425b-9be8-6b86719f2865,2018.11.15 10:11,UNKNOWN,0,100,0,HDAC,WITHDRAWAL,,,,0,COMPLETED,0,sum-user-id,1692766.056,airdrop-20181115-hdac-sum-user-id-withdrawal,accac570-de75-11e8-bd11-2f9252c4dc2f,AIRDROP,0
airdrop-20181115-hdac-845bfff4-49b1-4182-b60b-0214f9ca234b-withdrawal-exchange,2018.11.15 10:11,UNKNOWN,,UNKNOWN-55c0f2b7-dc24-425b-9be8-6b86719f2865,2018.11.15 10:11,UNKNOWN,0,100,0,HDAC,WITHDRAWAL,,,,0,COMPLETED,0,sum-user-id,1692666.056,airdrop-20181115-hdac-sum-user-id-withdrawal,accac570-de75-11e8-bd11-2f9252c4dc2f,AIRDROP,0
airdrop-20181115-hdac-84651ac3-1f7a-46ee-ad38-88f072085bb0-withdrawal-exchange,2018.11.15 10:11,UNKNOWN,,UNKNOWN-55c0f2b7-dc24-425b-9be8-6b86719f2865,2018.11.15 10:11,UNKNOWN,0,100,0,HDAC,WITHDRAWAL,,,,0,COMPLETED,0,sum-user-id,1692566.056,airdrop-20181115-hdac-sum-user-id-withdrawal,accac570-de75-11e8-bd11-2f9252c4dc2f,AIRDROP,0
airdrop-20181115-hdac-84706460-2d59-4cd8-a97d-c5888a6ff8ff-withdrawal-exchange,2018.11.15 10:11,UNKNOWN,,UNKNOWN-55c0f2b7-dc24-425b-9be8-6b86719f2865,2018.11.15 10:11,UNKNOWN,0,100,0,HDAC,WITHDRAWAL,,,,0,COMPLETED,0,sum-user-id,1692466.056,airdrop-20181115-hdac-sum-user-id-withdrawal,accac570-de75-11e8-bd11-2f9252c4dc2f,AIRDROP,0
airdrop-20181115-hdac-848357bd-0933-4eb3-a044-15b4d99338a7-withdrawal-exchange,2018.11.15 10:11,UNKNOWN,,UNKNOWN-55c0f2b7-dc24-425b-9be8-6b86719f2865,2018.11.15 10:11,UNKNOWN,0,100,0,HDAC,WITHDRAWAL,,,,0,COMPLETED,0,sum-user-id,1692366.056,airdrop-20181115-hdac-sum-user-id-withdrawal,accac570-de75-11e8-bd11-2f9252c4dc2f,AIRDROP,0
airdrop-20181115-hdac-848652f0-1f99-47a3-88a2-4fee592553e1-withdrawal-exchange,2018.11.15 10:11,UNKNOWN,,UNKNOWN-55c0f2b7-dc24-425b-9be8-6b86719f2865,2018.11.15 10:11,UNKNOWN,0,100,0,HDAC,WITHDRAWAL,,,,0,COMPLETED,0,sum-user-id,1692266.056,airdrop-20181115-hdac-sum-user-id-withdrawal,accac570-de75-11e8-bd11-2f9252c4dc2f,AIRDROP,0
airdrop-20181115-hdac-8486790b-17ea-40c6-acf3-439a9eb94fc1-withdrawal-exchange,2018.11.15 10:11,UNKNOWN,,UNKNOWN-55c0f2b7-dc24-425b-9be8-6b86719f2865,2018.11.15 10:11,UNKNOWN,0,100,0,HDAC,WITHDRAWAL,,,,0,COMPLETED,0,sum-user-id,1692166.056,airdrop-20181115-hdac-sum-user-id-withdrawal,accac570-de75-11e8-bd11-2f9252c4dc2f,AIRDROP,0
airdrop-20181115-hdac-848a8814-b658-483e-bf21-d539ab748555-withdrawal-exchange,2018.11.15 10:11,UNKNOWN,,UNKNOWN-55c0f2b7-dc24-425b-9be8-6b86719f2865,2018.11.15 10:11,UNKNOWN,0,100,0,HDAC,WITHDRAWAL,,,,0,COMPLETED,0,sum-user-id,1692066.056,airdrop-20181115-hdac-sum-user-id-withdrawal,accac570-de75-11e8-bd11-2f9252c4dc2f,AIRDROP,0
airdrop-20181115-hdac-848aa5db-1dbb-4070-a290-dc749cfafeaa-withdrawal-exchange,2018.11.15 10:11,UNKNOWN,,UNKNOWN-55c0f2b7-dc24-425b-9be8-6b86719f2865,2018.11.15 10:11,UNKNOWN,0,100,0,HDAC,WITHDRAWAL,,,,0,COMPLETED,0,sum-user-id,1691966.056,airdrop-20181115-hdac-sum-user-id-withdrawal,accac570-de75-11e8-bd11-2f9252c4dc2f,AIRDROP,0
airdrop-20181115-hdac-84991c55-3f50-4748-97f7-08cad641142e-withdrawal-exchange,2018.11.15 10:12,UNKNOWN,,UNKNOWN-55c0f2b7-dc24-425b-9be8-6b86719f2865,2018.11.15 10:12,UNKNOWN,0,775.365284,0,HDAC,WITHDRAWAL,,,,0,COMPLETED,0,sum-user-id,1253859.21,airdrop-20181115-hdac-sum-user-id-withdrawal,accac570-de75-11e8-bd11-2f9252c4dc2f,AIRDROP,0
airdrop-20181115-hdac-84c4467b-817b-4bfd-a129-5db01657608a-withdrawal-exchange,2018.11.15 10:11,UNKNOWN,,UNKNOWN-55c0f2b7-dc24-425b-9be8-6b86719f2865,2018.11.15 10:11,UNKNOWN,0,100,0,HDAC,WITHDRAWAL,,,,0,COMPLETED,0,sum-user-id,1691866.056,airdrop-20181115-hdac-sum-user-id-withdrawal,accac570-de75-11e8-bd11-2f9252c4dc2f,AIRDROP,0
airdrop-20181115-hdac-84cb7727-fd36-48e7-8c7a-53fd0583cf30-withdrawal-exchange,2018.11.15 10:11,UNKNOWN,,UNKNOWN-55c0f2b7-dc24-425b-9be8-6b86719f2865,2018.11.15 10:11,UNKNOWN,0,100,0,HDAC,WITHDRAWAL,,,,0,COMPLETED,0,sum-user-id,1691766.056,airdrop-20181115-hdac-sum-user-id-withdrawal,accac570-de75-11e8-bd11-2f9252c4dc2f,AIRDROP,0
airdrop-20181115-hdac-84e1e7bf-cb2f-4364-b0bd-328cb615e8bd-withdrawal-exchange,2018.11.15 10:11,UNKNOWN,,UNKNOWN-55c0f2b7-dc24-425b-9be8-6b86719f2865,2018.11.15 10:11,UNKNOWN,0,100,0,HDAC,WITHDRAWAL,,,,0,COMPLETED,0,sum-user-id,1691666.056,airdrop-20181115-hdac-sum-user-id-withdrawal,accac570-de75-11e8-bd11-2f9252c4dc2f,AIRDROP,0
airdrop-20181115-hdac-84eb0d97-ffca-40cd-9c2b-ebef13339a36-withdrawal-exchange,2018.11.15 10:11,UNKNOWN,,UNKNOWN-55c0f2b7-dc24-425b-9be8-6b86719f2865,2018.11.15 10:11,UNKNOWN,0,100,0,HDAC,WITHDRAWAL,,,,0,COMPLETED,0,sum-user-id,1691566.056,airdrop-20181115-hdac-sum-user-id-withdrawal,accac570-de75-11e8-bd11-2f9252c4dc2f,AIRDROP,0
airdrop-20181115-hdac-84faa4f0-9f10-4e8c-a07f-70d6b82ca595-withdrawal-exchange,2018.11.15 10:11,UNKNOWN,,UNKNOWN-55c0f2b7-dc24-425b-9be8-6b86719f2865,2018.11.15 10:11,UNKNOWN,0,10000,0,HDAC,WITHDRAWAL,,,,0,COMPLETED,0,sum-user-id,1681566.056,airdrop-20181115-hdac-sum-user-id-withdrawal,accac570-de75-11e8-bd11-2f9252c4dc2f,AIRDROP,0
airdrop-20181115-hdac-85119a6f-1f9c-4403-93cf-debc1d848a8e-withdrawal-exchange,2018.11.15 10:11,UNKNOWN,,UNKNOWN-55c0f2b7-dc24-425b-9be8-6b86719f2865,2018.11.15 10:11,UNKNOWN,0,100,0,HDAC,WITHDRAWAL,,,,0,COMPLETED,0,sum-user-id,1681466.056,airdrop-20181115-hdac-sum-user-id-withdrawal,accac570-de75-11e8-bd11-2f9252c4dc2f,AIRDROP,0
airdrop-20181115-hdac-8530237d-dc27-44c1-87a3-cc4a55f1dfa2-withdrawal-exchange,2018.11.15 10:11,UNKNOWN,,UNKNOWN-55c0f2b7-dc24-425b-9be8-6b86719f2865,2018.11.15 10:11,UNKNOWN,0,100,0,HDAC,WITHDRAWAL,,,,0,COMPLETED,0,sum-user-id,1681366.056,airdrop-20181115-hdac-sum-user-id-withdrawal,accac570-de75-11e8-bd11-2f9252c4dc2f,AIRDROP,0
airdrop-20181115-hdac-8530f0b5-2c3d-4de6-af91-b57f0385b541-withdrawal-exchange,2018.11.15 10:11,UNKNOWN,,UNKNOWN-55c0f2b7-dc24-425b-9be8-6b86719f2865,2018.11.15 10:11,UNKNOWN,0,100,0,HDAC,WITHDRAWAL,,,,0,COMPLETED,0,sum-user-id,1681266.056,airdrop-20181115-hdac-sum-user-id-withdrawal,accac570-de75-11e8-bd11-2f9252c4dc2f,AIRDROP,0
airdrop-20181115-hdac-85354412-e686-4f43-bd30-cc28414634f2-withdrawal-exchange,2018.11.15 10:11,UNKNOWN,,UNKNOWN-55c0f2b7-dc24-425b-9be8-6b86719f2865,2018.11.15 10:11,UNKNOWN,0,100,0,HDAC,WITHDRAWAL,,,,0,COMPLETED,0,sum-user-id,1681166.056,airdrop-20181115-hdac-sum-user-id-withdrawal,accac570-de75-11e8-bd11-2f9252c4dc2f,AIRDROP,0
airdrop-20181115-hdac-8559545d-b301-409c-9d5d-5e0194e15413-withdrawal-exchange,2018.11.15 10:11,UNKNOWN,,UNKNOWN-55c0f2b7-dc24-425b-9be8-6b86719f2865,2018.11.15 10:11,UNKNOWN,0,100,0,HDAC,WITHDRAWAL,,,,0,COMPLETED,0,sum-user-id,1681066.056,airdrop-20181115-hdac-sum-user-id-withdrawal,accac570-de75-11e8-bd11-2f9252c4dc2f,AIRDROP,0
airdrop-20181115-hdac-855a3a3d-933d-4ce4-afc8-35e64241d429-withdrawal-exchange,2018-11-15 10:11:48.017,UNKNOWN,,UNKNOWN-55c0f2b7-dc24-425b-9be8-6b86719f2865,2018-11-15 10:11:48.017,UNKNOWN,0,100,0,HDAC,WITHDRAWAL,,,,0,COMPLETED,0,sum-user-id,1680966.056,airdrop-20181115-hdac-sum-user-id-withdrawal,accac570-de75-11e8-bd11-2f9252c4dc2f,AIRDROP,0
airdrop-20181115-hdac-856959a7-2c1c-4c9e-9b1b-e70ecde0d40a-withdrawal-exchange,2018-11-15 10:11:48.050,UNKNOWN,,UNKNOWN-55c0f2b7-dc24-425b-9be8-6b86719f2865,2018-11-15 10:11:48.050,UNKNOWN,0,100,0,HDAC,WITHDRAWAL,,,,0,COMPLETED,0,sum-user-id,1680866.056,airdrop-20181115-hdac-sum-user-id-withdrawal,accac570-de75-11e8-bd11-2f9252c4dc2f,AIRDROP,0
airdrop-20181115-hdac-85914740-2d22-4d64-8d17-557f0f37fb85-withdrawal-exchange,2018-11-15 10:11:48.083,UNKNOWN,,UNKNOWN-55c0f2b7-dc24-425b-9be8-6b86719f2865,2018-11-15 10:11:48.083,UNKNOWN,0,100,0,HDAC,WITHDRAWAL,,,,0,COMPLETED,0,sum-user-id,1680766.056,airdrop-20181115-hdac-sum-user-id-withdrawal,accac570-de75-11e8-bd11-2f9252c4dc2f,AIRDROP,0
airdrop-20181115-hdac-85b1cbc6-dc11-4814-86af-2a19d38534e6-withdrawal-exchange,2018.11.15 10:11,UNKNOWN,,UNKNOWN-55c0f2b7-dc24-425b-9be8-6b86719f2865,2018.11.15 10:11,UNKNOWN,0,100,0,HDAC,WITHDRAWAL,,,,0,COMPLETED,0,sum-user-id,1680666.056,airdrop-20181115-hdac-sum-user-id-withdrawal,accac570-de75-11e8-bd11-2f9252c4dc2f,AIRDROP,0
airdrop-20181115-hdac-85b93416-1a0a-443e-9b09-4d8d445a888d-withdrawal-exchange,2018.11.15 10:11,UNKNOWN,,UNKNOWN-55c0f2b7-dc24-425b-9be8-6b86719f2865,2018.11.15 10:11,UNKNOWN,0,100,0,HDAC,WITHDRAWAL,,,,0,COMPLETED,0,sum-user-id,1680566.056,airdrop-20181115-hdac-sum-user-id-withdrawal,accac570-de75-11e8-bd11-2f9252c4dc2f,AIRDROP,0
airdrop-20181115-hdac-85bc5c65-6d75-4f7a-aed7-91d2ab6f9ddd-withdrawal-exchange,2018.11.15 10:11,UNKNOWN,,UNKNOWN-55c0f2b7-dc24-425b-9be8-6b86719f2865,2018.11.15 10:11,UNKNOWN,0,100,0,HDAC,WITHDRAWAL,,,,0,COMPLETED,0,sum-user-id,1680466.056,airdrop-20181115-hdac-sum-user-id-withdrawal,accac570-de75-11e8-bd11-2f9252c4dc2f,AIRDROP,0
airdrop-20181115-hdac-85c65c80-e75a-44d2-8a63-75cb29f733b7-withdrawal-exchange,2018.11.15 10:11,UNKNOWN,,UNKNOWN-55c0f2b7-dc24-425b-9be8-6b86719f2865,2018.11.15 10:11,UNKNOWN,0,60.572086,0,HDAC,WITHDRAWAL,,,,0,COMPLETED,0,sum-user-id,1680405.484,airdrop-20181115-hdac-sum-user-id-withdrawal,accac570-de75-11e8-bd11-2f9252c4dc2f,AIRDROP,0
airdrop-20181115-hdac-85d5172e-6741-4d14-a475-e0a4226ae7bf-withdrawal-exchange,2018.11.15 10:11,UNKNOWN,,UNKNOWN-55c0f2b7-dc24-425b-9be8-6b86719f2865,2018.11.15 10:11,UNKNOWN,0,100,0,HDAC,WITHDRAWAL,,,,0,COMPLETED,0,sum-user-id,1680305.484,airdrop-20181115-hdac-sum-user-id-withdrawal,accac570-de75-11e8-bd11-2f9252c4dc2f,AIRDROP,0
airdrop-20181115-hdac-85e3a494-d159-436e-9efd-b0223e479622-withdrawal-exchange,2018.11.15 10:11,UNKNOWN,,UNKNOWN-55c0f2b7-dc24-425b-9be8-6b86719f2865,2018.11.15 10:11,UNKNOWN,0,100,0,HDAC,WITHDRAWAL,,,,0,COMPLETED,0,sum-user-id,1680205.484,airdrop-20181115-hdac-sum-user-id-withdrawal,accac570-de75-11e8-bd11-2f9252c4dc2f,AIRDROP,0
airdrop-20181115-hdac-85e4bcfa-a13e-461a-a2f2-2aafd20e1a58-withdrawal-exchange,2018.11.15 10:11,UNKNOWN,,UNKNOWN-55c0f2b7-dc24-425b-9be8-6b86719f2865,2018.11.15 10:11,UNKNOWN,0,100,0,HDAC,WITHDRAWAL,,,,0,COMPLETED,0,sum-user-id,1680105.484,airdrop-20181115-hdac-sum-user-id-withdrawal,accac570-de75-11e8-bd11-2f9252c4dc2f,AIRDROP,0
airdrop-20181115-hdac-86216f34-1e69-459c-b155-4aa1dda3c358-withdrawal-exchange,2018.11.15 10:11,UNKNOWN,,UNKNOWN-55c0f2b7-dc24-425b-9be8-6b86719f2865,2018.11.15 10:11,UNKNOWN,0,100,0,HDAC,WITHDRAWAL,,,,0,COMPLETED,0,sum-user-id,1680005.484,airdrop-20181115-hdac-sum-user-id-withdrawal,accac570-de75-11e8-bd11-2f9252c4dc2f,AIRDROP,0
airdrop-20181115-hdac-86415c3b-4838-42c5-b4e0-3ffa3c58b365-withdrawal-exchange,2018.11.15 10:11,UNKNOWN,,UNKNOWN-55c0f2b7-dc24-425b-9be8-6b86719f2865,2018.11.15 10:11,UNKNOWN,0,100,0,HDAC,WITHDRAWAL,,,,0,COMPLETED,0,sum-user-id,1679905.484,airdrop-20181115-hdac-sum-user-id-withdrawal,accac570-de75-11e8-bd11-2f9252c4dc2f,AIRDROP,0
airdrop-20181115-hdac-8644258a-267e-4cda-8a7a-1e1cd4707d56-withdrawal-exchange,2018.11.15 10:11,UNKNOWN,,UNKNOWN-55c0f2b7-dc24-425b-9be8-6b86719f2865,2018.11.15 10:11,UNKNOWN,0,10000,0,HDAC,WITHDRAWAL,,,,0,COMPLETED,0,sum-user-id,1669905.484,airdrop-20181115-hdac-sum-user-id-withdrawal,accac570-de75-11e8-bd11-2f9252c4dc2f,AIRDROP,0
airdrop-20181115-hdac-86462613-48b6-4284-89fb-d115603754ce-withdrawal-exchange,2018.11.15 10:11,UNKNOWN,,UNKNOWN-55c0f2b7-dc24-425b-9be8-6b86719f2865,2018.11.15 10:11,UNKNOWN,0,100,0,HDAC,WITHDRAWAL,,,,0,COMPLETED,0,sum-user-id,1669805.484,airdrop-20181115-hdac-sum-user-id-withdrawal,accac570-de75-11e8-bd11-2f9252c4dc2f,AIRDROP,0
airdrop-20181115-hdac-86655539-c8d4-4192-bc89-216204dc582e-withdrawal-exchange,2018.11.15 10:11,UNKNOWN,,UNKNOWN-55c0f2b7-dc24-425b-9be8-6b86719f2865,2018.11.15 10:11,UNKNOWN,0,100,0,HDAC,WITHDRAWAL,,,,0,COMPLETED,0,sum-user-id,1669705.484,airdrop-20181115-hdac-sum-user-id-withdrawal,accac570-de75-11e8-bd11-2f9252c4dc2f,AIRDROP,0
airdrop-20181115-hdac-86788e8b-1e2a-4617-b7bc-6b87769fa3fc-withdrawal-exchange,2018.11.15 10:11,UNKNOWN,,UNKNOWN-55c0f2b7-dc24-425b-9be8-6b86719f2865,2018.11.15 10:11,UNKNOWN,0,100,0,HDAC,WITHDRAWAL,,,,0,COMPLETED,0,sum-user-id,1669605.484,airdrop-20181115-hdac-sum-user-id-withdrawal,accac570-de75-11e8-bd11-2f9252c4dc2f,AIRDROP,0
airdrop-20181115-hdac-86b3924e-2956-4f16-a899-fb1aa5264a8b-withdrawal-exchange,2018.11.15 10:11,UNKNOWN,,UNKNOWN-55c0f2b7-dc24-425b-9be8-6b86719f2865,2018.11.15 10:11,UNKNOWN,0,100,0,HDAC,WITHDRAWAL,,,,0,COMPLETED,0,sum-user-id,1669505.484,airdrop-20181115-hdac-sum-user-id-withdrawal,accac570-de75-11e8-bd11-2f9252c4dc2f,AIRDROP,0
airdrop-20181115-hdac-86bbab6a-bdd8-4624-a0ad-eec08b709a9c-withdrawal-exchange,2018.11.15 10:11,UNKNOWN,,UNKNOWN-55c0f2b7-dc24-425b-9be8-6b86719f2865,2018.11.15 10:11,UNKNOWN,0,100,0,HDAC,WITHDRAWAL,,,,0,COMPLETED,0,sum-user-id,1669405.484,airdrop-20181115-hdac-sum-user-id-withdrawal,accac570-de75-11e8-bd11-2f9252c4dc2f,AIRDROP,0
airdrop-20181115-hdac-86e49378-9f73-4cda-8333-c8ea1652fa28-withdrawal-exchange,2018.11.15 10:11,UNKNOWN,,UNKNOWN-55c0f2b7-dc24-425b-9be8-6b86719f2865,2018.11.15 10:11,UNKNOWN,0,100,0,HDAC,WITHDRAWAL,,,,0,COMPLETED,0,sum-user-id,1669305.484,airdrop-20181115-hdac-sum-user-id-withdrawal,accac570-de75-11e8-bd11-2f9252c4dc2f,AIRDROP,0
airdrop-20181115-hdac-86e66c17-e2b2-40d6-847e-18b1329c73f7-withdrawal-exchange,2018.11.15 10:11,UNKNOWN,,UNKNOWN-55c0f2b7-dc24-425b-9be8-6b86719f2865,2018.11.15 10:11,UNKNOWN,0,516.21,0,HDAC,WITHDRAWAL,,,,0,COMPLETED,0,sum-user-id,1668789.274,airdrop-20181115-hdac-sum-user-id-withdrawal,accac570-de75-11e8-bd11-2f9252c4dc2f,AIRDROP,0
airdrop-20181115-hdac-87174198-9095-4221-bd48-607fdd1a835c-withdrawal-exchange,2018.11.15 10:11,UNKNOWN,,UNKNOWN-55c0f2b7-dc24-425b-9be8-6b86719f2865,2018.11.15 10:11,UNKNOWN,0,100,0,HDAC,WITHDRAWAL,,,,0,COMPLETED,0,sum-user-id,1668689.274,airdrop-20181115-hdac-sum-user-id-withdrawal,accac570-de75-11e8-bd11-2f9252c4dc2f,AIRDROP,0
airdrop-20181115-hdac-87231253-c40c-4d71-ad1b-1a94214a296c-withdrawal-exchange,2018.11.15 10:11,UNKNOWN,,UNKNOWN-55c0f2b7-dc24-425b-9be8-6b86719f2865,2018.11.15 10:11,UNKNOWN,0,100,0,HDAC,WITHDRAWAL,,,,0,COMPLETED,0,sum-user-id,1668589.274,airdrop-20181115-hdac-sum-user-id-withdrawal,accac570-de75-11e8-bd11-2f9252c4dc2f,AIRDROP,0
airdrop-20181115-hdac-873896a4-9c34-48e7-986c-bdf8fc44be4c-withdrawal-exchange,2018.11.15 10:11,UNKNOWN,,UNKNOWN-55c0f2b7-dc24-425b-9be8-6b86719f2865,2018.11.15 10:11,UNKNOWN,0,100,0,HDAC,WITHDRAWAL,,,,0,COMPLETED,0,sum-user-id,1668489.274,airdrop-20181115-hdac-sum-user-id-withdrawal,accac570-de75-11e8-bd11-2f9252c4dc2f,AIRDROP,0
airdrop-20181115-hdac-8754cfb7-af18-4961-89e9-a2ea95667a60-withdrawal-exchange,2018.11.15 10:11,UNKNOWN,,UNKNOWN-55c0f2b7-dc24-425b-9be8-6b86719f2865,2018.11.15 10:11,UNKNOWN,0,100,0,HDAC,WITHDRAWAL,,,,0,COMPLETED,0,sum-user-id,1668389.274,airdrop-20181115-hdac-sum-user-id-withdrawal,accac570-de75-11e8-bd11-2f9252c4dc2f,AIRDROP,0
airdrop-20181115-hdac-876d865d-6dea-4635-81be-5ff8fd6ce781-withdrawal-exchange,2018.11.15 10:11,UNKNOWN,,UNKNOWN-55c0f2b7-dc24-425b-9be8-6b86719f2865,2018.11.15 10:11,UNKNOWN,0,100,0,HDAC,WITHDRAWAL,,,,0,COMPLETED,0,sum-user-id,1668289.274,airdrop-20181115-hdac-sum-user-id-withdrawal,accac570-de75-11e8-bd11-2f9252c4dc2f,AIRDROP,0
airdrop-20181115-hdac-8788614f-a120-4712-b32b-56008a401d53-withdrawal-exchange,2018.11.15 10:12,UNKNOWN,,UNKNOWN-55c0f2b7-dc24-425b-9be8-6b86719f2865,2018.11.15 10:12,UNKNOWN,0,10100,0,HDAC,WITHDRAWAL,,,,0,COMPLETED,0,sum-user-id,1243759.21,airdrop-20181115-hdac-sum-user-id-withdrawal,accac570-de75-11e8-bd11-2f9252c4dc2f,AIRDROP,0
airdrop-20181115-hdac-878b462c-16f8-4fc4-a008-025360e9b244-withdrawal-exchange,2018.11.15 10:11,UNKNOWN,,UNKNOWN-55c0f2b7-dc24-425b-9be8-6b86719f2865,2018.11.15 10:11,UNKNOWN,0,100,0,HDAC,WITHDRAWAL,,,,0,COMPLETED,0,sum-user-id,1668189.274,airdrop-20181115-hdac-sum-user-id-withdrawal,accac570-de75-11e8-bd11-2f9252c4dc2f,AIRDROP,0
airdrop-20181115-hdac-87be9872-d5c7-4c9e-8ddf-cea13e385395-withdrawal-exchange,2018.11.15 10:11,UNKNOWN,,UNKNOWN-55c0f2b7-dc24-425b-9be8-6b86719f2865,2018.11.15 10:11,UNKNOWN,0,100,0,HDAC,WITHDRAWAL,,,,0,COMPLETED,0,sum-user-id,1668089.274,airdrop-20181115-hdac-sum-user-id-withdrawal,accac570-de75-11e8-bd11-2f9252c4dc2f,AIRDROP,0
airdrop-20181115-hdac-87d441cf-d101-4e8d-9ac3-4f7fd0b587af-withdrawal-exchange,2018.11.15 10:11,UNKNOWN,,UNKNOWN-55c0f2b7-dc24-425b-9be8-6b86719f2865,2018.11.15 10:11,UNKNOWN,0,100,0,HDAC,WITHDRAWAL,,,,0,COMPLETED,0,sum-user-id,1667989.274,airdrop-20181115-hdac-sum-user-id-withdrawal,accac570-de75-11e8-bd11-2f9252c4dc2f,AIRDROP,0
airdrop-20181115-hdac-87d8a309-dc2a-49f0-b273-cbc79bf50d21-withdrawal-exchange,2018.11.15 10:11,UNKNOWN,,UNKNOWN-55c0f2b7-dc24-425b-9be8-6b86719f2865,2018.11.15 10:11,UNKNOWN,0,100,0,HDAC,WITHDRAWAL,,,,0,COMPLETED,0,sum-user-id,1667889.274,airdrop-20181115-hdac-sum-user-id-withdrawal,accac570-de75-11e8-bd11-2f9252c4dc2f,AIRDROP,0
airdrop-20181115-hdac-87df53f6-7171-4c37-b4ae-45a20030f216-withdrawal-exchange,2018.11.15 10:11,UNKNOWN,,UNKNOWN-55c0f2b7-dc24-425b-9be8-6b86719f2865,2018.11.15 10:11,UNKNOWN,0,100,0,HDAC,WITHDRAWAL,,,,0,COMPLETED,0,sum-user-id,1667789.274,airdrop-20181115-hdac-sum-user-id-withdrawal,accac570-de75-11e8-bd11-2f9252c4dc2f,AIRDROP,0
airdrop-20181115-hdac-87f7545d-7719-40ea-8949-cc862e0bbe97-withdrawal-exchange,2018.11.15 10:11,UNKNOWN,,UNKNOWN-55c0f2b7-dc24-425b-9be8-6b86719f2865,2018.11.15 10:11,UNKNOWN,0,100,0,HDAC,WITHDRAWAL,,,,0,COMPLETED,0,sum-user-id,1667689.274,airdrop-20181115-hdac-sum-user-id-withdrawal,accac570-de75-11e8-bd11-2f9252c4dc2f,AIRDROP,0
airdrop-20181115-hdac-8802f105-7556-4a32-b42c-58aba878dad4-withdrawal-exchange,2018-11-15 10:11:49.030,UNKNOWN,,UNKNOWN-55c0f2b7-dc24-425b-9be8-6b86719f2865,2018-11-15 10:11:49.030,UNKNOWN,0,100,0,HDAC,WITHDRAWAL,,,,0,COMPLETED,0,sum-user-id,1667589.274,airdrop-20181115-hdac-sum-user-id-withdrawal,accac570-de75-11e8-bd11-2f9252c4dc2f,AIRDROP,0
airdrop-20181115-hdac-88360d63-9b04-4250-9686-545863087d0f-withdrawal-exchange,2018-11-15 10:11:49.062,UNKNOWN,,UNKNOWN-55c0f2b7-dc24-425b-9be8-6b86719f2865,2018-11-15 10:11:49.062,UNKNOWN,0,100,0,HDAC,WITHDRAWAL,,,,0,COMPLETED,0,sum-user-id,1667489.274,airdrop-20181115-hdac-sum-user-id-withdrawal,accac570-de75-11e8-bd11-2f9252c4dc2f,AIRDROP,0
airdrop-20181115-hdac-883ef92a-31b6-4257-9165-53ab314cb405-withdrawal-exchange,2018-11-15 10:11:49.095,UNKNOWN,,UNKNOWN-55c0f2b7-dc24-425b-9be8-6b86719f2865,2018-11-15 10:11:49.095,UNKNOWN,0,100,0,HDAC,WITHDRAWAL,,,,0,COMPLETED,0,sum-user-id,1667389.274,airdrop-20181115-hdac-sum-user-id-withdrawal,accac570-de75-11e8-bd11-2f9252c4dc2f,AIRDROP,0
airdrop-20181115-hdac-885f05f7-e60e-44ed-a98b-6c253004294b-withdrawal-exchange,2018.11.15 10:11,UNKNOWN,,UNKNOWN-55c0f2b7-dc24-425b-9be8-6b86719f2865,2018.11.15 10:11,UNKNOWN,0,100,0,HDAC,WITHDRAWAL,,,,0,COMPLETED,0,sum-user-id,1667289.274,airdrop-20181115-hdac-sum-user-id-withdrawal,accac570-de75-11e8-bd11-2f9252c4dc2f,AIRDROP,0
airdrop-20181115-hdac-887aa39c-1d35-40b7-b974-48a323cd969b-withdrawal-exchange,2018.11.15 10:11,UNKNOWN,,UNKNOWN-55c0f2b7-dc24-425b-9be8-6b86719f2865,2018.11.15 10:11,UNKNOWN,0,100,0,HDAC,WITHDRAWAL,,,,0,COMPLETED,0,sum-user-id,1667189.274,airdrop-20181115-hdac-sum-user-id-withdrawal,accac570-de75-11e8-bd11-2f9252c4dc2f,AIRDROP,0
airdrop-20181115-hdac-88dad0ee-8cf9-4593-939a-242fb2e5243a-withdrawal-exchange,2018.11.15 10:11,UNKNOWN,,UNKNOWN-55c0f2b7-dc24-425b-9be8-6b86719f2865,2018.11.15 10:11,UNKNOWN,0,100,0,HDAC,WITHDRAWAL,,,,0,COMPLETED,0,sum-user-id,1667089.274,airdrop-20181115-hdac-sum-user-id-withdrawal,accac570-de75-11e8-bd11-2f9252c4dc2f,AIRDROP,0
airdrop-20181115-hdac-8915b744-bb62-40bf-97e1-55dbdc5109b6-withdrawal-exchange,2018.11.15 10:11,UNKNOWN,,UNKNOWN-55c0f2b7-dc24-425b-9be8-6b86719f2865,2018.11.15 10:11,UNKNOWN,0,100,0,HDAC,WITHDRAWAL,,,,0,COMPLETED,0,sum-user-id,1666989.274,airdrop-20181115-hdac-sum-user-id-withdrawal,accac570-de75-11e8-bd11-2f9252c4dc2f,AIRDROP,0
airdrop-20181115-hdac-894a8958-a12d-407f-ba03-2248123e6b55-withdrawal-exchange,2018.11.15 10:11,UNKNOWN,,UNKNOWN-55c0f2b7-dc24-425b-9be8-6b86719f2865,2018.11.15 10:11,UNKNOWN,0,100,0,HDAC,WITHDRAWAL,,,,0,COMPLETED,0,sum-user-id,1666889.274,airdrop-20181115-hdac-sum-user-id-withdrawal,accac570-de75-11e8-bd11-2f9252c4dc2f,AIRDROP,0
airdrop-20181115-hdac-894e94b6-c5b4-486c-8ca8-dac60e9d3a83-withdrawal-exchange,2018.11.15 10:11,UNKNOWN,,UNKNOWN-55c0f2b7-dc24-425b-9be8-6b86719f2865,2018.11.15 10:11,UNKNOWN,0,100,0,HDAC,WITHDRAWAL,,,,0,COMPLETED,0,sum-user-id,1666789.274,airdrop-20181115-hdac-sum-user-id-withdrawal,accac570-de75-11e8-bd11-2f9252c4dc2f,AIRDROP,0
airdrop-20181115-hdac-8960781f-6afa-450e-bd07-a421f3c2f168-withdrawal-exchange,2018.11.15 10:11,UNKNOWN,,UNKNOWN-55c0f2b7-dc24-425b-9be8-6b86719f2865,2018.11.15 10:11,UNKNOWN,0,100,0,HDAC,WITHDRAWAL,,,,0,COMPLETED,0,sum-user-id,1666689.274,airdrop-20181115-hdac-sum-user-id-withdrawal,accac570-de75-11e8-bd11-2f9252c4dc2f,AIRDROP,0
airdrop-20181115-hdac-89627f13-d824-40ad-a5df-9b5772facf3f-withdrawal-exchange,2018.11.15 10:11,UNKNOWN,,UNKNOWN-55c0f2b7-dc24-425b-9be8-6b86719f2865,2018.11.15 10:11,UNKNOWN,0,100,0,HDAC,WITHDRAWAL,,,,0,COMPLETED,0,sum-user-id,1666589.274,airdrop-20181115-hdac-sum-user-id-withdrawal,accac570-de75-11e8-bd11-2f9252c4dc2f,AIRDROP,0
airdrop-20181115-hdac-89870657-5f9c-4fdb-a78a-3de00c4d9f27-withdrawal-exchange,2018.11.15 10:11,UNKNOWN,,UNKNOWN-55c0f2b7-dc24-425b-9be8-6b86719f2865,2018.11.15 10:11,UNKNOWN,0,100,0,HDAC,WITHDRAWAL,,,,0,COMPLETED,0,sum-user-id,1666489.274,airdrop-20181115-hdac-sum-user-id-withdrawal,accac570-de75-11e8-bd11-2f9252c4dc2f,AIRDROP,0
airdrop-20181115-hdac-89d45040-3ef9-47c1-8b8f-a950ac467d73-withdrawal-exchange,2018.11.15 10:11,UNKNOWN,,UNKNOWN-55c0f2b7-dc24-425b-9be8-6b86719f2865,2018.11.15 10:11,UNKNOWN,0,100,0,HDAC,WITHDRAWAL,,,,0,COMPLETED,0,sum-user-id,1666389.274,airdrop-20181115-hdac-sum-user-id-withdrawal,accac570-de75-11e8-bd11-2f9252c4dc2f,AIRDROP,0
airdrop-20181115-hdac-89d9f435-90a4-47ec-93f9-6096c832b27d-withdrawal-exchange,2018.11.15 10:11,UNKNOWN,,UNKNOWN-55c0f2b7-dc24-425b-9be8-6b86719f2865,2018.11.15 10:11,UNKNOWN,0,100,0,HDAC,WITHDRAWAL,,,,0,COMPLETED,0,sum-user-id,1666289.274,airdrop-20181115-hdac-sum-user-id-withdrawal,accac570-de75-11e8-bd11-2f9252c4dc2f,AIRDROP,0
airdrop-20181115-hdac-89e17113-ed98-4250-8d5c-c41a49ef7c15-withdrawal-exchange,2018.11.15 10:11,UNKNOWN,,UNKNOWN-55c0f2b7-dc24-425b-9be8-6b86719f2865,2018.11.15 10:11,UNKNOWN,0,100,0,HDAC,WITHDRAWAL,,,,0,COMPLETED,0,sum-user-id,1666189.274,airdrop-20181115-hdac-sum-user-id-withdrawal,accac570-de75-11e8-bd11-2f9252c4dc2f,AIRDROP,0
airdrop-20181115-hdac-89e490ce-84a5-41ea-8de6-396d86fee8d1-withdrawal-exchange,2018.11.15 10:11,UNKNOWN,,UNKNOWN-55c0f2b7-dc24-425b-9be8-6b86719f2865,2018.11.15 10:11,UNKNOWN,0,100,0,HDAC,WITHDRAWAL,,,,0,COMPLETED,0,sum-user-id,1666089.274,airdrop-20181115-hdac-sum-user-id-withdrawal,accac570-de75-11e8-bd11-2f9252c4dc2f,AIRDROP,0
airdrop-20181115-hdac-89effe43-bd41-49e6-afff-c67f6cf29fbc-withdrawal-exchange,2018.11.15 10:11,UNKNOWN,,UNKNOWN-55c0f2b7-dc24-425b-9be8-6b86719f2865,2018.11.15 10:11,UNKNOWN,0,100,0,HDAC,WITHDRAWAL,,,,0,COMPLETED,0,sum-user-id,1665989.274,airdrop-20181115-hdac-sum-user-id-withdrawal,accac570-de75-11e8-bd11-2f9252c4dc2f,AIRDROP,0
airdrop-20181115-hdac-8a3cdd5d-1c10-48e5-b4f0-86291eef4706-withdrawal-exchange,2018.11.15 10:11,UNKNOWN,,UNKNOWN-55c0f2b7-dc24-425b-9be8-6b86719f2865,2018.11.15 10:11,UNKNOWN,0,100,0,HDAC,WITHDRAWAL,,,,0,COMPLETED,0,sum-user-id,1665889.274,airdrop-20181115-hdac-sum-user-id-withdrawal,accac570-de75-11e8-bd11-2f9252c4dc2f,AIRDROP,0
airdrop-20181115-hdac-8a3fa6e5-98d5-438b-b338-f93f3ef1b378-withdrawal-exchange,2018.11.15 10:11,UNKNOWN,,UNKNOWN-55c0f2b7-dc24-425b-9be8-6b86719f2865,2018.11.15 10:11,UNKNOWN,0,100,0,HDAC,WITHDRAWAL,,,,0,COMPLETED,0,sum-user-id,1665789.274,airdrop-20181115-hdac-sum-user-id-withdrawal,accac570-de75-11e8-bd11-2f9252c4dc2f,AIRDROP,0
airdrop-20181115-hdac-8a5bc708-17be-45f0-ae12-0e1d04f56c15-withdrawal-exchange,2018.11.15 10:11,UNKNOWN,,UNKNOWN-55c0f2b7-dc24-425b-9be8-6b86719f2865,2018.11.15 10:11,UNKNOWN,0,100,0,HDAC,WITHDRAWAL,,,,0,COMPLETED,0,sum-user-id,1665689.274,airdrop-20181115-hdac-sum-user-id-withdrawal,accac570-de75-11e8-bd11-2f9252c4dc2f,AIRDROP,0
airdrop-20181115-hdac-8a5e4043-9998-4ba7-9cb1-71adf5887686-withdrawal-exchange,2018.11.15 10:11,UNKNOWN,,UNKNOWN-55c0f2b7-dc24-425b-9be8-6b86719f2865,2018.11.15 10:11,UNKNOWN,0,100,0,HDAC,WITHDRAWAL,,,,0,COMPLETED,0,sum-user-id,1665589.274,airdrop-20181115-hdac-sum-user-id-withdrawal,accac570-de75-11e8-bd11-2f9252c4dc2f,AIRDROP,0
airdrop-20181115-hdac-8a7c4671-254b-4620-a478-055ef36c9fcb-withdrawal-exchange,2018.11.15 10:11,UNKNOWN,,UNKNOWN-55c0f2b7-dc24-425b-9be8-6b86719f2865,2018.11.15 10:11,UNKNOWN,0,100,0,HDAC,WITHDRAWAL,,,,0,COMPLETED,0,sum-user-id,1665489.274,airdrop-20181115-hdac-sum-user-id-withdrawal,accac570-de75-11e8-bd11-2f9252c4dc2f,AIRDROP,0
airdrop-20181115-hdac-8aaa9505-84c4-415a-b046-7d59e8316341-withdrawal-exchange,2018.11.15 10:11,UNKNOWN,,UNKNOWN-55c0f2b7-dc24-425b-9be8-6b86719f2865,2018.11.15 10:11,UNKNOWN,0,100,0,HDAC,WITHDRAWAL,,,,0,COMPLETED,0,sum-user-id,1665389.274,airdrop-20181115-hdac-sum-user-id-withdrawal,accac570-de75-11e8-bd11-2f9252c4dc2f,AIRDROP,0
airdrop-20181115-hdac-8ad62b0f-b6ce-4cf6-99ad-cd8edd0fe81f-withdrawal-exchange,2018.11.15 10:11,UNKNOWN,,UNKNOWN-55c0f2b7-dc24-425b-9be8-6b86719f2865,2018.11.15 10:11,UNKNOWN,0,100,0,HDAC,WITHDRAWAL,,,,0,COMPLETED,0,sum-user-id,1665289.274,airdrop-20181115-hdac-sum-user-id-withdrawal,accac570-de75-11e8-bd11-2f9252c4dc2f,AIRDROP,0
airdrop-20181115-hdac-8adc96ac-ca46-4f4b-8ff1-c9d4944c6165-withdrawal-exchange,2018.11.15 10:11,UNKNOWN,,UNKNOWN-55c0f2b7-dc24-425b-9be8-6b86719f2865,2018.11.15 10:11,UNKNOWN,0,100,0,HDAC,WITHDRAWAL,,,,0,COMPLETED,0,sum-user-id,1665189.274,airdrop-20181115-hdac-sum-user-id-withdrawal,accac570-de75-11e8-bd11-2f9252c4dc2f,AIRDROP,0
airdrop-20181115-hdac-8b437e47-f896-4843-8ba0-1fcd33c563a6-withdrawal-exchange,2018.11.15 10:11,UNKNOWN,,UNKNOWN-55c0f2b7-dc24-425b-9be8-6b86719f2865,2018.11.15 10:11,UNKNOWN,0,100,0,HDAC,WITHDRAWAL,,,,0,COMPLETED,0,sum-user-id,1665089.274,airdrop-20181115-hdac-sum-user-id-withdrawal,accac570-de75-11e8-bd11-2f9252c4dc2f,AIRDROP,0
airdrop-20181115-hdac-8b73a0e7-7fd7-4a39-9097-3134b90579f0-withdrawal-exchange,2018.11.15 10:11,UNKNOWN,,UNKNOWN-55c0f2b7-dc24-425b-9be8-6b86719f2865,2018.11.15 10:11,UNKNOWN,0,100,0,HDAC,WITHDRAWAL,,,,0,COMPLETED,0,sum-user-id,1664989.274,airdrop-20181115-hdac-sum-user-id-withdrawal,accac570-de75-11e8-bd11-2f9252c4dc2f,AIRDROP,0
airdrop-20181115-hdac-8b8486d5-502b-4e46-956c-73c321a28535-withdrawal-exchange,2018.11.15 10:11,UNKNOWN,,UNKNOWN-55c0f2b7-dc24-425b-9be8-6b86719f2865,2018.11.15 10:11,UNKNOWN,0,100,0,HDAC,WITHDRAWAL,,,,0,COMPLETED,0,sum-user-id,1664889.274,airdrop-20181115-hdac-sum-user-id-withdrawal,accac570-de75-11e8-bd11-2f9252c4dc2f,AIRDROP,0
airdrop-20181115-hdac-8ba6ff89-e541-4fdd-93a6-d61181a53a50-withdrawal-exchange,2018.11.15 10:11,UNKNOWN,,UNKNOWN-55c0f2b7-dc24-425b-9be8-6b86719f2865,2018.11.15 10:11,UNKNOWN,0,100,0,HDAC,WITHDRAWAL,,,,0,COMPLETED,0,sum-user-id,1664789.274,airdrop-20181115-hdac-sum-user-id-withdrawal,accac570-de75-11e8-bd11-2f9252c4dc2f,AIRDROP,0
airdrop-20181115-hdac-8bca708e-c8c6-4060-8a4d-4dbef47b8dec-withdrawal-exchange,2018.11.15 10:11,UNKNOWN,,UNKNOWN-55c0f2b7-dc24-425b-9be8-6b86719f2865,2018.11.15 10:11,UNKNOWN,0,100,0,HDAC,WITHDRAWAL,,,,0,COMPLETED,0,sum-user-id,1664689.274,airdrop-20181115-hdac-sum-user-id-withdrawal,accac570-de75-11e8-bd11-2f9252c4dc2f,AIRDROP,0
airdrop-20181115-hdac-8bcdb493-02c7-465f-98af-1de65d77744a-withdrawal-exchange,2018-11-15 10:11:50.010,UNKNOWN,,UNKNOWN-55c0f2b7-dc24-425b-9be8-6b86719f2865,2018-11-15 10:11:50.010,UNKNOWN,0,100,0,HDAC,WITHDRAWAL,,,,0,COMPLETED,0,sum-user-id,1664589.274,airdrop-20181115-hdac-sum-user-id-withdrawal,accac570-de75-11e8-bd11-2f9252c4dc2f,AIRDROP,0
airdrop-20181115-hdac-8bd055b1-ae51-4c5b-82ef-7221dab12835-withdrawal-exchange,2018-11-15 10:11:50.042,UNKNOWN,,UNKNOWN-55c0f2b7-dc24-425b-9be8-6b86719f2865,2018-11-15 10:11:50.042,UNKNOWN,0,100,0,HDAC,WITHDRAWAL,,,,0,COMPLETED,0,sum-user-id,1664489.274,airdrop-20181115-hdac-sum-user-id-withdrawal,accac570-de75-11e8-bd11-2f9252c4dc2f,AIRDROP,0
airdrop-20181115-hdac-8bea2c35-6355-4ba4-bf76-a0bfc4e3369c-withdrawal-exchange,2018-11-15 10:11:50.074,UNKNOWN,,UNKNOWN-55c0f2b7-dc24-425b-9be8-6b86719f2865,2018-11-15 10:11:50.074,UNKNOWN,0,100,0,HDAC,WITHDRAWAL,,,,0,COMPLETED,0,sum-user-id,1664389.274,airdrop-20181115-hdac-sum-user-id-withdrawal,accac570-de75-11e8-bd11-2f9252c4dc2f,AIRDROP,0
airdrop-20181115-hdac-8c654769-2cb9-43e1-8de1-c4ffc9dee693-withdrawal-exchange,2018.11.15 10:11,UNKNOWN,,UNKNOWN-55c0f2b7-dc24-425b-9be8-6b86719f2865,2018.11.15 10:11,UNKNOWN,0,100,0,HDAC,WITHDRAWAL,,,,0,COMPLETED,0,sum-user-id,1664289.274,airdrop-20181115-hdac-sum-user-id-withdrawal,accac570-de75-11e8-bd11-2f9252c4dc2f,AIRDROP,0
airdrop-20181115-hdac-8c868bba-d7eb-493a-b930-48bfeb322d9c-withdrawal-exchange,2018.11.15 10:11,UNKNOWN,,UNKNOWN-55c0f2b7-dc24-425b-9be8-6b86719f2865,2018.11.15 10:11,UNKNOWN,0,100,0,HDAC,WITHDRAWAL,,,,0,COMPLETED,0,sum-user-id,1664189.274,airdrop-20181115-hdac-sum-user-id-withdrawal,accac570-de75-11e8-bd11-2f9252c4dc2f,AIRDROP,0
airdrop-20181115-hdac-8c899119-ec0f-421b-8bbd-f4ed3d35cb2c-withdrawal-exchange,2018.11.15 10:11,UNKNOWN,,UNKNOWN-55c0f2b7-dc24-425b-9be8-6b86719f2865,2018.11.15 10:11,UNKNOWN,0,100,0,HDAC,WITHDRAWAL,,,,0,COMPLETED,0,sum-user-id,1664089.274,airdrop-20181115-hdac-sum-user-id-withdrawal,accac570-de75-11e8-bd11-2f9252c4dc2f,AIRDROP,0
airdrop-20181115-hdac-8c9707ce-0758-49ef-85e4-e9154cc50b95-withdrawal-exchange,2018.11.15 10:11,UNKNOWN,,UNKNOWN-55c0f2b7-dc24-425b-9be8-6b86719f2865,2018.11.15 10:11,UNKNOWN,0,100,0,HDAC,WITHDRAWAL,,,,0,COMPLETED,0,sum-user-id,1663989.274,airdrop-20181115-hdac-sum-user-id-withdrawal,accac570-de75-11e8-bd11-2f9252c4dc2f,AIRDROP,0
airdrop-20181115-hdac-8c97aa3a-970a-44ce-b9ac-9d2e2cafde5e-withdrawal-exchange,2018.11.15 10:11,UNKNOWN,,UNKNOWN-55c0f2b7-dc24-425b-9be8-6b86719f2865,2018.11.15 10:11,UNKNOWN,0,100,0,HDAC,WITHDRAWAL,,,,0,COMPLETED,0,sum-user-id,1663889.274,airdrop-20181115-hdac-sum-user-id-withdrawal,accac570-de75-11e8-bd11-2f9252c4dc2f,AIRDROP,0
airdrop-20181115-hdac-8cba5771-cedc-4511-ab75-3bc5a3c915f4-withdrawal-exchange,2018.11.15 10:11,UNKNOWN,,UNKNOWN-55c0f2b7-dc24-425b-9be8-6b86719f2865,2018.11.15 10:11,UNKNOWN,0,100,0,HDAC,WITHDRAWAL,,,,0,COMPLETED,0,sum-user-id,1663789.274,airdrop-20181115-hdac-sum-user-id-withdrawal,accac570-de75-11e8-bd11-2f9252c4dc2f,AIRDROP,0
airdrop-20181115-hdac-8cbcedb9-40c9-4074-b70f-2f70980e0318-withdrawal-exchange,2018.11.15 10:11,UNKNOWN,,UNKNOWN-55c0f2b7-dc24-425b-9be8-6b86719f2865,2018.11.15 10:11,UNKNOWN,0,100,0,HDAC,WITHDRAWAL,,,,0,COMPLETED,0,sum-user-id,1663689.274,airdrop-20181115-hdac-sum-user-id-withdrawal,accac570-de75-11e8-bd11-2f9252c4dc2f,AIRDROP,0
airdrop-20181115-hdac-8ccac64f-e682-43c4-a7b7-255e59d50fb3-withdrawal-exchange,2018.11.15 10:11,UNKNOWN,,UNKNOWN-55c0f2b7-dc24-425b-9be8-6b86719f2865,2018.11.15 10:11,UNKNOWN,0,100,0,HDAC,WITHDRAWAL,,,,0,COMPLETED,0,sum-user-id,1663589.274,airdrop-20181115-hdac-sum-user-id-withdrawal,accac570-de75-11e8-bd11-2f9252c4dc2f,AIRDROP,0
airdrop-20181115-hdac-8ce58ee3-7a3e-4b22-bdf9-a1b3f434cc2d-withdrawal-exchange,2018.11.15 10:11,UNKNOWN,,UNKNOWN-55c0f2b7-dc24-425b-9be8-6b86719f2865,2018.11.15 10:11,UNKNOWN,0,100,0,HDAC,WITHDRAWAL,,,,0,COMPLETED,0,sum-user-id,1663489.274,airdrop-20181115-hdac-sum-user-id-withdrawal,accac570-de75-11e8-bd11-2f9252c4dc2f,AIRDROP,0
airdrop-20181115-hdac-8d3d2da3-b21d-4bb4-96c5-1ac715937cad-withdrawal-exchange,2018.11.15 10:11,UNKNOWN,,UNKNOWN-55c0f2b7-dc24-425b-9be8-6b86719f2865,2018.11.15 10:11,UNKNOWN,0,100,0,HDAC,WITHDRAWAL,,,,0,COMPLETED,0,sum-user-id,1663389.274,airdrop-20181115-hdac-sum-user-id-withdrawal,accac570-de75-11e8-bd11-2f9252c4dc2f,AIRDROP,0
airdrop-20181115-hdac-8d59517c-54a5-4e19-8120-01d31dbd48c5-withdrawal-exchange,2018.11.15 10:11,UNKNOWN,,UNKNOWN-55c0f2b7-dc24-425b-9be8-6b86719f2865,2018.11.15 10:11,UNKNOWN,0,100,0,HDAC,WITHDRAWAL,,,,0,COMPLETED,0,sum-user-id,1663289.274,airdrop-20181115-hdac-sum-user-id-withdrawal,accac570-de75-11e8-bd11-2f9252c4dc2f,AIRDROP,0
airdrop-20181115-hdac-8d7d013b-9b97-4987-88c9-b4281e1edcab-withdrawal-exchange,2018.11.15 10:11,UNKNOWN,,UNKNOWN-55c0f2b7-dc24-425b-9be8-6b86719f2865,2018.11.15 10:11,UNKNOWN,0,100,0,HDAC,WITHDRAWAL,,,,0,COMPLETED,0,sum-user-id,1663189.274,airdrop-20181115-hdac-sum-user-id-withdrawal,accac570-de75-11e8-bd11-2f9252c4dc2f,AIRDROP,0
airdrop-20181115-hdac-8d7ec481-2e7a-440f-9f02-e448b6b98057-withdrawal-exchange,2018.11.15 10:11,UNKNOWN,,UNKNOWN-55c0f2b7-dc24-425b-9be8-6b86719f2865,2018.11.15 10:11,UNKNOWN,0,100,0,HDAC,WITHDRAWAL,,,,0,COMPLETED,0,sum-user-id,1663089.274,airdrop-20181115-hdac-sum-user-id-withdrawal,accac570-de75-11e8-bd11-2f9252c4dc2f,AIRDROP,0
airdrop-20181115-hdac-8d8b2154-d375-4c97-b31c-0b9d7c859928-withdrawal-exchange,2018.11.15 10:11,UNKNOWN,,UNKNOWN-55c0f2b7-dc24-425b-9be8-6b86719f2865,2018.11.15 10:11,UNKNOWN,0,100,0,HDAC,WITHDRAWAL,,,,0,COMPLETED,0,sum-user-id,1662989.274,airdrop-20181115-hdac-sum-user-id-withdrawal,accac570-de75-11e8-bd11-2f9252c4dc2f,AIRDROP,0
airdrop-20181115-hdac-8d985170-18a3-4800-a764-90d0484b31a8-withdrawal-exchange,2018.11.15 10:11,UNKNOWN,,UNKNOWN-55c0f2b7-dc24-425b-9be8-6b86719f2865,2018.11.15 10:11,UNKNOWN,0,100,0,HDAC,WITHDRAWAL,,,,0,COMPLETED,0,sum-user-id,1662889.274,airdrop-20181115-hdac-sum-user-id-withdrawal,accac570-de75-11e8-bd11-2f9252c4dc2f,AIRDROP,0
airdrop-20181115-hdac-8da917ce-6fea-4524-b6a2-86522c9dd551-withdrawal-exchange,2018.11.15 10:11,UNKNOWN,,UNKNOWN-55c0f2b7-dc24-425b-9be8-6b86719f2865,2018.11.15 10:11,UNKNOWN,0,100,0,HDAC,WITHDRAWAL,,,,0,COMPLETED,0,sum-user-id,1662789.274,airdrop-20181115-hdac-sum-user-id-withdrawal,accac570-de75-11e8-bd11-2f9252c4dc2f,AIRDROP,0
airdrop-20181115-hdac-8dd82da5-ddfd-4e55-a322-2bd037b3282d-withdrawal-exchange,2018.11.15 10:11,UNKNOWN,,UNKNOWN-55c0f2b7-dc24-425b-9be8-6b86719f2865,2018.11.15 10:11,UNKNOWN,0,100,0,HDAC,WITHDRAWAL,,,,0,COMPLETED,0,sum-user-id,1662689.274,airdrop-20181115-hdac-sum-user-id-withdrawal,accac570-de75-11e8-bd11-2f9252c4dc2f,AIRDROP,0
airdrop-20181115-hdac-8ddb8d02-a9b3-445f-a5b1-592783c76f95-withdrawal-exchange,2018.11.15 10:11,UNKNOWN,,UNKNOWN-55c0f2b7-dc24-425b-9be8-6b86719f2865,2018.11.15 10:11,UNKNOWN,0,100,0,HDAC,WITHDRAWAL,,,,0,COMPLETED,0,sum-user-id,1662589.274,airdrop-20181115-hdac-sum-user-id-withdrawal,accac570-de75-11e8-bd11-2f9252c4dc2f,AIRDROP,0
airdrop-20181115-hdac-8e042e6c-c769-401b-9c59-b046df671875-withdrawal-exchange,2018.11.15 10:11,UNKNOWN,,UNKNOWN-55c0f2b7-dc24-425b-9be8-6b86719f2865,2018.11.15 10:11,UNKNOWN,0,100,0,HDAC,WITHDRAWAL,,,,0,COMPLETED,0,sum-user-id,1662489.274,airdrop-20181115-hdac-sum-user-id-withdrawal,accac570-de75-11e8-bd11-2f9252c4dc2f,AIRDROP,0
airdrop-20181115-hdac-8e0c9887-c22d-4892-acb9-2c7c0db6a4bb-withdrawal-exchange,2018.11.15 10:11,UNKNOWN,,UNKNOWN-55c0f2b7-dc24-425b-9be8-6b86719f2865,2018.11.15 10:11,UNKNOWN,0,100,0,HDAC,WITHDRAWAL,,,,0,COMPLETED,0,sum-user-id,1662389.274,airdrop-20181115-hdac-sum-user-id-withdrawal,accac570-de75-11e8-bd11-2f9252c4dc2f,AIRDROP,0
airdrop-20181115-hdac-8e3e19b6-6f1c-4ad9-8f12-873e81f43ca7-withdrawal-exchange,2018.11.15 10:11,UNKNOWN,,UNKNOWN-55c0f2b7-dc24-425b-9be8-6b86719f2865,2018.11.15 10:11,UNKNOWN,0,100,0,HDAC,WITHDRAWAL,,,,0,COMPLETED,0,sum-user-id,1662289.274,airdrop-20181115-hdac-sum-user-id-withdrawal,accac570-de75-11e8-bd11-2f9252c4dc2f,AIRDROP,0
airdrop-20181115-hdac-8e4669ad-4df3-4e07-b443-b89f0457cefc-withdrawal-exchange,2018.11.15 10:11,UNKNOWN,,UNKNOWN-55c0f2b7-dc24-425b-9be8-6b86719f2865,2018.11.15 10:11,UNKNOWN,0,100,0,HDAC,WITHDRAWAL,,,,0,COMPLETED,0,sum-user-id,1662189.274,airdrop-20181115-hdac-sum-user-id-withdrawal,accac570-de75-11e8-bd11-2f9252c4dc2f,AIRDROP,0
airdrop-20181115-hdac-8e6c35f2-3188-455e-9e01-fc1698fea505-withdrawal-exchange,2018.11.15 10:11,UNKNOWN,,UNKNOWN-55c0f2b7-dc24-425b-9be8-6b86719f2865,2018.11.15 10:11,UNKNOWN,0,100,0,HDAC,WITHDRAWAL,,,,0,COMPLETED,0,sum-user-id,1662089.274,airdrop-20181115-hdac-sum-user-id-withdrawal,accac570-de75-11e8-bd11-2f9252c4dc2f,AIRDROP,0
airdrop-20181115-hdac-8e843622-4739-43bb-93ad-540bb8f31c05-withdrawal-exchange,2018.11.15 10:11,UNKNOWN,,UNKNOWN-55c0f2b7-dc24-425b-9be8-6b86719f2865,2018.11.15 10:11,UNKNOWN,0,100,0,HDAC,WITHDRAWAL,,,,0,COMPLETED,0,sum-user-id,1661989.274,airdrop-20181115-hdac-sum-user-id-withdrawal,accac570-de75-11e8-bd11-2f9252c4dc2f,AIRDROP,0
airdrop-20181115-hdac-8eb7619c-2327-47fc-b831-ba270160c862-withdrawal-exchange,2018.11.15 10:11,UNKNOWN,,UNKNOWN-55c0f2b7-dc24-425b-9be8-6b86719f2865,2018.11.15 10:11,UNKNOWN,0,100,0,HDAC,WITHDRAWAL,,,,0,COMPLETED,0,sum-user-id,1661889.274,airdrop-20181115-hdac-sum-user-id-withdrawal,accac570-de75-11e8-bd11-2f9252c4dc2f,AIRDROP,0
airdrop-20181115-hdac-8ebba7f5-4ff8-4833-b150-f3d8b54c0c19-withdrawal-exchange,2018.11.15 10:11,UNKNOWN,,UNKNOWN-55c0f2b7-dc24-425b-9be8-6b86719f2865,2018.11.15 10:11,UNKNOWN,0,100,0,HDAC,WITHDRAWAL,,,,0,COMPLETED,0,sum-user-id,1661789.274,airdrop-20181115-hdac-sum-user-id-withdrawal,accac570-de75-11e8-bd11-2f9252c4dc2f,AIRDROP,0
airdrop-20181115-hdac-8ede69bb-594a-4a00-820c-81e9b90c04f1-withdrawal-exchange,2018.11.15 10:11,UNKNOWN,,UNKNOWN-55c0f2b7-dc24-425b-9be8-6b86719f2865,2018.11.15 10:11,UNKNOWN,0,100,0,HDAC,WITHDRAWAL,,,,0,COMPLETED,0,sum-user-id,1661689.274,airdrop-20181115-hdac-sum-user-id-withdrawal,accac570-de75-11e8-bd11-2f9252c4dc2f,AIRDROP,0
airdrop-20181115-hdac-8ee326ef-0e13-4689-b81b-083d3dd32d68-withdrawal-exchange,2018.11.15 10:11,UNKNOWN,,UNKNOWN-55c0f2b7-dc24-425b-9be8-6b86719f2865,2018.11.15 10:11,UNKNOWN,0,100,0,HDAC,WITHDRAWAL,,,,0,COMPLETED,0,sum-user-id,1661589.274,airdrop-20181115-hdac-sum-user-id-withdrawal,accac570-de75-11e8-bd11-2f9252c4dc2f,AIRDROP,0
airdrop-20181115-hdac-8ef046eb-8ffe-4bb8-b896-4bcfb874647a-withdrawal-exchange,2018-11-15 10:11:51.012,UNKNOWN,,UNKNOWN-55c0f2b7-dc24-425b-9be8-6b86719f2865,2018-11-15 10:11:51.012,UNKNOWN,0,100,0,HDAC,WITHDRAWAL,,,,0,COMPLETED,0,sum-user-id,1661489.274,airdrop-20181115-hdac-sum-user-id-withdrawal,accac570-de75-11e8-bd11-2f9252c4dc2f,AIRDROP,0
airdrop-20181115-hdac-8f04a9eb-0aa8-4b0c-8e07-16cfa1bb71d2-withdrawal-exchange,2018-11-15 10:11:51.044,UNKNOWN,,UNKNOWN-55c0f2b7-dc24-425b-9be8-6b86719f2865,2018-11-15 10:11:51.044,UNKNOWN,0,100,0,HDAC,WITHDRAWAL,,,,0,COMPLETED,0,sum-user-id,1661389.274,airdrop-20181115-hdac-sum-user-id-withdrawal,accac570-de75-11e8-bd11-2f9252c4dc2f,AIRDROP,0
airdrop-20181115-hdac-8f3bc803-55f3-438b-8fce-711c46532557-withdrawal-exchange,2018-11-15 10:11:51.075,UNKNOWN,,UNKNOWN-55c0f2b7-dc24-425b-9be8-6b86719f2865,2018-11-15 10:11:51.075,UNKNOWN,0,100,0,HDAC,WITHDRAWAL,,,,0,COMPLETED,0,sum-user-id,1661289.274,airdrop-20181115-hdac-sum-user-id-withdrawal,accac570-de75-11e8-bd11-2f9252c4dc2f,AIRDROP,0
airdrop-20181115-hdac-8f5356ba-8044-40a5-b43a-65ed44a489dc-withdrawal-exchange,2018.11.15 10:11,UNKNOWN,,UNKNOWN-55c0f2b7-dc24-425b-9be8-6b86719f2865,2018.11.15 10:11,UNKNOWN,0,100,0,HDAC,WITHDRAWAL,,,,0,COMPLETED,0,sum-user-id,1661189.274,airdrop-20181115-hdac-sum-user-id-withdrawal,accac570-de75-11e8-bd11-2f9252c4dc2f,AIRDROP,0
airdrop-20181115-hdac-8f53c261-ac79-4711-a896-4299dc06c1d3-withdrawal-exchange,2018.11.15 10:11,UNKNOWN,,UNKNOWN-55c0f2b7-dc24-425b-9be8-6b86719f2865,2018.11.15 10:11,UNKNOWN,0,100,0,HDAC,WITHDRAWAL,,,,0,COMPLETED,0,sum-user-id,1661089.274,airdrop-20181115-hdac-sum-user-id-withdrawal,accac570-de75-11e8-bd11-2f9252c4dc2f,AIRDROP,0
airdrop-20181115-hdac-8f547c1b-829b-416e-a6e6-aff512240e68-withdrawal-exchange,2018.11.15 10:11,UNKNOWN,,UNKNOWN-55c0f2b7-dc24-425b-9be8-6b86719f2865,2018.11.15 10:11,UNKNOWN,0,100,0,HDAC,WITHDRAWAL,,,,0,COMPLETED,0,sum-user-id,1660989.274,airdrop-20181115-hdac-sum-user-id-withdrawal,accac570-de75-11e8-bd11-2f9252c4dc2f,AIRDROP,0
airdrop-20181115-hdac-8f7a0238-3704-45b6-a8ce-883099d67e51-withdrawal-exchange,2018.11.15 10:11,UNKNOWN,,UNKNOWN-55c0f2b7-dc24-425b-9be8-6b86719f2865,2018.11.15 10:11,UNKNOWN,0,100,0,HDAC,WITHDRAWAL,,,,0,COMPLETED,0,sum-user-id,1660889.274,airdrop-20181115-hdac-sum-user-id-withdrawal,accac570-de75-11e8-bd11-2f9252c4dc2f,AIRDROP,0
airdrop-20181115-hdac-8f7ea589-8aa8-4716-886a-4d9b31dccd2a-withdrawal-exchange,2018.11.15 10:11,UNKNOWN,,UNKNOWN-55c0f2b7-dc24-425b-9be8-6b86719f2865,2018.11.15 10:11,UNKNOWN,0,100,0,HDAC,WITHDRAWAL,,,,0,COMPLETED,0,sum-user-id,1660789.274,airdrop-20181115-hdac-sum-user-id-withdrawal,accac570-de75-11e8-bd11-2f9252c4dc2f,AIRDROP,0
airdrop-20181115-hdac-8fb684b8-abe5-489a-93dc-38db137111fe-withdrawal-exchange,2018.11.15 10:11,UNKNOWN,,UNKNOWN-55c0f2b7-dc24-425b-9be8-6b86719f2865,2018.11.15 10:11,UNKNOWN,0,100,0,HDAC,WITHDRAWAL,,,,0,COMPLETED,0,sum-user-id,1660689.274,airdrop-20181115-hdac-sum-user-id-withdrawal,accac570-de75-11e8-bd11-2f9252c4dc2f,AIRDROP,0
airdrop-20181115-hdac-8fcd4288-cef7-460c-8983-f5abdb65785e-withdrawal-exchange,2018.11.15 10:11,UNKNOWN,,UNKNOWN-55c0f2b7-dc24-425b-9be8-6b86719f2865,2018.11.15 10:11,UNKNOWN,0,100,0,HDAC,WITHDRAWAL,,,,0,COMPLETED,0,sum-user-id,1660589.274,airdrop-20181115-hdac-sum-user-id-withdrawal,accac570-de75-11e8-bd11-2f9252c4dc2f,AIRDROP,0
airdrop-20181115-hdac-8fcd5d18-0565-4fea-bb5f-5e991ed34af8-withdrawal-exchange,2018.11.15 10:11,UNKNOWN,,UNKNOWN-55c0f2b7-dc24-425b-9be8-6b86719f2865,2018.11.15 10:11,UNKNOWN,0,100,0,HDAC,WITHDRAWAL,,,,0,COMPLETED,0,sum-user-id,1660489.274,airdrop-20181115-hdac-sum-user-id-withdrawal,accac570-de75-11e8-bd11-2f9252c4dc2f,AIRDROP,0
airdrop-20181115-hdac-8fd15d73-27d3-4403-aabc-7b19079284a0-withdrawal-exchange,2018.11.15 10:11,UNKNOWN,,UNKNOWN-55c0f2b7-dc24-425b-9be8-6b86719f2865,2018.11.15 10:11,UNKNOWN,0,100,0,HDAC,WITHDRAWAL,,,,0,COMPLETED,0,sum-user-id,1660389.274,airdrop-20181115-hdac-sum-user-id-withdrawal,accac570-de75-11e8-bd11-2f9252c4dc2f,AIRDROP,0
airdrop-20181115-hdac-8fdfbdef-09df-4c94-8f00-5735c8a79550-withdrawal-exchange,2018.11.15 10:11,UNKNOWN,,UNKNOWN-55c0f2b7-dc24-425b-9be8-6b86719f2865,2018.11.15 10:11,UNKNOWN,0,100,0,HDAC,WITHDRAWAL,,,,0,COMPLETED,0,sum-user-id,1660289.274,airdrop-20181115-hdac-sum-user-id-withdrawal,accac570-de75-11e8-bd11-2f9252c4dc2f,AIRDROP,0
airdrop-20181115-hdac-8ff25148-9703-4297-89da-ee60554f5d58-withdrawal-exchange,2018.11.15 10:11,UNKNOWN,,UNKNOWN-55c0f2b7-dc24-425b-9be8-6b86719f2865,2018.11.15 10:11,UNKNOWN,0,100,0,HDAC,WITHDRAWAL,,,,0,COMPLETED,0,sum-user-id,1660189.274,airdrop-20181115-hdac-sum-user-id-withdrawal,accac570-de75-11e8-bd11-2f9252c4dc2f,AIRDROP,0
airdrop-20181115-hdac-90065611-2108-4279-b006-ec131e51754e-withdrawal-exchange,2018.11.15 10:11,UNKNOWN,,UNKNOWN-55c0f2b7-dc24-425b-9be8-6b86719f2865,2018.11.15 10:11,UNKNOWN,0,100,0,HDAC,WITHDRAWAL,,,,0,COMPLETED,0,sum-user-id,1660089.274,airdrop-20181115-hdac-sum-user-id-withdrawal,accac570-de75-11e8-bd11-2f9252c4dc2f,AIRDROP,0
airdrop-20181115-hdac-902a7b59-a3f7-4491-99c4-a91cb155f875-withdrawal-exchange,2018.11.15 10:11,UNKNOWN,,UNKNOWN-55c0f2b7-dc24-425b-9be8-6b86719f2865,2018.11.15 10:11,UNKNOWN,0,100,0,HDAC,WITHDRAWAL,,,,0,COMPLETED,0,sum-user-id,1659989.274,airdrop-20181115-hdac-sum-user-id-withdrawal,accac570-de75-11e8-bd11-2f9252c4dc2f,AIRDROP,0
airdrop-20181115-hdac-9052d135-eeb2-4ab6-823f-b41f21933e7b-withdrawal-exchange,2018.11.15 10:11,UNKNOWN,,UNKNOWN-55c0f2b7-dc24-425b-9be8-6b86719f2865,2018.11.15 10:11,UNKNOWN,0,100,0,HDAC,WITHDRAWAL,,,,0,COMPLETED,0,sum-user-id,1659889.274,airdrop-20181115-hdac-sum-user-id-withdrawal,accac570-de75-11e8-bd11-2f9252c4dc2f,AIRDROP,0
airdrop-20181115-hdac-90550390-71d3-4bc0-8873-e0d29d15d4e0-withdrawal-exchange,2018.11.15 10:11,UNKNOWN,,UNKNOWN-55c0f2b7-dc24-425b-9be8-6b86719f2865,2018.11.15 10:11,UNKNOWN,0,100,0,HDAC,WITHDRAWAL,,,,0,COMPLETED,0,sum-user-id,1659789.274,airdrop-20181115-hdac-sum-user-id-withdrawal,accac570-de75-11e8-bd11-2f9252c4dc2f,AIRDROP,0
airdrop-20181115-hdac-906c4d30-c187-43ab-b386-8b9dda58b1ea-withdrawal-exchange,2018.11.15 10:11,UNKNOWN,,UNKNOWN-55c0f2b7-dc24-425b-9be8-6b86719f2865,2018.11.15 10:11,UNKNOWN,0,100,0,HDAC,WITHDRAWAL,,,,0,COMPLETED,0,sum-user-id,1659689.274,airdrop-20181115-hdac-sum-user-id-withdrawal,accac570-de75-11e8-bd11-2f9252c4dc2f,AIRDROP,0
airdrop-20181115-hdac-9070689f-f9c1-498d-93e3-c8a630a4f610-withdrawal-exchange,2018.11.15 10:11,UNKNOWN,,UNKNOWN-55c0f2b7-dc24-425b-9be8-6b86719f2865,2018.11.15 10:11,UNKNOWN,0,100,0,HDAC,WITHDRAWAL,,,,0,COMPLETED,0,sum-user-id,1659589.274,airdrop-20181115-hdac-sum-user-id-withdrawal,accac570-de75-11e8-bd11-2f9252c4dc2f,AIRDROP,0
airdrop-20181115-hdac-907f0310-38f7-4256-a95b-1543293de3e0-withdrawal-exchange,2018.11.15 10:11,UNKNOWN,,UNKNOWN-55c0f2b7-dc24-425b-9be8-6b86719f2865,2018.11.15 10:11,UNKNOWN,0,100,0,HDAC,WITHDRAWAL,,,,0,COMPLETED,0,sum-user-id,1659489.274,airdrop-20181115-hdac-sum-user-id-withdrawal,accac570-de75-11e8-bd11-2f9252c4dc2f,AIRDROP,0
airdrop-20181115-hdac-909dc9f2-5049-4e3c-a84f-f1c680756f14-withdrawal-exchange,2018.11.15 10:11,UNKNOWN,,UNKNOWN-55c0f2b7-dc24-425b-9be8-6b86719f2865,2018.11.15 10:11,UNKNOWN,0,100,0,HDAC,WITHDRAWAL,,,,0,COMPLETED,0,sum-user-id,1659389.274,airdrop-20181115-hdac-sum-user-id-withdrawal,accac570-de75-11e8-bd11-2f9252c4dc2f,AIRDROP,0
airdrop-20181115-hdac-90fb9bc9-75af-4ede-8c1c-de58659a04dc-withdrawal-exchange,2018.11.15 10:11,UNKNOWN,,UNKNOWN-55c0f2b7-dc24-425b-9be8-6b86719f2865,2018.11.15 10:11,UNKNOWN,0,100,0,HDAC,WITHDRAWAL,,,,0,COMPLETED,0,sum-user-id,1659289.274,airdrop-20181115-hdac-sum-user-id-withdrawal,accac570-de75-11e8-bd11-2f9252c4dc2f,AIRDROP,0
airdrop-20181115-hdac-9111c8e4-df4f-45b1-8096-f46ad8cce6b2-withdrawal-exchange,2018.11.15 10:11,UNKNOWN,,UNKNOWN-55c0f2b7-dc24-425b-9be8-6b86719f2865,2018.11.15 10:11,UNKNOWN,0,100,0,HDAC,WITHDRAWAL,,,,0,COMPLETED,0,sum-user-id,1659189.274,airdrop-20181115-hdac-sum-user-id-withdrawal,accac570-de75-11e8-bd11-2f9252c4dc2f,AIRDROP,0
airdrop-20181115-hdac-9135c4f7-b71a-4885-ae43-f7f46a654e98-withdrawal-exchange,2018.11.15 10:11,UNKNOWN,,UNKNOWN-55c0f2b7-dc24-425b-9be8-6b86719f2865,2018.11.15 10:11,UNKNOWN,0,100,0,HDAC,WITHDRAWAL,,,,0,COMPLETED,0,sum-user-id,1659089.274,airdrop-20181115-hdac-sum-user-id-withdrawal,accac570-de75-11e8-bd11-2f9252c4dc2f,AIRDROP,0
airdrop-20181115-hdac-9158e0ec-0db9-4154-aa92-878db7474b5b-withdrawal-exchange,2018.11.15 10:11,UNKNOWN,,UNKNOWN-55c0f2b7-dc24-425b-9be8-6b86719f2865,2018.11.15 10:11,UNKNOWN,0,100,0,HDAC,WITHDRAWAL,,,,0,COMPLETED,0,sum-user-id,1658989.274,airdrop-20181115-hdac-sum-user-id-withdrawal,accac570-de75-11e8-bd11-2f9252c4dc2f,AIRDROP,0
airdrop-20181115-hdac-915e17c3-653e-4c99-9bd6-d19e7f4cc9c9-withdrawal-exchange,2018.11.15 10:11,UNKNOWN,,UNKNOWN-55c0f2b7-dc24-425b-9be8-6b86719f2865,2018.11.15 10:11,UNKNOWN,0,3664.979935,0,HDAC,WITHDRAWAL,,,,0,COMPLETED,0,sum-user-id,1655324.294,airdrop-20181115-hdac-sum-user-id-withdrawal,accac570-de75-11e8-bd11-2f9252c4dc2f,AIRDROP,0
airdrop-20181115-hdac-9160462a-569f-48bf-9817-3c667e78b049-withdrawal-exchange,2018.11.15 10:11,UNKNOWN,,UNKNOWN-55c0f2b7-dc24-425b-9be8-6b86719f2865,2018.11.15 10:11,UNKNOWN,0,100,0,HDAC,WITHDRAWAL,,,,0,COMPLETED,0,sum-user-id,1655224.294,airdrop-20181115-hdac-sum-user-id-withdrawal,accac570-de75-11e8-bd11-2f9252c4dc2f,AIRDROP,0
airdrop-20181115-hdac-91727e8c-cfd8-4bb1-b815-70b2b6ce47d8-withdrawal-exchange,2018.11.15 10:11,UNKNOWN,,UNKNOWN-55c0f2b7-dc24-425b-9be8-6b86719f2865,2018.11.15 10:11,UNKNOWN,0,100,0,HDAC,WITHDRAWAL,,,,0,COMPLETED,0,sum-user-id,1655124.294,airdrop-20181115-hdac-sum-user-id-withdrawal,accac570-de75-11e8-bd11-2f9252c4dc2f,AIRDROP,0
airdrop-20181115-hdac-91848b04-51c9-49d2-83b9-bd4e350fbe6c-withdrawal-exchange,2018.11.15 10:11,UNKNOWN,,UNKNOWN-55c0f2b7-dc24-425b-9be8-6b86719f2865,2018.11.15 10:11,UNKNOWN,0,100,0,HDAC,WITHDRAWAL,,,,0,COMPLETED,0,sum-user-id,1655024.294,airdrop-20181115-hdac-sum-user-id-withdrawal,accac570-de75-11e8-bd11-2f9252c4dc2f,AIRDROP,0
airdrop-20181115-hdac-919877ca-b8e9-48a4-96cf-b2e54a940047-withdrawal-exchange,2018.11.15 10:11,UNKNOWN,,UNKNOWN-55c0f2b7-dc24-425b-9be8-6b86719f2865,2018.11.15 10:11,UNKNOWN,0,100,0,HDAC,WITHDRAWAL,,,,0,COMPLETED,0,sum-user-id,1654924.294,airdrop-20181115-hdac-sum-user-id-withdrawal,accac570-de75-11e8-bd11-2f9252c4dc2f,AIRDROP,0
airdrop-20181115-hdac-91ac15d6-9043-46b9-a82b-8a142d3852f7-withdrawal-exchange,2018-11-15 10:11:52.023,UNKNOWN,,UNKNOWN-55c0f2b7-dc24-425b-9be8-6b86719f2865,2018-11-15 10:11:52.023,UNKNOWN,0,100,0,HDAC,WITHDRAWAL,,,,0,COMPLETED,0,sum-user-id,1654824.294,airdrop-20181115-hdac-sum-user-id-withdrawal,accac570-de75-11e8-bd11-2f9252c4dc2f,AIRDROP,0
airdrop-20181115-hdac-91d2296c-efb8-4012-837e-b968c0286844-withdrawal-exchange,2018-11-15 10:11:52.055,UNKNOWN,,UNKNOWN-55c0f2b7-dc24-425b-9be8-6b86719f2865,2018-11-15 10:11:52.055,UNKNOWN,0,100,0,HDAC,WITHDRAWAL,,,,0,COMPLETED,0,sum-user-id,1654724.294,airdrop-20181115-hdac-sum-user-id-withdrawal,accac570-de75-11e8-bd11-2f9252c4dc2f,AIRDROP,0
airdrop-20181115-hdac-91e272d6-12c7-4198-b5ff-98994d1f41b6-withdrawal-exchange,2018-11-15 10:11:52.083,UNKNOWN,,UNKNOWN-55c0f2b7-dc24-425b-9be8-6b86719f2865,2018-11-15 10:11:52.083,UNKNOWN,0,100,0,HDAC,WITHDRAWAL,,,,0,COMPLETED,0,sum-user-id,1654624.294,airdrop-20181115-hdac-sum-user-id-withdrawal,accac570-de75-11e8-bd11-2f9252c4dc2f,AIRDROP,0
airdrop-20181115-hdac-921fde84-b3a9-44d6-850c-72593131423c-withdrawal-exchange,2018.11.15 10:11,UNKNOWN,,UNKNOWN-55c0f2b7-dc24-425b-9be8-6b86719f2865,2018.11.15 10:11,UNKNOWN,0,100,0,HDAC,WITHDRAWAL,,,,0,COMPLETED,0,sum-user-id,1654524.294,airdrop-20181115-hdac-sum-user-id-withdrawal,accac570-de75-11e8-bd11-2f9252c4dc2f,AIRDROP,0
airdrop-20181115-hdac-9221d753-77f0-4a2b-bb61-afcb318d095d-withdrawal-exchange,2018.11.15 10:11,UNKNOWN,,UNKNOWN-55c0f2b7-dc24-425b-9be8-6b86719f2865,2018.11.15 10:11,UNKNOWN,0,100,0,HDAC,WITHDRAWAL,,,,0,COMPLETED,0,sum-user-id,1654424.294,airdrop-20181115-hdac-sum-user-id-withdrawal,accac570-de75-11e8-bd11-2f9252c4dc2f,AIRDROP,0
airdrop-20181115-hdac-922b9682-7d7c-41e0-bd7d-86fcc3e3ec65-withdrawal-exchange,2018.11.15 10:11,UNKNOWN,,UNKNOWN-55c0f2b7-dc24-425b-9be8-6b86719f2865,2018.11.15 10:11,UNKNOWN,0,100,0,HDAC,WITHDRAWAL,,,,0,COMPLETED,0,sum-user-id,1654324.294,airdrop-20181115-hdac-sum-user-id-withdrawal,accac570-de75-11e8-bd11-2f9252c4dc2f,AIRDROP,0
airdrop-20181115-hdac-9261faa1-0964-47bf-a1aa-e4e9d874fb21-withdrawal-exchange,2018.11.15 10:11,UNKNOWN,,UNKNOWN-55c0f2b7-dc24-425b-9be8-6b86719f2865,2018.11.15 10:11,UNKNOWN,0,100,0,HDAC,WITHDRAWAL,,,,0,COMPLETED,0,sum-user-id,1654224.294,airdrop-20181115-hdac-sum-user-id-withdrawal,accac570-de75-11e8-bd11-2f9252c4dc2f,AIRDROP,0
airdrop-20181115-hdac-92773910-a4ce-4081-acb4-14004e21906e-withdrawal-exchange,2018.11.15 10:11,UNKNOWN,,UNKNOWN-55c0f2b7-dc24-425b-9be8-6b86719f2865,2018.11.15 10:11,UNKNOWN,0,100,0,HDAC,WITHDRAWAL,,,,0,COMPLETED,0,sum-user-id,1654124.294,airdrop-20181115-hdac-sum-user-id-withdrawal,accac570-de75-11e8-bd11-2f9252c4dc2f,AIRDROP,0
airdrop-20181115-hdac-928646c2-0815-4384-8ab8-b87cf3082b8b-withdrawal-exchange,2018.11.15 10:11,UNKNOWN,,UNKNOWN-55c0f2b7-dc24-425b-9be8-6b86719f2865,2018.11.15 10:11,UNKNOWN,0,100,0,HDAC,WITHDRAWAL,,,,0,COMPLETED,0,sum-user-id,1654024.294,airdrop-20181115-hdac-sum-user-id-withdrawal,accac570-de75-11e8-bd11-2f9252c4dc2f,AIRDROP,0
airdrop-20181115-hdac-929cc04f-b343-4517-9471-4ee82aab5654-withdrawal-exchange,2018.11.15 10:11,UNKNOWN,,UNKNOWN-55c0f2b7-dc24-425b-9be8-6b86719f2865,2018.11.15 10:11,UNKNOWN,0,100,0,HDAC,WITHDRAWAL,,,,0,COMPLETED,0,sum-user-id,1653924.294,airdrop-20181115-hdac-sum-user-id-withdrawal,accac570-de75-11e8-bd11-2f9252c4dc2f,AIRDROP,0
airdrop-20181115-hdac-92a19aad-8271-4e94-9be1-013ddcc37594-withdrawal-exchange,2018.11.15 10:11,UNKNOWN,,UNKNOWN-55c0f2b7-dc24-425b-9be8-6b86719f2865,2018.11.15 10:11,UNKNOWN,0,100,0,HDAC,WITHDRAWAL,,,,0,COMPLETED,0,sum-user-id,1653824.294,airdrop-20181115-hdac-sum-user-id-withdrawal,accac570-de75-11e8-bd11-2f9252c4dc2f,AIRDROP,0
airdrop-20181115-hdac-92a63f51-e5ab-4193-9919-15c7559fe2a7-withdrawal-exchange,2018.11.15 10:11,UNKNOWN,,UNKNOWN-55c0f2b7-dc24-425b-9be8-6b86719f2865,2018.11.15 10:11,UNKNOWN,0,100,0,HDAC,WITHDRAWAL,,,,0,COMPLETED,0,sum-user-id,1653724.294,airdrop-20181115-hdac-sum-user-id-withdrawal,accac570-de75-11e8-bd11-2f9252c4dc2f,AIRDROP,0
airdrop-20181115-hdac-92b8a562-da02-4e82-a503-064d10ebf65f-withdrawal-exchange,2018.11.15 10:11,UNKNOWN,,UNKNOWN-55c0f2b7-dc24-425b-9be8-6b86719f2865,2018.11.15 10:11,UNKNOWN,0,100,0,HDAC,WITHDRAWAL,,,,0,COMPLETED,0,sum-user-id,1653624.294,airdrop-20181115-hdac-sum-user-id-withdrawal,accac570-de75-11e8-bd11-2f9252c4dc2f,AIRDROP,0
airdrop-20181115-hdac-92bc1b8d-784a-44a5-a623-90c25c81a282-withdrawal-exchange,2018.11.15 10:11,UNKNOWN,,UNKNOWN-55c0f2b7-dc24-425b-9be8-6b86719f2865,2018.11.15 10:11,UNKNOWN,0,100,0,HDAC,WITHDRAWAL,,,,0,COMPLETED,0,sum-user-id,1653524.294,airdrop-20181115-hdac-sum-user-id-withdrawal,accac570-de75-11e8-bd11-2f9252c4dc2f,AIRDROP,0
airdrop-20181115-hdac-92cca07f-111b-4584-9211-1319c8fadf69-withdrawal-exchange,2018.11.15 10:11,UNKNOWN,,UNKNOWN-55c0f2b7-dc24-425b-9be8-6b86719f2865,2018.11.15 10:11,UNKNOWN,0,100,0,HDAC,WITHDRAWAL,,,,0,COMPLETED,0,sum-user-id,1653424.294,airdrop-20181115-hdac-sum-user-id-withdrawal,accac570-de75-11e8-bd11-2f9252c4dc2f,AIRDROP,0
airdrop-20181115-hdac-92f3890e-f0ba-4f0a-af58-936c926f7db4-withdrawal-exchange,2018.11.15 10:11,UNKNOWN,,UNKNOWN-55c0f2b7-dc24-425b-9be8-6b86719f2865,2018.11.15 10:11,UNKNOWN,0,100,0,HDAC,WITHDRAWAL,,,,0,COMPLETED,0,sum-user-id,1653324.294,airdrop-20181115-hdac-sum-user-id-withdrawal,accac570-de75-11e8-bd11-2f9252c4dc2f,AIRDROP,0
airdrop-20181115-hdac-9302bc33-9c90-4417-9857-1fe3b072a93b-withdrawal-exchange,2018.11.15 10:11,UNKNOWN,,UNKNOWN-55c0f2b7-dc24-425b-9be8-6b86719f2865,2018.11.15 10:11,UNKNOWN,0,100,0,HDAC,WITHDRAWAL,,,,0,COMPLETED,0,sum-user-id,1653224.294,airdrop-20181115-hdac-sum-user-id-withdrawal,accac570-de75-11e8-bd11-2f9252c4dc2f,AIRDROP,0
airdrop-20181115-hdac-9305f570-dd7d-4ab6-adf3-28360ebe9f61-withdrawal-exchange,2018.11.15 10:11,UNKNOWN,,UNKNOWN-55c0f2b7-dc24-425b-9be8-6b86719f2865,2018.11.15 10:11,UNKNOWN,0,100,0,HDAC,WITHDRAWAL,,,,0,COMPLETED,0,sum-user-id,1653124.294,airdrop-20181115-hdac-sum-user-id-withdrawal,accac570-de75-11e8-bd11-2f9252c4dc2f,AIRDROP,0
airdrop-20181115-hdac-93206477-dd48-4b10-87d6-b64767995381-withdrawal-exchange,2018.11.15 10:11,UNKNOWN,,UNKNOWN-55c0f2b7-dc24-425b-9be8-6b86719f2865,2018.11.15 10:11,UNKNOWN,0,100,0,HDAC,WITHDRAWAL,,,,0,COMPLETED,0,sum-user-id,1653024.294,airdrop-20181115-hdac-sum-user-id-withdrawal,accac570-de75-11e8-bd11-2f9252c4dc2f,AIRDROP,0
airdrop-20181115-hdac-9372513e-cbc1-4c4f-9292-c8a0a0c996b0-withdrawal-exchange,2018.11.15 10:11,UNKNOWN,,UNKNOWN-55c0f2b7-dc24-425b-9be8-6b86719f2865,2018.11.15 10:11,UNKNOWN,0,100,0,HDAC,WITHDRAWAL,,,,0,COMPLETED,0,sum-user-id,1652924.294,airdrop-20181115-hdac-sum-user-id-withdrawal,accac570-de75-11e8-bd11-2f9252c4dc2f,AIRDROP,0
airdrop-20181115-hdac-937c90b4-7c53-446d-9b5f-19a496055d94-withdrawal-exchange,2018.11.15 10:11,UNKNOWN,,UNKNOWN-55c0f2b7-dc24-425b-9be8-6b86719f2865,2018.11.15 10:11,UNKNOWN,0,100,0,HDAC,WITHDRAWAL,,,,0,COMPLETED,0,sum-user-id,1652824.294,airdrop-20181115-hdac-sum-user-id-withdrawal,accac570-de75-11e8-bd11-2f9252c4dc2f,AIRDROP,0
airdrop-20181115-hdac-93810e6f-cfd8-4e4e-b5a1-fe10d9269463-withdrawal-exchange,2018.11.15 10:11,UNKNOWN,,UNKNOWN-55c0f2b7-dc24-425b-9be8-6b86719f2865,2018.11.15 10:11,UNKNOWN,0,100,0,HDAC,WITHDRAWAL,,,,0,COMPLETED,0,sum-user-id,1652724.294,airdrop-20181115-hdac-sum-user-id-withdrawal,accac570-de75-11e8-bd11-2f9252c4dc2f,AIRDROP,0
airdrop-20181115-hdac-93950df0-5515-458f-ac60-ad958ad142d2-withdrawal-exchange,2018.11.15 10:11,UNKNOWN,,UNKNOWN-55c0f2b7-dc24-425b-9be8-6b86719f2865,2018.11.15 10:11,UNKNOWN,0,100,0,HDAC,WITHDRAWAL,,,,0,COMPLETED,0,sum-user-id,1652624.294,airdrop-20181115-hdac-sum-user-id-withdrawal,accac570-de75-11e8-bd11-2f9252c4dc2f,AIRDROP,0
airdrop-20181115-hdac-93d9b771-40a1-4c01-9fed-8013f6a573b2-withdrawal-exchange,2018.11.15 10:11,UNKNOWN,,UNKNOWN-55c0f2b7-dc24-425b-9be8-6b86719f2865,2018.11.15 10:11,UNKNOWN,0,100,0,HDAC,WITHDRAWAL,,,,0,COMPLETED,0,sum-user-id,1652524.294,airdrop-20181115-hdac-sum-user-id-withdrawal,accac570-de75-11e8-bd11-2f9252c4dc2f,AIRDROP,0
airdrop-20181115-hdac-93e7df30-d423-4b64-9204-ac3e3f81366e-withdrawal-exchange,2018.11.15 10:11,UNKNOWN,,UNKNOWN-55c0f2b7-dc24-425b-9be8-6b86719f2865,2018.11.15 10:11,UNKNOWN,0,100,0,HDAC,WITHDRAWAL,,,,0,COMPLETED,0,sum-user-id,1652424.294,airdrop-20181115-hdac-sum-user-id-withdrawal,accac570-de75-11e8-bd11-2f9252c4dc2f,AIRDROP,0
airdrop-20181115-hdac-93f92861-1604-4d67-b8f6-5fd36374dae3-withdrawal-exchange,2018.11.15 10:11,UNKNOWN,,UNKNOWN-55c0f2b7-dc24-425b-9be8-6b86719f2865,2018.11.15 10:11,UNKNOWN,0,100,0,HDAC,WITHDRAWAL,,,,0,COMPLETED,0,sum-user-id,1652324.294,airdrop-20181115-hdac-sum-user-id-withdrawal,accac570-de75-11e8-bd11-2f9252c4dc2f,AIRDROP,0
airdrop-20181115-hdac-93fe4448-6717-4804-9fb0-26a4bf241320-withdrawal-exchange,2018.11.15 10:11,UNKNOWN,,UNKNOWN-55c0f2b7-dc24-425b-9be8-6b86719f2865,2018.11.15 10:11,UNKNOWN,0,100,0,HDAC,WITHDRAWAL,,,,0,COMPLETED,0,sum-user-id,1652224.294,airdrop-20181115-hdac-sum-user-id-withdrawal,accac570-de75-11e8-bd11-2f9252c4dc2f,AIRDROP,0
airdrop-20181115-hdac-94014aa8-c231-4673-a438-3199c8d09395-withdrawal-exchange,2018.11.15 10:11,UNKNOWN,,UNKNOWN-55c0f2b7-dc24-425b-9be8-6b86719f2865,2018.11.15 10:11,UNKNOWN,0,100,0,HDAC,WITHDRAWAL,,,,0,COMPLETED,0,sum-user-id,1652124.294,airdrop-20181115-hdac-sum-user-id-withdrawal,accac570-de75-11e8-bd11-2f9252c4dc2f,AIRDROP,0
airdrop-20181115-hdac-9401da07-370c-4e4c-9023-0323308a842a-withdrawal-exchange,2018.11.15 10:11,UNKNOWN,,UNKNOWN-55c0f2b7-dc24-425b-9be8-6b86719f2865,2018.11.15 10:11,UNKNOWN,0,100,0,HDAC,WITHDRAWAL,,,,0,COMPLETED,0,sum-user-id,1652024.294,airdrop-20181115-hdac-sum-user-id-withdrawal,accac570-de75-11e8-bd11-2f9252c4dc2f,AIRDROP,0
airdrop-20181115-hdac-9434c15e-9e4f-4157-b997-61f0f64074fb-withdrawal-exchange,2018.11.15 10:11,UNKNOWN,,UNKNOWN-55c0f2b7-dc24-425b-9be8-6b86719f2865,2018.11.15 10:11,UNKNOWN,0,100,0,HDAC,WITHDRAWAL,,,,0,COMPLETED,0,sum-user-id,1651924.294,airdrop-20181115-hdac-sum-user-id-withdrawal,accac570-de75-11e8-bd11-2f9252c4dc2f,AIRDROP,0
airdrop-20181115-hdac-94635dd1-c81d-43b1-9ec6-bb3575f2f9d2-withdrawal-exchange,2018.11.15 10:11,UNKNOWN,,UNKNOWN-55c0f2b7-dc24-425b-9be8-6b86719f2865,2018.11.15 10:11,UNKNOWN,0,100,0,HDAC,WITHDRAWAL,,,,0,COMPLETED,0,sum-user-id,1651824.294,airdrop-20181115-hdac-sum-user-id-withdrawal,accac570-de75-11e8-bd11-2f9252c4dc2f,AIRDROP,0
airdrop-20181115-hdac-946712a6-d2b9-4f05-aaf7-97c66afe84b2-withdrawal-exchange,2018-11-15 10:11:53.006,UNKNOWN,,UNKNOWN-55c0f2b7-dc24-425b-9be8-6b86719f2865,2018-11-15 10:11:53.006,UNKNOWN,0,100,0,HDAC,WITHDRAWAL,,,,0,COMPLETED,0,sum-user-id,1651724.294,airdrop-20181115-hdac-sum-user-id-withdrawal,accac570-de75-11e8-bd11-2f9252c4dc2f,AIRDROP,0
airdrop-20181115-hdac-94754afe-2b20-4e94-9cd6-a34c9f1366b6-withdrawal-exchange,2018-11-15 10:11:53.036,UNKNOWN,,UNKNOWN-55c0f2b7-dc24-425b-9be8-6b86719f2865,2018-11-15 10:11:53.036,UNKNOWN,0,100,0,HDAC,WITHDRAWAL,,,,0,COMPLETED,0,sum-user-id,1651624.294,airdrop-20181115-hdac-sum-user-id-withdrawal,accac570-de75-11e8-bd11-2f9252c4dc2f,AIRDROP,0
airdrop-20181115-hdac-94902189-d611-4f54-9c4d-9f2b2d704741-withdrawal-exchange,2018-11-15 10:11:53.071,UNKNOWN,,UNKNOWN-55c0f2b7-dc24-425b-9be8-6b86719f2865,2018-11-15 10:11:53.071,UNKNOWN,0,100,0,HDAC,WITHDRAWAL,,,,0,COMPLETED,0,sum-user-id,1651524.294,airdrop-20181115-hdac-sum-user-id-withdrawal,accac570-de75-11e8-bd11-2f9252c4dc2f,AIRDROP,0
airdrop-20181115-hdac-94fbbc53-cde0-4a02-bec2-2612c8e730e6-withdrawal-exchange,2018.11.15 10:11,UNKNOWN,,UNKNOWN-55c0f2b7-dc24-425b-9be8-6b86719f2865,2018.11.15 10:11,UNKNOWN,0,100,0,HDAC,WITHDRAWAL,,,,0,COMPLETED,0,sum-user-id,1651424.294,airdrop-20181115-hdac-sum-user-id-withdrawal,accac570-de75-11e8-bd11-2f9252c4dc2f,AIRDROP,0
airdrop-20181115-hdac-94fcd880-ca71-41d1-89ac-56653c1e8031-withdrawal-exchange,2018.11.15 10:11,UNKNOWN,,UNKNOWN-55c0f2b7-dc24-425b-9be8-6b86719f2865,2018.11.15 10:11,UNKNOWN,0,100,0,HDAC,WITHDRAWAL,,,,0,COMPLETED,0,sum-user-id,1651324.294,airdrop-20181115-hdac-sum-user-id-withdrawal,accac570-de75-11e8-bd11-2f9252c4dc2f,AIRDROP,0
airdrop-20181115-hdac-94fdc27d-508a-4e4c-9136-3dcf76f4de9d-withdrawal-exchange,2018.11.15 10:11,UNKNOWN,,UNKNOWN-55c0f2b7-dc24-425b-9be8-6b86719f2865,2018.11.15 10:11,UNKNOWN,0,100,0,HDAC,WITHDRAWAL,,,,0,COMPLETED,0,sum-user-id,1651224.294,airdrop-20181115-hdac-sum-user-id-withdrawal,accac570-de75-11e8-bd11-2f9252c4dc2f,AIRDROP,0
airdrop-20181115-hdac-9507f31b-987c-478c-9ba3-1fe306b19307-withdrawal-exchange,2018.11.15 10:11,UNKNOWN,,UNKNOWN-55c0f2b7-dc24-425b-9be8-6b86719f2865,2018.11.15 10:11,UNKNOWN,0,100,0,HDAC,WITHDRAWAL,,,,0,COMPLETED,0,sum-user-id,1651124.294,airdrop-20181115-hdac-sum-user-id-withdrawal,accac570-de75-11e8-bd11-2f9252c4dc2f,AIRDROP,0
airdrop-20181115-hdac-951dcaae-bcbe-4b5b-bb85-38d5145f3fbb-withdrawal-exchange,2018.11.15 10:11,UNKNOWN,,UNKNOWN-55c0f2b7-dc24-425b-9be8-6b86719f2865,2018.11.15 10:11,UNKNOWN,0,100,0,HDAC,WITHDRAWAL,,,,0,COMPLETED,0,sum-user-id,1651024.294,airdrop-20181115-hdac-sum-user-id-withdrawal,accac570-de75-11e8-bd11-2f9252c4dc2f,AIRDROP,0
airdrop-20181115-hdac-95676ea8-eef2-4d33-8f4f-ff7d17577fa9-withdrawal-exchange,2018.11.15 10:11,UNKNOWN,,UNKNOWN-55c0f2b7-dc24-425b-9be8-6b86719f2865,2018.11.15 10:11,UNKNOWN,0,100,0,HDAC,WITHDRAWAL,,,,0,COMPLETED,0,sum-user-id,1650924.294,airdrop-20181115-hdac-sum-user-id-withdrawal,accac570-de75-11e8-bd11-2f9252c4dc2f,AIRDROP,0
airdrop-20181115-hdac-95a96261-d937-4fce-91e9-f1455a08178f-withdrawal-exchange,2018.11.15 10:12,UNKNOWN,,UNKNOWN-55c0f2b7-dc24-425b-9be8-6b86719f2865,2018.11.15 10:12,UNKNOWN,0,117.209342,0,HDAC,WITHDRAWAL,,,,0,COMPLETED,0,sum-user-id,1243642.001,airdrop-20181115-hdac-sum-user-id-withdrawal,accac570-de75-11e8-bd11-2f9252c4dc2f,AIRDROP,0
airdrop-20181115-hdac-95dec22d-9df4-4a52-9dfd-31f4d730d75a-withdrawal-exchange,2018.11.15 10:11,UNKNOWN,,UNKNOWN-55c0f2b7-dc24-425b-9be8-6b86719f2865,2018.11.15 10:11,UNKNOWN,0,100,0,HDAC,WITHDRAWAL,,,,0,COMPLETED,0,sum-user-id,1650824.294,airdrop-20181115-hdac-sum-user-id-withdrawal,accac570-de75-11e8-bd11-2f9252c4dc2f,AIRDROP,0
airdrop-20181115-hdac-95e80519-e007-413c-968e-ba8d0b1cc87a-withdrawal-exchange,2018.11.15 10:11,UNKNOWN,,UNKNOWN-55c0f2b7-dc24-425b-9be8-6b86719f2865,2018.11.15 10:11,UNKNOWN,0,100,0,HDAC,WITHDRAWAL,,,,0,COMPLETED,0,sum-user-id,1650724.294,airdrop-20181115-hdac-sum-user-id-withdrawal,accac570-de75-11e8-bd11-2f9252c4dc2f,AIRDROP,0
airdrop-20181115-hdac-95f9b728-fdcd-47f9-bb30-103f4dbbc6a5-withdrawal-exchange,2018.11.15 10:11,UNKNOWN,,UNKNOWN-55c0f2b7-dc24-425b-9be8-6b86719f2865,2018.11.15 10:11,UNKNOWN,0,100,0,HDAC,WITHDRAWAL,,,,0,COMPLETED,0,sum-user-id,1650624.294,airdrop-20181115-hdac-sum-user-id-withdrawal,accac570-de75-11e8-bd11-2f9252c4dc2f,AIRDROP,0
airdrop-20181115-hdac-95fcfd7a-d5e9-42aa-a5d5-68a642da9ff9-withdrawal-exchange,2018.11.15 10:11,UNKNOWN,,UNKNOWN-55c0f2b7-dc24-425b-9be8-6b86719f2865,2018.11.15 10:11,UNKNOWN,0,100,0,HDAC,WITHDRAWAL,,,,0,COMPLETED,0,sum-user-id,1650524.294,airdrop-20181115-hdac-sum-user-id-withdrawal,accac570-de75-11e8-bd11-2f9252c4dc2f,AIRDROP,0
airdrop-20181115-hdac-9604507b-10e4-4e28-9098-ee963f7b6b76-withdrawal-exchange,2018.11.15 10:11,UNKNOWN,,UNKNOWN-55c0f2b7-dc24-425b-9be8-6b86719f2865,2018.11.15 10:11,UNKNOWN,0,100,0,HDAC,WITHDRAWAL,,,,0,COMPLETED,0,sum-user-id,1650424.294,airdrop-20181115-hdac-sum-user-id-withdrawal,accac570-de75-11e8-bd11-2f9252c4dc2f,AIRDROP,0
airdrop-20181115-hdac-96881534-85f0-4537-b410-eaefbf0e8f1d-withdrawal-exchange,2018.11.15 10:11,UNKNOWN,,UNKNOWN-55c0f2b7-dc24-425b-9be8-6b86719f2865,2018.11.15 10:11,UNKNOWN,0,100,0,HDAC,WITHDRAWAL,,,,0,COMPLETED,0,sum-user-id,1650324.294,airdrop-20181115-hdac-sum-user-id-withdrawal,accac570-de75-11e8-bd11-2f9252c4dc2f,AIRDROP,0
airdrop-20181115-hdac-968e8d8a-a462-4317-bdc5-af9449775f8f-withdrawal-exchange,2018.11.15 10:11,UNKNOWN,,UNKNOWN-55c0f2b7-dc24-425b-9be8-6b86719f2865,2018.11.15 10:11,UNKNOWN,0,100,0,HDAC,WITHDRAWAL,,,,0,COMPLETED,0,sum-user-id,1650224.294,airdrop-20181115-hdac-sum-user-id-withdrawal,accac570-de75-11e8-bd11-2f9252c4dc2f,AIRDROP,0
airdrop-20181115-hdac-96a2cd66-c755-4328-8309-cd4f29c98c96-withdrawal-exchange,2018.11.15 10:11,UNKNOWN,,UNKNOWN-55c0f2b7-dc24-425b-9be8-6b86719f2865,2018.11.15 10:11,UNKNOWN,0,100,0,HDAC,WITHDRAWAL,,,,0,COMPLETED,0,sum-user-id,1650124.294,airdrop-20181115-hdac-sum-user-id-withdrawal,accac570-de75-11e8-bd11-2f9252c4dc2f,AIRDROP,0
airdrop-20181115-hdac-96a9a1e6-10a5-4d29-bf1f-f4adfae8dd1c-withdrawal-exchange,2018.11.15 10:11,UNKNOWN,,UNKNOWN-55c0f2b7-dc24-425b-9be8-6b86719f2865,2018.11.15 10:11,UNKNOWN,0,100,0,HDAC,WITHDRAWAL,,,,0,COMPLETED,0,sum-user-id,1650024.294,airdrop-20181115-hdac-sum-user-id-withdrawal,accac570-de75-11e8-bd11-2f9252c4dc2f,AIRDROP,0
airdrop-20181115-hdac-96e6f846-5d4c-4aed-b993-59365bbeeee4-withdrawal-exchange,2018.11.15 10:11,UNKNOWN,,UNKNOWN-55c0f2b7-dc24-425b-9be8-6b86719f2865,2018.11.15 10:11,UNKNOWN,0,100,0,HDAC,WITHDRAWAL,,,,0,COMPLETED,0,sum-user-id,1649924.294,airdrop-20181115-hdac-sum-user-id-withdrawal,accac570-de75-11e8-bd11-2f9252c4dc2f,AIRDROP,0
airdrop-20181115-hdac-9750acb0-0464-4166-9995-1545ebb267c2-withdrawal-exchange,2018.11.15 10:11,UNKNOWN,,UNKNOWN-55c0f2b7-dc24-425b-9be8-6b86719f2865,2018.11.15 10:11,UNKNOWN,0,100,0,HDAC,WITHDRAWAL,,,,0,COMPLETED,0,sum-user-id,1649824.294,airdrop-20181115-hdac-sum-user-id-withdrawal,accac570-de75-11e8-bd11-2f9252c4dc2f,AIRDROP,0
airdrop-20181115-hdac-976dc2a6-09d6-4336-a352-000218174d18-withdrawal-exchange,2018.11.15 10:11,UNKNOWN,,UNKNOWN-55c0f2b7-dc24-425b-9be8-6b86719f2865,2018.11.15 10:11,UNKNOWN,0,100,0,HDAC,WITHDRAWAL,,,,0,COMPLETED,0,sum-user-id,1649724.294,airdrop-20181115-hdac-sum-user-id-withdrawal,accac570-de75-11e8-bd11-2f9252c4dc2f,AIRDROP,0
airdrop-20181115-hdac-978f75f7-c3b1-4b67-b482-c2a4e1027c1c-withdrawal-exchange,2018.11.15 10:11,UNKNOWN,,UNKNOWN-55c0f2b7-dc24-425b-9be8-6b86719f2865,2018.11.15 10:11,UNKNOWN,0,100,0,HDAC,WITHDRAWAL,,,,0,COMPLETED,0,sum-user-id,1649624.294,airdrop-20181115-hdac-sum-user-id-withdrawal,accac570-de75-11e8-bd11-2f9252c4dc2f,AIRDROP,0
airdrop-20181115-hdac-97af24ad-5500-4851-bdee-f9c00c56fad9-withdrawal-exchange,2018.11.15 10:11,UNKNOWN,,UNKNOWN-55c0f2b7-dc24-425b-9be8-6b86719f2865,2018.11.15 10:11,UNKNOWN,0,100,0,HDAC,WITHDRAWAL,,,,0,COMPLETED,0,sum-user-id,1649524.294,airdrop-20181115-hdac-sum-user-id-withdrawal,accac570-de75-11e8-bd11-2f9252c4dc2f,AIRDROP,0
airdrop-20181115-hdac-97cb96e9-a11f-460a-b061-ab1f077c83a6-withdrawal-exchange,2018.11.15 10:11,UNKNOWN,,UNKNOWN-55c0f2b7-dc24-425b-9be8-6b86719f2865,2018.11.15 10:11,UNKNOWN,0,100,0,HDAC,WITHDRAWAL,,,,0,COMPLETED,0,sum-user-id,1649424.294,airdrop-20181115-hdac-sum-user-id-withdrawal,accac570-de75-11e8-bd11-2f9252c4dc2f,AIRDROP,0
airdrop-20181115-hdac-97e12897-7e74-4e22-9c82-151cf0e5a51f-withdrawal-exchange,2018.11.15 10:11,UNKNOWN,,UNKNOWN-55c0f2b7-dc24-425b-9be8-6b86719f2865,2018.11.15 10:11,UNKNOWN,0,100,0,HDAC,WITHDRAWAL,,,,0,COMPLETED,0,sum-user-id,1649324.294,airdrop-20181115-hdac-sum-user-id-withdrawal,accac570-de75-11e8-bd11-2f9252c4dc2f,AIRDROP,0
airdrop-20181115-hdac-97ff5407-a2cc-41b2-907e-b38020c2cd41-withdrawal-exchange,2018.11.15 10:11,UNKNOWN,,UNKNOWN-55c0f2b7-dc24-425b-9be8-6b86719f2865,2018.11.15 10:11,UNKNOWN,0,100,0,HDAC,WITHDRAWAL,,,,0,COMPLETED,0,sum-user-id,1649224.294,airdrop-20181115-hdac-sum-user-id-withdrawal,accac570-de75-11e8-bd11-2f9252c4dc2f,AIRDROP,0
airdrop-20181115-hdac-98072a1d-6685-40d7-bce5-855d133c491a-withdrawal-exchange,2018.11.15 10:11,UNKNOWN,,UNKNOWN-55c0f2b7-dc24-425b-9be8-6b86719f2865,2018.11.15 10:11,UNKNOWN,0,170.861557,0,HDAC,WITHDRAWAL,,,,0,COMPLETED,0,sum-user-id,1649053.432,airdrop-20181115-hdac-sum-user-id-withdrawal,accac570-de75-11e8-bd11-2f9252c4dc2f,AIRDROP,0
airdrop-20181115-hdac-980e50a4-4c03-41e6-8211-188f00796cae-withdrawal-exchange,2018.11.15 10:11,UNKNOWN,,UNKNOWN-55c0f2b7-dc24-425b-9be8-6b86719f2865,2018.11.15 10:11,UNKNOWN,0,100,0,HDAC,WITHDRAWAL,,,,0,COMPLETED,0,sum-user-id,1648953.432,airdrop-20181115-hdac-sum-user-id-withdrawal,accac570-de75-11e8-bd11-2f9252c4dc2f,AIRDROP,0
airdrop-20181115-hdac-9854381d-c4db-41e0-a1bc-ae24b501d649-withdrawal-exchange,2018.11.15 10:11,UNKNOWN,,UNKNOWN-55c0f2b7-dc24-425b-9be8-6b86719f2865,2018.11.15 10:11,UNKNOWN,0,100,0,HDAC,WITHDRAWAL,,,,0,COMPLETED,0,sum-user-id,1648853.432,airdrop-20181115-hdac-sum-user-id-withdrawal,accac570-de75-11e8-bd11-2f9252c4dc2f,AIRDROP,0
airdrop-20181115-hdac-98622998-c324-4997-bb70-1f67c2e1f6d4-withdrawal-exchange,2018.11.15 10:11,UNKNOWN,,UNKNOWN-55c0f2b7-dc24-425b-9be8-6b86719f2865,2018.11.15 10:11,UNKNOWN,0,100,0,HDAC,WITHDRAWAL,,,,0,COMPLETED,0,sum-user-id,1648753.432,airdrop-20181115-hdac-sum-user-id-withdrawal,accac570-de75-11e8-bd11-2f9252c4dc2f,AIRDROP,0
airdrop-20181115-hdac-98a70f2d-943e-4519-837f-bcf59db678e4-withdrawal-exchange,2018.11.15 10:11,UNKNOWN,,UNKNOWN-55c0f2b7-dc24-425b-9be8-6b86719f2865,2018.11.15 10:11,UNKNOWN,0,100,0,HDAC,WITHDRAWAL,,,,0,COMPLETED,0,sum-user-id,1648653.432,airdrop-20181115-hdac-sum-user-id-withdrawal,accac570-de75-11e8-bd11-2f9252c4dc2f,AIRDROP,0
airdrop-20181115-hdac-98a75f96-901d-47ad-8aed-0c712db7801e-withdrawal-exchange,2018-11-15 10:11:54.004,UNKNOWN,,UNKNOWN-55c0f2b7-dc24-425b-9be8-6b86719f2865,2018-11-15 10:11:54.004,UNKNOWN,0,100,0,HDAC,WITHDRAWAL,,,,0,COMPLETED,0,sum-user-id,1648553.432,airdrop-20181115-hdac-sum-user-id-withdrawal,accac570-de75-11e8-bd11-2f9252c4dc2f,AIRDROP,0
airdrop-20181115-hdac-98bbeaed-4238-4863-9c75-6f831f552d63-withdrawal-exchange,2018-11-15 10:11:54.037,UNKNOWN,,UNKNOWN-55c0f2b7-dc24-425b-9be8-6b86719f2865,2018-11-15 10:11:54.037,UNKNOWN,0,100,0,HDAC,WITHDRAWAL,,,,0,COMPLETED,0,sum-user-id,1648453.432,airdrop-20181115-hdac-sum-user-id-withdrawal,accac570-de75-11e8-bd11-2f9252c4dc2f,AIRDROP,0
airdrop-20181115-hdac-98d58445-cc86-4c25-8e16-160d57bc5d93-withdrawal-exchange,2018-11-15 10:11:54.065,UNKNOWN,,UNKNOWN-55c0f2b7-dc24-425b-9be8-6b86719f2865,2018-11-15 10:11:54.065,UNKNOWN,0,100,0,HDAC,WITHDRAWAL,,,,0,COMPLETED,0,sum-user-id,1648353.432,airdrop-20181115-hdac-sum-user-id-withdrawal,accac570-de75-11e8-bd11-2f9252c4dc2f,AIRDROP,0
airdrop-20181115-hdac-98e3eaaf-dbef-4e51-9d91-25f04efc8024-withdrawal-exchange,2018-11-15 10:11:54.094,UNKNOWN,,UNKNOWN-55c0f2b7-dc24-425b-9be8-6b86719f2865,2018-11-15 10:11:54.094,UNKNOWN,0,100,0,HDAC,WITHDRAWAL,,,,0,COMPLETED,0,sum-user-id,1648253.432,airdrop-20181115-hdac-sum-user-id-withdrawal,accac570-de75-11e8-bd11-2f9252c4dc2f,AIRDROP,0
airdrop-20181115-hdac-98ea9a92-01bb-4761-b27a-0b94b6f995c2-withdrawal-exchange,2018.11.15 10:11,UNKNOWN,,UNKNOWN-55c0f2b7-dc24-425b-9be8-6b86719f2865,2018.11.15 10:11,UNKNOWN,0,100,0,HDAC,WITHDRAWAL,,,,0,COMPLETED,0,sum-user-id,1648153.432,airdrop-20181115-hdac-sum-user-id-withdrawal,accac570-de75-11e8-bd11-2f9252c4dc2f,AIRDROP,0
airdrop-20181115-hdac-98ee0b54-024b-46f0-b228-63bd8ee9774b-withdrawal-exchange,2018.11.15 10:11,UNKNOWN,,UNKNOWN-55c0f2b7-dc24-425b-9be8-6b86719f2865,2018.11.15 10:11,UNKNOWN,0,100,0,HDAC,WITHDRAWAL,,,,0,COMPLETED,0,sum-user-id,1648053.432,airdrop-20181115-hdac-sum-user-id-withdrawal,accac570-de75-11e8-bd11-2f9252c4dc2f,AIRDROP,0
airdrop-20181115-hdac-98fc8994-47e9-4169-9a21-bcc73ae3d2a1-withdrawal-exchange,2018.11.15 10:11,UNKNOWN,,UNKNOWN-55c0f2b7-dc24-425b-9be8-6b86719f2865,2018.11.15 10:11,UNKNOWN,0,100,0,HDAC,WITHDRAWAL,,,,0,COMPLETED,0,sum-user-id,1647953.432,airdrop-20181115-hdac-sum-user-id-withdrawal,accac570-de75-11e8-bd11-2f9252c4dc2f,AIRDROP,0
airdrop-20181115-hdac-9908d617-8d70-47bb-9eb1-71e2f154370d-withdrawal-exchange,2018.11.15 10:11,UNKNOWN,,UNKNOWN-55c0f2b7-dc24-425b-9be8-6b86719f2865,2018.11.15 10:11,UNKNOWN,0,100,0,HDAC,WITHDRAWAL,,,,0,COMPLETED,0,sum-user-id,1647853.432,airdrop-20181115-hdac-sum-user-id-withdrawal,accac570-de75-11e8-bd11-2f9252c4dc2f,AIRDROP,0
airdrop-20181115-hdac-9920c07e-3b31-4475-8956-c56df378e0b8-withdrawal-exchange,2018.11.15 10:11,UNKNOWN,,UNKNOWN-55c0f2b7-dc24-425b-9be8-6b86719f2865,2018.11.15 10:11,UNKNOWN,0,100,0,HDAC,WITHDRAWAL,,,,0,COMPLETED,0,sum-user-id,1647753.432,airdrop-20181115-hdac-sum-user-id-withdrawal,accac570-de75-11e8-bd11-2f9252c4dc2f,AIRDROP,0
airdrop-20181115-hdac-993da3ef-b4c9-4e10-a039-9909c4c3183e-withdrawal-exchange,2018.11.15 10:11,UNKNOWN,,UNKNOWN-55c0f2b7-dc24-425b-9be8-6b86719f2865,2018.11.15 10:11,UNKNOWN,0,100,0,HDAC,WITHDRAWAL,,,,0,COMPLETED,0,sum-user-id,1647653.432,airdrop-20181115-hdac-sum-user-id-withdrawal,accac570-de75-11e8-bd11-2f9252c4dc2f,AIRDROP,0
airdrop-20181115-hdac-99428e75-2fd5-48e1-8bec-8e5b8f620b8b-withdrawal-exchange,2018.11.15 10:11,UNKNOWN,,UNKNOWN-55c0f2b7-dc24-425b-9be8-6b86719f2865,2018.11.15 10:11,UNKNOWN,0,100,0,HDAC,WITHDRAWAL,,,,0,COMPLETED,0,sum-user-id,1647553.432,airdrop-20181115-hdac-sum-user-id-withdrawal,accac570-de75-11e8-bd11-2f9252c4dc2f,AIRDROP,0
airdrop-20181115-hdac-994a1a1c-fdc9-4901-9ff8-55e36616099f-withdrawal-exchange,2018.11.15 10:11,UNKNOWN,,UNKNOWN-55c0f2b7-dc24-425b-9be8-6b86719f2865,2018.11.15 10:11,UNKNOWN,0,100,0,HDAC,WITHDRAWAL,,,,0,COMPLETED,0,sum-user-id,1647453.432,airdrop-20181115-hdac-sum-user-id-withdrawal,accac570-de75-11e8-bd11-2f9252c4dc2f,AIRDROP,0
airdrop-20181115-hdac-995e77b3-5721-4457-ad6f-4cd8dad3bcef-withdrawal-exchange,2018.11.15 10:11,UNKNOWN,,UNKNOWN-55c0f2b7-dc24-425b-9be8-6b86719f2865,2018.11.15 10:11,UNKNOWN,0,100,0,HDAC,WITHDRAWAL,,,,0,COMPLETED,0,sum-user-id,1647353.432,airdrop-20181115-hdac-sum-user-id-withdrawal,accac570-de75-11e8-bd11-2f9252c4dc2f,AIRDROP,0
airdrop-20181115-hdac-99a95758-4885-4b85-8ca9-595656fb7b8d-withdrawal-exchange,2018.11.15 10:11,UNKNOWN,,UNKNOWN-55c0f2b7-dc24-425b-9be8-6b86719f2865,2018.11.15 10:11,UNKNOWN,0,100,0,HDAC,WITHDRAWAL,,,,0,COMPLETED,0,sum-user-id,1647253.432,airdrop-20181115-hdac-sum-user-id-withdrawal,accac570-de75-11e8-bd11-2f9252c4dc2f,AIRDROP,0
airdrop-20181115-hdac-99af7e2c-2fd7-417c-a923-19779bfac17a-withdrawal-exchange,2018.11.15 10:11,UNKNOWN,,UNKNOWN-55c0f2b7-dc24-425b-9be8-6b86719f2865,2018.11.15 10:11,UNKNOWN,0,100,0,HDAC,WITHDRAWAL,,,,0,COMPLETED,0,sum-user-id,1647153.432,airdrop-20181115-hdac-sum-user-id-withdrawal,accac570-de75-11e8-bd11-2f9252c4dc2f,AIRDROP,0
airdrop-20181115-hdac-99c56978-de93-416c-92c1-ac4066422598-withdrawal-exchange,2018.11.15 10:11,UNKNOWN,,UNKNOWN-55c0f2b7-dc24-425b-9be8-6b86719f2865,2018.11.15 10:11,UNKNOWN,0,100,0,HDAC,WITHDRAWAL,,,,0,COMPLETED,0,sum-user-id,1647053.432,airdrop-20181115-hdac-sum-user-id-withdrawal,accac570-de75-11e8-bd11-2f9252c4dc2f,AIRDROP,0
airdrop-20181115-hdac-99d9422c-95f7-49a1-afd1-9a3d3141751a-withdrawal-exchange,2018.11.15 10:11,UNKNOWN,,UNKNOWN-55c0f2b7-dc24-425b-9be8-6b86719f2865,2018.11.15 10:11,UNKNOWN,0,100,0,HDAC,WITHDRAWAL,,,,0,COMPLETED,0,sum-user-id,1646953.432,airdrop-20181115-hdac-sum-user-id-withdrawal,accac570-de75-11e8-bd11-2f9252c4dc2f,AIRDROP,0
airdrop-20181115-hdac-9a2da7a6-fadd-4ecb-a572-ac415d83e409-withdrawal-exchange,2018.11.15 10:11,UNKNOWN,,UNKNOWN-55c0f2b7-dc24-425b-9be8-6b86719f2865,2018.11.15 10:11,UNKNOWN,0,100,0,HDAC,WITHDRAWAL,,,,0,COMPLETED,0,sum-user-id,1646853.432,airdrop-20181115-hdac-sum-user-id-withdrawal,accac570-de75-11e8-bd11-2f9252c4dc2f,AIRDROP,0
airdrop-20181115-hdac-9a40f596-9732-4709-a1ec-cb4189c37dd3-withdrawal-exchange,2018.11.15 10:11,UNKNOWN,,UNKNOWN-55c0f2b7-dc24-425b-9be8-6b86719f2865,2018.11.15 10:11,UNKNOWN,0,100,0,HDAC,WITHDRAWAL,,,,0,COMPLETED,0,sum-user-id,1646753.432,airdrop-20181115-hdac-sum-user-id-withdrawal,accac570-de75-11e8-bd11-2f9252c4dc2f,AIRDROP,0
airdrop-20181115-hdac-9a51a06c-0c50-44ee-9bcd-7a51993cf296-withdrawal-exchange,2018.11.15 10:11,UNKNOWN,,UNKNOWN-55c0f2b7-dc24-425b-9be8-6b86719f2865,2018.11.15 10:11,UNKNOWN,0,100,0,HDAC,WITHDRAWAL,,,,0,COMPLETED,0,sum-user-id,1646653.432,airdrop-20181115-hdac-sum-user-id-withdrawal,accac570-de75-11e8-bd11-2f9252c4dc2f,AIRDROP,0
airdrop-20181115-hdac-9a696b92-c318-4031-980c-8568ed06e63d-withdrawal-exchange,2018.11.15 10:11,UNKNOWN,,UNKNOWN-55c0f2b7-dc24-425b-9be8-6b86719f2865,2018.11.15 10:11,UNKNOWN,0,100,0,HDAC,WITHDRAWAL,,,,0,COMPLETED,0,sum-user-id,1646553.432,airdrop-20181115-hdac-sum-user-id-withdrawal,accac570-de75-11e8-bd11-2f9252c4dc2f,AIRDROP,0
airdrop-20181115-hdac-9a84f225-ee04-4b95-9662-98215bd5eebe-withdrawal-exchange,2018.11.15 10:11,UNKNOWN,,UNKNOWN-55c0f2b7-dc24-425b-9be8-6b86719f2865,2018.11.15 10:11,UNKNOWN,0,100,0,HDAC,WITHDRAWAL,,,,0,COMPLETED,0,sum-user-id,1646453.432,airdrop-20181115-hdac-sum-user-id-withdrawal,accac570-de75-11e8-bd11-2f9252c4dc2f,AIRDROP,0
airdrop-20181115-hdac-9aa90bcd-e6e4-4764-8dc1-7fad4229b7dd-withdrawal-exchange,2018.11.15 10:11,UNKNOWN,,UNKNOWN-55c0f2b7-dc24-425b-9be8-6b86719f2865,2018.11.15 10:11,UNKNOWN,0,100,0,HDAC,WITHDRAWAL,,,,0,COMPLETED,0,sum-user-id,1646353.432,airdrop-20181115-hdac-sum-user-id-withdrawal,accac570-de75-11e8-bd11-2f9252c4dc2f,AIRDROP,0
airdrop-20181115-hdac-9ab5fe8e-856c-4d03-8b83-fcb9b553bae0-withdrawal-exchange,2018.11.15 10:11,UNKNOWN,,UNKNOWN-55c0f2b7-dc24-425b-9be8-6b86719f2865,2018.11.15 10:11,UNKNOWN,0,100,0,HDAC,WITHDRAWAL,,,,0,COMPLETED,0,sum-user-id,1646253.432,airdrop-20181115-hdac-sum-user-id-withdrawal,accac570-de75-11e8-bd11-2f9252c4dc2f,AIRDROP,0
airdrop-20181115-hdac-9addd566-50b2-46b7-808b-115c95e76c8c-withdrawal-exchange,2018.11.15 10:11,UNKNOWN,,UNKNOWN-55c0f2b7-dc24-425b-9be8-6b86719f2865,2018.11.15 10:11,UNKNOWN,0,100,0,HDAC,WITHDRAWAL,,,,0,COMPLETED,0,sum-user-id,1646153.432,airdrop-20181115-hdac-sum-user-id-withdrawal,accac570-de75-11e8-bd11-2f9252c4dc2f,AIRDROP,0
airdrop-20181115-hdac-9b04f2a8-8cf8-4ff8-a472-43fc50ca71bd-withdrawal-exchange,2018.11.15 10:11,UNKNOWN,,UNKNOWN-55c0f2b7-dc24-425b-9be8-6b86719f2865,2018.11.15 10:11,UNKNOWN,0,100,0,HDAC,WITHDRAWAL,,,,0,COMPLETED,0,sum-user-id,1646053.432,airdrop-20181115-hdac-sum-user-id-withdrawal,accac570-de75-11e8-bd11-2f9252c4dc2f,AIRDROP,0
airdrop-20181115-hdac-9b1a92bd-8476-4d43-8ab7-afb89aefd4e1-withdrawal-exchange,2018.11.15 10:11,UNKNOWN,,UNKNOWN-55c0f2b7-dc24-425b-9be8-6b86719f2865,2018.11.15 10:11,UNKNOWN,0,100,0,HDAC,WITHDRAWAL,,,,0,COMPLETED,0,sum-user-id,1645953.432,airdrop-20181115-hdac-sum-user-id-withdrawal,accac570-de75-11e8-bd11-2f9252c4dc2f,AIRDROP,0
airdrop-20181115-hdac-9b2a86f0-4b19-4763-a7f6-d4eb6a3ee953-withdrawal-exchange,2018.11.15 10:11,UNKNOWN,,UNKNOWN-55c0f2b7-dc24-425b-9be8-6b86719f2865,2018.11.15 10:11,UNKNOWN,0,100,0,HDAC,WITHDRAWAL,,,,0,COMPLETED,0,sum-user-id,1645853.432,airdrop-20181115-hdac-sum-user-id-withdrawal,accac570-de75-11e8-bd11-2f9252c4dc2f,AIRDROP,0
airdrop-20181115-hdac-9b5dbc31-a3de-4cc9-8e38-709da461d2a5-withdrawal-exchange,2018.11.15 10:11,UNKNOWN,,UNKNOWN-55c0f2b7-dc24-425b-9be8-6b86719f2865,2018.11.15 10:11,UNKNOWN,0,100,0,HDAC,WITHDRAWAL,,,,0,COMPLETED,0,sum-user-id,1645753.432,airdrop-20181115-hdac-sum-user-id-withdrawal,accac570-de75-11e8-bd11-2f9252c4dc2f,AIRDROP,0
airdrop-20181115-hdac-9b852a82-4424-4df8-8ff7-61f5790728de-withdrawal-exchange,2018.11.15 10:11,UNKNOWN,,UNKNOWN-55c0f2b7-dc24-425b-9be8-6b86719f2865,2018.11.15 10:11,UNKNOWN,0,100,0,HDAC,WITHDRAWAL,,,,0,COMPLETED,0,sum-user-id,1645653.432,airdrop-20181115-hdac-sum-user-id-withdrawal,accac570-de75-11e8-bd11-2f9252c4dc2f,AIRDROP,0
airdrop-20181115-hdac-9b8f381a-a7d6-4f16-904d-aa0281c65d94-withdrawal-exchange,2018.11.15 10:11,UNKNOWN,,UNKNOWN-55c0f2b7-dc24-425b-9be8-6b86719f2865,2018.11.15 10:11,UNKNOWN,0,100,0,HDAC,WITHDRAWAL,,,,0,COMPLETED,0,sum-user-id,1645553.432,airdrop-20181115-hdac-sum-user-id-withdrawal,accac570-de75-11e8-bd11-2f9252c4dc2f,AIRDROP,0
airdrop-20181115-hdac-9ba7b6a6-4f0e-43bf-8acc-fe0f6f1ab7be-withdrawal-exchange,2018.11.15 10:11,UNKNOWN,,UNKNOWN-55c0f2b7-dc24-425b-9be8-6b86719f2865,2018.11.15 10:11,UNKNOWN,0,100,0,HDAC,WITHDRAWAL,,,,0,COMPLETED,0,sum-user-id,1645453.432,airdrop-20181115-hdac-sum-user-id-withdrawal,accac570-de75-11e8-bd11-2f9252c4dc2f,AIRDROP,0
airdrop-20181115-hdac-9ba919aa-9dc5-4152-9087-7d9646598ca0-withdrawal-exchange,2018.11.15 10:11,UNKNOWN,,UNKNOWN-55c0f2b7-dc24-425b-9be8-6b86719f2865,2018.11.15 10:11,UNKNOWN,0,100,0,HDAC,WITHDRAWAL,,,,0,COMPLETED,0,sum-user-id,1645353.432,airdrop-20181115-hdac-sum-user-id-withdrawal,accac570-de75-11e8-bd11-2f9252c4dc2f,AIRDROP,0
airdrop-20181115-hdac-9bc8c443-bb7b-44f4-8aab-339da9f23e44-withdrawal-exchange,2018-11-15 10:11:55.019,UNKNOWN,,UNKNOWN-55c0f2b7-dc24-425b-9be8-6b86719f2865,2018-11-15 10:11:55.019,UNKNOWN,0,100,0,HDAC,WITHDRAWAL,,,,0,COMPLETED,0,sum-user-id,1645253.432,airdrop-20181115-hdac-sum-user-id-withdrawal,accac570-de75-11e8-bd11-2f9252c4dc2f,AIRDROP,0
airdrop-20181115-hdac-9bcc4edc-5b9f-4f3f-affb-e3bccd3cdfd8-withdrawal-exchange,2018-11-15 10:11:55.051,UNKNOWN,,UNKNOWN-55c0f2b7-dc24-425b-9be8-6b86719f2865,2018-11-15 10:11:55.051,UNKNOWN,0,100,0,HDAC,WITHDRAWAL,,,,0,COMPLETED,0,sum-user-id,1645153.432,airdrop-20181115-hdac-sum-user-id-withdrawal,accac570-de75-11e8-bd11-2f9252c4dc2f,AIRDROP,0
airdrop-20181115-hdac-9bdef89a-53e4-4c92-ba90-c0fab24ddc3e-withdrawal-exchange,2018-11-15 10:11:55.082,UNKNOWN,,UNKNOWN-55c0f2b7-dc24-425b-9be8-6b86719f2865,2018-11-15 10:11:55.082,UNKNOWN,0,100,0,HDAC,WITHDRAWAL,,,,0,COMPLETED,0,sum-user-id,1645053.432,airdrop-20181115-hdac-sum-user-id-withdrawal,accac570-de75-11e8-bd11-2f9252c4dc2f,AIRDROP,0
airdrop-20181115-hdac-9bf02efe-3853-42fa-98c4-1216536c74a1-withdrawal-exchange,2018.11.15 10:11,UNKNOWN,,UNKNOWN-55c0f2b7-dc24-425b-9be8-6b86719f2865,2018.11.15 10:11,UNKNOWN,0,100,0,HDAC,WITHDRAWAL,,,,0,COMPLETED,0,sum-user-id,1644953.432,airdrop-20181115-hdac-sum-user-id-withdrawal,accac570-de75-11e8-bd11-2f9252c4dc2f,AIRDROP,0
airdrop-20181115-hdac-9bf09f58-92ba-42c2-a63f-2db10b071586-withdrawal-exchange,2018.11.15 10:11,UNKNOWN,,UNKNOWN-55c0f2b7-dc24-425b-9be8-6b86719f2865,2018.11.15 10:11,UNKNOWN,0,100,0,HDAC,WITHDRAWAL,,,,0,COMPLETED,0,sum-user-id,1644853.432,airdrop-20181115-hdac-sum-user-id-withdrawal,accac570-de75-11e8-bd11-2f9252c4dc2f,AIRDROP,0
airdrop-20181115-hdac-9c0a4e69-b006-49f4-98c6-218b477191b0-withdrawal-exchange,2018.11.15 10:11,UNKNOWN,,UNKNOWN-55c0f2b7-dc24-425b-9be8-6b86719f2865,2018.11.15 10:11,UNKNOWN,0,100,0,HDAC,WITHDRAWAL,,,,0,COMPLETED,0,sum-user-id,1644753.432,airdrop-20181115-hdac-sum-user-id-withdrawal,accac570-de75-11e8-bd11-2f9252c4dc2f,AIRDROP,0
airdrop-20181115-hdac-9c2f6b65-efb8-4a32-a7b0-1b161c327ff4-withdrawal-exchange,2018.11.15 10:11,UNKNOWN,,UNKNOWN-55c0f2b7-dc24-425b-9be8-6b86719f2865,2018.11.15 10:11,UNKNOWN,0,100,0,HDAC,WITHDRAWAL,,,,0,COMPLETED,0,sum-user-id,1644653.432,airdrop-20181115-hdac-sum-user-id-withdrawal,accac570-de75-11e8-bd11-2f9252c4dc2f,AIRDROP,0
airdrop-20181115-hdac-9c32ebdd-440c-4f5d-8ff0-10d817413760-withdrawal-exchange,2018.11.15 10:11,UNKNOWN,,UNKNOWN-55c0f2b7-dc24-425b-9be8-6b86719f2865,2018.11.15 10:11,UNKNOWN,0,100,0,HDAC,WITHDRAWAL,,,,0,COMPLETED,0,sum-user-id,1644553.432,airdrop-20181115-hdac-sum-user-id-withdrawal,accac570-de75-11e8-bd11-2f9252c4dc2f,AIRDROP,0
airdrop-20181115-hdac-9c392466-112a-4faa-a047-b4fd51f3436c-withdrawal-exchange,2018.11.15 10:11,UNKNOWN,,UNKNOWN-55c0f2b7-dc24-425b-9be8-6b86719f2865,2018.11.15 10:11,UNKNOWN,0,100,0,HDAC,WITHDRAWAL,,,,0,COMPLETED,0,sum-user-id,1644453.432,airdrop-20181115-hdac-sum-user-id-withdrawal,accac570-de75-11e8-bd11-2f9252c4dc2f,AIRDROP,0
airdrop-20181115-hdac-9c50c867-3900-41c8-adba-2ee6b4cad816-withdrawal-exchange,2018.11.15 10:11,UNKNOWN,,UNKNOWN-55c0f2b7-dc24-425b-9be8-6b86719f2865,2018.11.15 10:11,UNKNOWN,0,100,0,HDAC,WITHDRAWAL,,,,0,COMPLETED,0,sum-user-id,1644353.432,airdrop-20181115-hdac-sum-user-id-withdrawal,accac570-de75-11e8-bd11-2f9252c4dc2f,AIRDROP,0
airdrop-20181115-hdac-9c55cd84-fcb3-4600-b34e-cf85a87cb010-withdrawal-exchange,2018.11.15 10:11,UNKNOWN,,UNKNOWN-55c0f2b7-dc24-425b-9be8-6b86719f2865,2018.11.15 10:11,UNKNOWN,0,100,0,HDAC,WITHDRAWAL,,,,0,COMPLETED,0,sum-user-id,1644253.432,airdrop-20181115-hdac-sum-user-id-withdrawal,accac570-de75-11e8-bd11-2f9252c4dc2f,AIRDROP,0
airdrop-20181115-hdac-9c632199-6d5a-499b-8de3-7443d81cfa34-withdrawal-exchange,2018.11.15 10:11,UNKNOWN,,UNKNOWN-55c0f2b7-dc24-425b-9be8-6b86719f2865,2018.11.15 10:11,UNKNOWN,0,100,0,HDAC,WITHDRAWAL,,,,0,COMPLETED,0,sum-user-id,1644153.432,airdrop-20181115-hdac-sum-user-id-withdrawal,accac570-de75-11e8-bd11-2f9252c4dc2f,AIRDROP,0
airdrop-20181115-hdac-9c86bb5b-490d-4f5a-94cf-d67a93e7352b-withdrawal-exchange,2018.11.15 10:11,UNKNOWN,,UNKNOWN-55c0f2b7-dc24-425b-9be8-6b86719f2865,2018.11.15 10:11,UNKNOWN,0,100,0,HDAC,WITHDRAWAL,,,,0,COMPLETED,0,sum-user-id,1644053.432,airdrop-20181115-hdac-sum-user-id-withdrawal,accac570-de75-11e8-bd11-2f9252c4dc2f,AIRDROP,0
airdrop-20181115-hdac-9cadef5d-7ca9-44e9-9791-c1e23687833a-withdrawal-exchange,2018.11.15 10:11,UNKNOWN,,UNKNOWN-55c0f2b7-dc24-425b-9be8-6b86719f2865,2018.11.15 10:11,UNKNOWN,0,100,0,HDAC,WITHDRAWAL,,,,0,COMPLETED,0,sum-user-id,1643953.432,airdrop-20181115-hdac-sum-user-id-withdrawal,accac570-de75-11e8-bd11-2f9252c4dc2f,AIRDROP,0
airdrop-20181115-hdac-9cb38fb3-1039-4382-8ea9-99c612dd5ece-withdrawal-exchange,2018.11.15 10:11,UNKNOWN,,UNKNOWN-55c0f2b7-dc24-425b-9be8-6b86719f2865,2018.11.15 10:11,UNKNOWN,0,100,0,HDAC,WITHDRAWAL,,,,0,COMPLETED,0,sum-user-id,1643853.432,airdrop-20181115-hdac-sum-user-id-withdrawal,accac570-de75-11e8-bd11-2f9252c4dc2f,AIRDROP,0
airdrop-20181115-hdac-9ce4e6bb-f3eb-4740-b13b-95e7def3986e-withdrawal-exchange,2018.11.15 10:11,UNKNOWN,,UNKNOWN-55c0f2b7-dc24-425b-9be8-6b86719f2865,2018.11.15 10:11,UNKNOWN,0,100,0,HDAC,WITHDRAWAL,,,,0,COMPLETED,0,sum-user-id,1643753.432,airdrop-20181115-hdac-sum-user-id-withdrawal,accac570-de75-11e8-bd11-2f9252c4dc2f,AIRDROP,0
airdrop-20181115-hdac-9cf94bd3-6dcf-4158-80b3-0fd3f6910df3-withdrawal-exchange,2018.11.15 10:11,UNKNOWN,,UNKNOWN-55c0f2b7-dc24-425b-9be8-6b86719f2865,2018.11.15 10:11,UNKNOWN,0,100,0,HDAC,WITHDRAWAL,,,,0,COMPLETED,0,sum-user-id,1643653.432,airdrop-20181115-hdac-sum-user-id-withdrawal,accac570-de75-11e8-bd11-2f9252c4dc2f,AIRDROP,0
airdrop-20181115-hdac-9cfd3401-caa8-4222-80b3-9382759f5705-withdrawal-exchange,2018.11.15 10:11,UNKNOWN,,UNKNOWN-55c0f2b7-dc24-425b-9be8-6b86719f2865,2018.11.15 10:11,UNKNOWN,0,100,0,HDAC,WITHDRAWAL,,,,0,COMPLETED,0,sum-user-id,1643553.432,airdrop-20181115-hdac-sum-user-id-withdrawal,accac570-de75-11e8-bd11-2f9252c4dc2f,AIRDROP,0
airdrop-20181115-hdac-9d1af12b-ef5b-4106-9c4d-6843836e184b-withdrawal-exchange,2018.11.15 10:11,UNKNOWN,,UNKNOWN-55c0f2b7-dc24-425b-9be8-6b86719f2865,2018.11.15 10:11,UNKNOWN,0,100,0,HDAC,WITHDRAWAL,,,,0,COMPLETED,0,sum-user-id,1643453.432,airdrop-20181115-hdac-sum-user-id-withdrawal,accac570-de75-11e8-bd11-2f9252c4dc2f,AIRDROP,0
airdrop-20181115-hdac-9d201b3f-9e3a-4aec-bf3d-a3b6e541c85c-withdrawal-exchange,2018.11.15 10:11,UNKNOWN,,UNKNOWN-55c0f2b7-dc24-425b-9be8-6b86719f2865,2018.11.15 10:11,UNKNOWN,0,100,0,HDAC,WITHDRAWAL,,,,0,COMPLETED,0,sum-user-id,1643353.432,airdrop-20181115-hdac-sum-user-id-withdrawal,accac570-de75-11e8-bd11-2f9252c4dc2f,AIRDROP,0
airdrop-20181115-hdac-9d212d58-274b-4d8e-ab22-eddccd8b0162-withdrawal-exchange,2018.11.15 10:11,UNKNOWN,,UNKNOWN-55c0f2b7-dc24-425b-9be8-6b86719f2865,2018.11.15 10:11,UNKNOWN,0,100,0,HDAC,WITHDRAWAL,,,,0,COMPLETED,0,sum-user-id,1643253.432,airdrop-20181115-hdac-sum-user-id-withdrawal,accac570-de75-11e8-bd11-2f9252c4dc2f,AIRDROP,0
airdrop-20181115-hdac-9d42ed50-5982-420b-a413-a48b449a881b-withdrawal-exchange,2018.11.15 10:11,UNKNOWN,,UNKNOWN-55c0f2b7-dc24-425b-9be8-6b86719f2865,2018.11.15 10:11,UNKNOWN,0,100,0,HDAC,WITHDRAWAL,,,,0,COMPLETED,0,sum-user-id,1643153.432,airdrop-20181115-hdac-sum-user-id-withdrawal,accac570-de75-11e8-bd11-2f9252c4dc2f,AIRDROP,0
airdrop-20181115-hdac-9d64ad5f-c0ee-4d4b-a4ff-03f65ccdea39-withdrawal-exchange,2018.11.15 10:11,UNKNOWN,,UNKNOWN-55c0f2b7-dc24-425b-9be8-6b86719f2865,2018.11.15 10:11,UNKNOWN,0,100,0,HDAC,WITHDRAWAL,,,,0,COMPLETED,0,sum-user-id,1643053.432,airdrop-20181115-hdac-sum-user-id-withdrawal,accac570-de75-11e8-bd11-2f9252c4dc2f,AIRDROP,0
airdrop-20181115-hdac-9d86f9a6-6094-491a-b5aa-ff2cae827845-withdrawal-exchange,2018.11.15 10:11,UNKNOWN,,UNKNOWN-55c0f2b7-dc24-425b-9be8-6b86719f2865,2018.11.15 10:11,UNKNOWN,0,19.485009,0,HDAC,WITHDRAWAL,,,,0,COMPLETED,0,sum-user-id,1643033.947,airdrop-20181115-hdac-sum-user-id-withdrawal,accac570-de75-11e8-bd11-2f9252c4dc2f,AIRDROP,0
airdrop-20181115-hdac-9d960492-a6c2-4a1c-baed-c2c92e162253-withdrawal-exchange,2018.11.15 10:11,UNKNOWN,,UNKNOWN-55c0f2b7-dc24-425b-9be8-6b86719f2865,2018.11.15 10:11,UNKNOWN,0,100,0,HDAC,WITHDRAWAL,,,,0,COMPLETED,0,sum-user-id,1642933.947,airdrop-20181115-hdac-sum-user-id-withdrawal,accac570-de75-11e8-bd11-2f9252c4dc2f,AIRDROP,0
airdrop-20181115-hdac-9d96778f-d96c-49d2-ae71-b47d746beb9f-withdrawal-exchange,2018.11.15 10:11,UNKNOWN,,UNKNOWN-55c0f2b7-dc24-425b-9be8-6b86719f2865,2018.11.15 10:11,UNKNOWN,0,100,0,HDAC,WITHDRAWAL,,,,0,COMPLETED,0,sum-user-id,1642833.947,airdrop-20181115-hdac-sum-user-id-withdrawal,accac570-de75-11e8-bd11-2f9252c4dc2f,AIRDROP,0
airdrop-20181115-hdac-9d97ee84-8095-459e-96cf-b941ab43a2cb-withdrawal-exchange,2018.11.15 10:11,UNKNOWN,,UNKNOWN-55c0f2b7-dc24-425b-9be8-6b86719f2865,2018.11.15 10:11,UNKNOWN,0,100,0,HDAC,WITHDRAWAL,,,,0,COMPLETED,0,sum-user-id,1642733.947,airdrop-20181115-hdac-sum-user-id-withdrawal,accac570-de75-11e8-bd11-2f9252c4dc2f,AIRDROP,0
airdrop-20181115-hdac-9d9e32a6-fe48-4109-be55-b28bddc63ba8-withdrawal-exchange,2018.11.15 10:11,UNKNOWN,,UNKNOWN-55c0f2b7-dc24-425b-9be8-6b86719f2865,2018.11.15 10:11,UNKNOWN,0,100,0,HDAC,WITHDRAWAL,,,,0,COMPLETED,0,sum-user-id,1642633.947,airdrop-20181115-hdac-sum-user-id-withdrawal,accac570-de75-11e8-bd11-2f9252c4dc2f,AIRDROP,0
airdrop-20181115-hdac-9db18896-1df0-4a43-80c0-9239b8a0f938-withdrawal-exchange,2018.11.15 10:11,UNKNOWN,,UNKNOWN-55c0f2b7-dc24-425b-9be8-6b86719f2865,2018.11.15 10:11,UNKNOWN,0,100,0,HDAC,WITHDRAWAL,,,,0,COMPLETED,0,sum-user-id,1642533.947,airdrop-20181115-hdac-sum-user-id-withdrawal,accac570-de75-11e8-bd11-2f9252c4dc2f,AIRDROP,0
airdrop-20181115-hdac-9db3b98e-2627-4627-ade0-73d094a68c4b-withdrawal-exchange,2018.11.15 10:11,UNKNOWN,,UNKNOWN-55c0f2b7-dc24-425b-9be8-6b86719f2865,2018.11.15 10:11,UNKNOWN,0,100,0,HDAC,WITHDRAWAL,,,,0,COMPLETED,0,sum-user-id,1642433.947,airdrop-20181115-hdac-sum-user-id-withdrawal,accac570-de75-11e8-bd11-2f9252c4dc2f,AIRDROP,0
airdrop-20181115-hdac-9dc5f075-506a-4366-a0af-e052722bf85b-withdrawal-exchange,2018.11.15 10:11,UNKNOWN,,UNKNOWN-55c0f2b7-dc24-425b-9be8-6b86719f2865,2018.11.15 10:11,UNKNOWN,0,100,0,HDAC,WITHDRAWAL,,,,0,COMPLETED,0,sum-user-id,1642333.947,airdrop-20181115-hdac-sum-user-id-withdrawal,accac570-de75-11e8-bd11-2f9252c4dc2f,AIRDROP,0
airdrop-20181115-hdac-9dd8f158-67a1-4d63-b241-7444c3b37204-withdrawal-exchange,2018.11.15 10:11,UNKNOWN,,UNKNOWN-55c0f2b7-dc24-425b-9be8-6b86719f2865,2018.11.15 10:11,UNKNOWN,0,100,0,HDAC,WITHDRAWAL,,,,0,COMPLETED,0,sum-user-id,1642233.947,airdrop-20181115-hdac-sum-user-id-withdrawal,accac570-de75-11e8-bd11-2f9252c4dc2f,AIRDROP,0
airdrop-20181115-hdac-9df0c497-7da3-4418-8b65-d2bbd2aec983-withdrawal-exchange,2018-11-15 10:11:56.015,UNKNOWN,,UNKNOWN-55c0f2b7-dc24-425b-9be8-6b86719f2865,2018-11-15 10:11:56.015,UNKNOWN,0,100,0,HDAC,WITHDRAWAL,,,,0,COMPLETED,0,sum-user-id,1642133.947,airdrop-20181115-hdac-sum-user-id-withdrawal,accac570-de75-11e8-bd11-2f9252c4dc2f,AIRDROP,0
airdrop-20181115-hdac-9e0a2b01-be6d-4bf8-84d2-ca69bb4aaae7-withdrawal-exchange,2018-11-15 10:11:56.047,UNKNOWN,,UNKNOWN-55c0f2b7-dc24-425b-9be8-6b86719f2865,2018-11-15 10:11:56.047,UNKNOWN,0,100,0,HDAC,WITHDRAWAL,,,,0,COMPLETED,0,sum-user-id,1642033.947,airdrop-20181115-hdac-sum-user-id-withdrawal,accac570-de75-11e8-bd11-2f9252c4dc2f,AIRDROP,0
airdrop-20181115-hdac-9e0ccebc-0ba9-44b6-80b1-9d574b710ae6-withdrawal-exchange,2018-11-15 10:11:56.078,UNKNOWN,,UNKNOWN-55c0f2b7-dc24-425b-9be8-6b86719f2865,2018-11-15 10:11:56.078,UNKNOWN,0,100,0,HDAC,WITHDRAWAL,,,,0,COMPLETED,0,sum-user-id,1641933.947,airdrop-20181115-hdac-sum-user-id-withdrawal,accac570-de75-11e8-bd11-2f9252c4dc2f,AIRDROP,0
airdrop-20181115-hdac-9e22d8f0-bb1b-43ed-9ae0-339fa7ab0be8-withdrawal-exchange,2018.11.15 10:11,UNKNOWN,,UNKNOWN-55c0f2b7-dc24-425b-9be8-6b86719f2865,2018.11.15 10:11,UNKNOWN,0,100,0,HDAC,WITHDRAWAL,,,,0,COMPLETED,0,sum-user-id,1641833.947,airdrop-20181115-hdac-sum-user-id-withdrawal,accac570-de75-11e8-bd11-2f9252c4dc2f,AIRDROP,0
airdrop-20181115-hdac-9e247fb4-a649-432c-8324-54c4252225c0-withdrawal-exchange,2018.11.15 10:11,UNKNOWN,,UNKNOWN-55c0f2b7-dc24-425b-9be8-6b86719f2865,2018.11.15 10:11,UNKNOWN,0,100,0,HDAC,WITHDRAWAL,,,,0,COMPLETED,0,sum-user-id,1641733.947,airdrop-20181115-hdac-sum-user-id-withdrawal,accac570-de75-11e8-bd11-2f9252c4dc2f,AIRDROP,0
airdrop-20181115-hdac-9e35affe-6784-446a-9b93-5f882cf17d68-withdrawal-exchange,2018.11.15 10:11,UNKNOWN,,UNKNOWN-55c0f2b7-dc24-425b-9be8-6b86719f2865,2018.11.15 10:11,UNKNOWN,0,100,0,HDAC,WITHDRAWAL,,,,0,COMPLETED,0,sum-user-id,1641633.947,airdrop-20181115-hdac-sum-user-id-withdrawal,accac570-de75-11e8-bd11-2f9252c4dc2f,AIRDROP,0
airdrop-20181115-hdac-9e819a29-86d5-47ad-a942-c8092c050df2-withdrawal-exchange,2018.11.15 10:11,UNKNOWN,,UNKNOWN-55c0f2b7-dc24-425b-9be8-6b86719f2865,2018.11.15 10:11,UNKNOWN,0,100,0,HDAC,WITHDRAWAL,,,,0,COMPLETED,0,sum-user-id,1641533.947,airdrop-20181115-hdac-sum-user-id-withdrawal,accac570-de75-11e8-bd11-2f9252c4dc2f,AIRDROP,0
airdrop-20181115-hdac-9e930a2c-167e-49f3-a875-aff6273d359e-withdrawal-exchange,2018.11.15 10:11,UNKNOWN,,UNKNOWN-55c0f2b7-dc24-425b-9be8-6b86719f2865,2018.11.15 10:11,UNKNOWN,0,100,0,HDAC,WITHDRAWAL,,,,0,COMPLETED,0,sum-user-id,1641433.947,airdrop-20181115-hdac-sum-user-id-withdrawal,accac570-de75-11e8-bd11-2f9252c4dc2f,AIRDROP,0
airdrop-20181115-hdac-9e9de79f-c738-40c3-a086-d75dd44fe447-withdrawal-exchange,2018.11.15 10:11,UNKNOWN,,UNKNOWN-55c0f2b7-dc24-425b-9be8-6b86719f2865,2018.11.15 10:11,UNKNOWN,0,100,0,HDAC,WITHDRAWAL,,,,0,COMPLETED,0,sum-user-id,1641333.947,airdrop-20181115-hdac-sum-user-id-withdrawal,accac570-de75-11e8-bd11-2f9252c4dc2f,AIRDROP,0
airdrop-20181115-hdac-9ea3c658-67f5-4f78-b8c5-6ddd86fa42d6-withdrawal-exchange,2018.11.15 10:11,UNKNOWN,,UNKNOWN-55c0f2b7-dc24-425b-9be8-6b86719f2865,2018.11.15 10:11,UNKNOWN,0,100,0,HDAC,WITHDRAWAL,,,,0,COMPLETED,0,sum-user-id,1641233.947,airdrop-20181115-hdac-sum-user-id-withdrawal,accac570-de75-11e8-bd11-2f9252c4dc2f,AIRDROP,0
airdrop-20181115-hdac-9ea3f499-76fa-4ea4-9748-b4e06457ee62-withdrawal-exchange,2018.11.15 10:11,UNKNOWN,,UNKNOWN-55c0f2b7-dc24-425b-9be8-6b86719f2865,2018.11.15 10:11,UNKNOWN,0,100,0,HDAC,WITHDRAWAL,,,,0,COMPLETED,0,sum-user-id,1641133.947,airdrop-20181115-hdac-sum-user-id-withdrawal,accac570-de75-11e8-bd11-2f9252c4dc2f,AIRDROP,0
airdrop-20181115-hdac-9ed06ecf-14c0-473b-85a9-42b8342429e6-withdrawal-exchange,2018.11.15 10:11,UNKNOWN,,UNKNOWN-55c0f2b7-dc24-425b-9be8-6b86719f2865,2018.11.15 10:11,UNKNOWN,0,100,0,HDAC,WITHDRAWAL,,,,0,COMPLETED,0,sum-user-id,1641033.947,airdrop-20181115-hdac-sum-user-id-withdrawal,accac570-de75-11e8-bd11-2f9252c4dc2f,AIRDROP,0
airdrop-20181115-hdac-9f528ed3-b38f-4c50-8044-40e9e41df594-withdrawal-exchange,2018.11.15 10:11,UNKNOWN,,UNKNOWN-55c0f2b7-dc24-425b-9be8-6b86719f2865,2018.11.15 10:11,UNKNOWN,0,100,0,HDAC,WITHDRAWAL,,,,0,COMPLETED,0,sum-user-id,1640933.947,airdrop-20181115-hdac-sum-user-id-withdrawal,accac570-de75-11e8-bd11-2f9252c4dc2f,AIRDROP,0
airdrop-20181115-hdac-9f740b05-c83c-4666-bde9-9758ddc25097-withdrawal-exchange,2018.11.15 10:11,UNKNOWN,,UNKNOWN-55c0f2b7-dc24-425b-9be8-6b86719f2865,2018.11.15 10:11,UNKNOWN,0,100,0,HDAC,WITHDRAWAL,,,,0,COMPLETED,0,sum-user-id,1640833.947,airdrop-20181115-hdac-sum-user-id-withdrawal,accac570-de75-11e8-bd11-2f9252c4dc2f,AIRDROP,0
airdrop-20181115-hdac-9fb6eb63-0037-4d8d-aa33-e7fdac1ac1f5-withdrawal-exchange,2018.11.15 10:11,UNKNOWN,,UNKNOWN-55c0f2b7-dc24-425b-9be8-6b86719f2865,2018.11.15 10:11,UNKNOWN,0,100,0,HDAC,WITHDRAWAL,,,,0,COMPLETED,0,sum-user-id,1640733.947,airdrop-20181115-hdac-sum-user-id-withdrawal,accac570-de75-11e8-bd11-2f9252c4dc2f,AIRDROP,0
airdrop-20181115-hdac-9fdfe0fb-6377-44ee-bb86-f1914e0bec4c-withdrawal-exchange,2018.11.15 10:11,UNKNOWN,,UNKNOWN-55c0f2b7-dc24-425b-9be8-6b86719f2865,2018.11.15 10:11,UNKNOWN,0,100,0,HDAC,WITHDRAWAL,,,,0,COMPLETED,0,sum-user-id,1640633.947,airdrop-20181115-hdac-sum-user-id-withdrawal,accac570-de75-11e8-bd11-2f9252c4dc2f,AIRDROP,0
airdrop-20181115-hdac-9fe9296e-9ba0-4619-bc31-85f264c1411c-withdrawal-exchange,2018.11.15 10:11,UNKNOWN,,UNKNOWN-55c0f2b7-dc24-425b-9be8-6b86719f2865,2018.11.15 10:11,UNKNOWN,0,100,0,HDAC,WITHDRAWAL,,,,0,COMPLETED,0,sum-user-id,1640533.947,airdrop-20181115-hdac-sum-user-id-withdrawal,accac570-de75-11e8-bd11-2f9252c4dc2f,AIRDROP,0
airdrop-20181115-hdac-9fe97dea-15a2-4956-b52c-83562c012daf-withdrawal-exchange,2018.11.15 10:12,UNKNOWN,,UNKNOWN-55c0f2b7-dc24-425b-9be8-6b86719f2865,2018.11.15 10:12,UNKNOWN,0,170.091164,0,HDAC,WITHDRAWAL,,,,0,COMPLETED,0,sum-user-id,1243471.91,airdrop-20181115-hdac-sum-user-id-withdrawal,accac570-de75-11e8-bd11-2f9252c4dc2f,AIRDROP,0
airdrop-20181115-hdac-9fec089d-b981-43f4-95e9-dd8bfab6beb5-withdrawal-exchange,2018.11.15 10:11,UNKNOWN,,UNKNOWN-55c0f2b7-dc24-425b-9be8-6b86719f2865,2018.11.15 10:11,UNKNOWN,0,100,0,HDAC,WITHDRAWAL,,,,0,COMPLETED,0,sum-user-id,1640433.947,airdrop-20181115-hdac-sum-user-id-withdrawal,accac570-de75-11e8-bd11-2f9252c4dc2f,AIRDROP,0
airdrop-20181115-hdac-9fed116e-f5e3-464e-87ef-bdf22ea20330-withdrawal-exchange,2018.11.15 10:11,UNKNOWN,,UNKNOWN-55c0f2b7-dc24-425b-9be8-6b86719f2865,2018.11.15 10:11,UNKNOWN,0,100,0,HDAC,WITHDRAWAL,,,,0,COMPLETED,0,sum-user-id,1640333.947,airdrop-20181115-hdac-sum-user-id-withdrawal,accac570-de75-11e8-bd11-2f9252c4dc2f,AIRDROP,0
airdrop-20181115-hdac-9ff867c1-d6b6-41b9-bf7e-698603fe6c6e-withdrawal-exchange,2018.11.15 10:11,UNKNOWN,,UNKNOWN-55c0f2b7-dc24-425b-9be8-6b86719f2865,2018.11.15 10:11,UNKNOWN,0,100,0,HDAC,WITHDRAWAL,,,,0,COMPLETED,0,sum-user-id,1640233.947,airdrop-20181115-hdac-sum-user-id-withdrawal,accac570-de75-11e8-bd11-2f9252c4dc2f,AIRDROP,0
airdrop-20181115-hdac-a0303881-12fb-4163-bdee-e7dc5af8f816-withdrawal-exchange,2018.11.15 10:11,UNKNOWN,,UNKNOWN-55c0f2b7-dc24-425b-9be8-6b86719f2865,2018.11.15 10:11,UNKNOWN,0,100,0,HDAC,WITHDRAWAL,,,,0,COMPLETED,0,sum-user-id,1640133.947,airdrop-20181115-hdac-sum-user-id-withdrawal,accac570-de75-11e8-bd11-2f9252c4dc2f,AIRDROP,0
airdrop-20181115-hdac-a0448d7d-64f1-47b2-9149-4b25cc4c6771-withdrawal-exchange,2018.11.15 10:11,UNKNOWN,,UNKNOWN-55c0f2b7-dc24-425b-9be8-6b86719f2865,2018.11.15 10:11,UNKNOWN,0,100,0,HDAC,WITHDRAWAL,,,,0,COMPLETED,0,sum-user-id,1640033.947,airdrop-20181115-hdac-sum-user-id-withdrawal,accac570-de75-11e8-bd11-2f9252c4dc2f,AIRDROP,0
airdrop-20181115-hdac-a050f596-df27-41be-950d-35adefae9bc3-withdrawal-exchange,2018.11.15 10:11,UNKNOWN,,UNKNOWN-55c0f2b7-dc24-425b-9be8-6b86719f2865,2018.11.15 10:11,UNKNOWN,0,100,0,HDAC,WITHDRAWAL,,,,0,COMPLETED,0,sum-user-id,1639933.947,airdrop-20181115-hdac-sum-user-id-withdrawal,accac570-de75-11e8-bd11-2f9252c4dc2f,AIRDROP,0
airdrop-20181115-hdac-a0577257-a6d1-49fb-95c8-c9d28d0ec941-withdrawal-exchange,2018.11.15 10:11,UNKNOWN,,UNKNOWN-55c0f2b7-dc24-425b-9be8-6b86719f2865,2018.11.15 10:11,UNKNOWN,0,100,0,HDAC,WITHDRAWAL,,,,0,COMPLETED,0,sum-user-id,1639833.947,airdrop-20181115-hdac-sum-user-id-withdrawal,accac570-de75-11e8-bd11-2f9252c4dc2f,AIRDROP,0
airdrop-20181115-hdac-a085f293-d8d7-4c37-8647-f22762821402-withdrawal-exchange,2018.11.15 10:11,UNKNOWN,,UNKNOWN-55c0f2b7-dc24-425b-9be8-6b86719f2865,2018.11.15 10:11,UNKNOWN,0,100,0,HDAC,WITHDRAWAL,,,,0,COMPLETED,0,sum-user-id,1639733.947,airdrop-20181115-hdac-sum-user-id-withdrawal,accac570-de75-11e8-bd11-2f9252c4dc2f,AIRDROP,0
airdrop-20181115-hdac-a08cc97a-6490-4bf8-900f-7e65ed8db504-withdrawal-exchange,2018.11.15 10:11,UNKNOWN,,UNKNOWN-55c0f2b7-dc24-425b-9be8-6b86719f2865,2018.11.15 10:11,UNKNOWN,0,100,0,HDAC,WITHDRAWAL,,,,0,COMPLETED,0,sum-user-id,1639633.947,airdrop-20181115-hdac-sum-user-id-withdrawal,accac570-de75-11e8-bd11-2f9252c4dc2f,AIRDROP,0
airdrop-20181115-hdac-a0a26fc3-fdad-4779-9b56-1f7f68ff0233-withdrawal-exchange,2018.11.15 10:11,UNKNOWN,,UNKNOWN-55c0f2b7-dc24-425b-9be8-6b86719f2865,2018.11.15 10:11,UNKNOWN,0,100,0,HDAC,WITHDRAWAL,,,,0,COMPLETED,0,sum-user-id,1639533.947,airdrop-20181115-hdac-sum-user-id-withdrawal,accac570-de75-11e8-bd11-2f9252c4dc2f,AIRDROP,0
airdrop-20181115-hdac-a0a89629-e739-4d8e-af15-6f3c35a22f39-withdrawal-exchange,2018.11.15 10:11,UNKNOWN,,UNKNOWN-55c0f2b7-dc24-425b-9be8-6b86719f2865,2018.11.15 10:11,UNKNOWN,0,100,0,HDAC,WITHDRAWAL,,,,0,COMPLETED,0,sum-user-id,1639433.947,airdrop-20181115-hdac-sum-user-id-withdrawal,accac570-de75-11e8-bd11-2f9252c4dc2f,AIRDROP,0
airdrop-20181115-hdac-a0c70679-af99-4fec-b61a-0332cd9105dc-withdrawal-exchange,2018.11.15 10:11,UNKNOWN,,UNKNOWN-55c0f2b7-dc24-425b-9be8-6b86719f2865,2018.11.15 10:11,UNKNOWN,0,100,0,HDAC,WITHDRAWAL,,,,0,COMPLETED,0,sum-user-id,1639333.947,airdrop-20181115-hdac-sum-user-id-withdrawal,accac570-de75-11e8-bd11-2f9252c4dc2f,AIRDROP,0
airdrop-20181115-hdac-a0e4b531-f8c7-4a3d-b1f2-81e56664e010-withdrawal-exchange,2018.11.15 10:11,UNKNOWN,,UNKNOWN-55c0f2b7-dc24-425b-9be8-6b86719f2865,2018.11.15 10:11,UNKNOWN,0,100,0,HDAC,WITHDRAWAL,,,,0,COMPLETED,0,sum-user-id,1639233.947,airdrop-20181115-hdac-sum-user-id-withdrawal,accac570-de75-11e8-bd11-2f9252c4dc2f,AIRDROP,0
airdrop-20181115-hdac-a0ec4202-2645-42c4-8152-20d5ace8849e-withdrawal-exchange,2018.11.15 10:11,UNKNOWN,,UNKNOWN-55c0f2b7-dc24-425b-9be8-6b86719f2865,2018.11.15 10:11,UNKNOWN,0,100,0,HDAC,WITHDRAWAL,,,,0,COMPLETED,0,sum-user-id,1639133.947,airdrop-20181115-hdac-sum-user-id-withdrawal,accac570-de75-11e8-bd11-2f9252c4dc2f,AIRDROP,0
airdrop-20181115-hdac-a1247f65-db11-4e20-9342-ec299ca9f33e-withdrawal-exchange,2018-11-15 10:11:57.014,UNKNOWN,,UNKNOWN-55c0f2b7-dc24-425b-9be8-6b86719f2865,2018-11-15 10:11:57.014,UNKNOWN,0,100,0,HDAC,WITHDRAWAL,,,,0,COMPLETED,0,sum-user-id,1639033.947,airdrop-20181115-hdac-sum-user-id-withdrawal,accac570-de75-11e8-bd11-2f9252c4dc2f,AIRDROP,0
airdrop-20181115-hdac-a15b9d2a-0126-4711-9692-22b89bc8ad18-withdrawal-exchange,2018-11-15 10:11:57.045,UNKNOWN,,UNKNOWN-55c0f2b7-dc24-425b-9be8-6b86719f2865,2018-11-15 10:11:57.045,UNKNOWN,0,100,0,HDAC,WITHDRAWAL,,,,0,COMPLETED,0,sum-user-id,1638933.947,airdrop-20181115-hdac-sum-user-id-withdrawal,accac570-de75-11e8-bd11-2f9252c4dc2f,AIRDROP,0
airdrop-20181115-hdac-a18b51d2-a25f-4f11-98d0-4c24ded7d998-withdrawal-exchange,2018-11-15 10:11:57.077,UNKNOWN,,UNKNOWN-55c0f2b7-dc24-425b-9be8-6b86719f2865,2018-11-15 10:11:57.077,UNKNOWN,0,100,0,HDAC,WITHDRAWAL,,,,0,COMPLETED,0,sum-user-id,1638833.947,airdrop-20181115-hdac-sum-user-id-withdrawal,accac570-de75-11e8-bd11-2f9252c4dc2f,AIRDROP,0
airdrop-20181115-hdac-a1a5342c-70ce-4b9c-a27c-1f7f648e69ab-withdrawal-exchange,2018.11.15 10:11,UNKNOWN,,UNKNOWN-55c0f2b7-dc24-425b-9be8-6b86719f2865,2018.11.15 10:11,UNKNOWN,0,100,0,HDAC,WITHDRAWAL,,,,0,COMPLETED,0,sum-user-id,1638733.947,airdrop-20181115-hdac-sum-user-id-withdrawal,accac570-de75-11e8-bd11-2f9252c4dc2f,AIRDROP,0
airdrop-20181115-hdac-a1ae9886-6b81-4708-a0a3-59fd347480c7-withdrawal-exchange,2018.11.15 10:11,UNKNOWN,,UNKNOWN-55c0f2b7-dc24-425b-9be8-6b86719f2865,2018.11.15 10:11,UNKNOWN,0,100,0,HDAC,WITHDRAWAL,,,,0,COMPLETED,0,sum-user-id,1638633.947,airdrop-20181115-hdac-sum-user-id-withdrawal,accac570-de75-11e8-bd11-2f9252c4dc2f,AIRDROP,0
airdrop-20181115-hdac-a1b97ca9-f026-4194-9b78-dcbe87faa32d-withdrawal-exchange,2018.11.15 10:11,UNKNOWN,,UNKNOWN-55c0f2b7-dc24-425b-9be8-6b86719f2865,2018.11.15 10:11,UNKNOWN,0,100,0,HDAC,WITHDRAWAL,,,,0,COMPLETED,0,sum-user-id,1638533.947,airdrop-20181115-hdac-sum-user-id-withdrawal,accac570-de75-11e8-bd11-2f9252c4dc2f,AIRDROP,0
airdrop-20181115-hdac-a1f01c43-dc5b-48c7-b3c1-a57b01fd1154-withdrawal-exchange,2018.11.15 10:11,UNKNOWN,,UNKNOWN-55c0f2b7-dc24-425b-9be8-6b86719f2865,2018.11.15 10:11,UNKNOWN,0,100,0,HDAC,WITHDRAWAL,,,,0,COMPLETED,0,sum-user-id,1638433.947,airdrop-20181115-hdac-sum-user-id-withdrawal,accac570-de75-11e8-bd11-2f9252c4dc2f,AIRDROP,0
airdrop-20181115-hdac-a1fe5f71-d74d-40fe-9340-fa6353f4742f-withdrawal-exchange,2018.11.15 10:11,UNKNOWN,,UNKNOWN-55c0f2b7-dc24-425b-9be8-6b86719f2865,2018.11.15 10:11,UNKNOWN,0,100,0,HDAC,WITHDRAWAL,,,,0,COMPLETED,0,sum-user-id,1638333.947,airdrop-20181115-hdac-sum-user-id-withdrawal,accac570-de75-11e8-bd11-2f9252c4dc2f,AIRDROP,0
airdrop-20181115-hdac-a21a0085-c129-473f-8f9e-378702778e25-withdrawal-exchange,2018.11.15 10:11,UNKNOWN,,UNKNOWN-55c0f2b7-dc24-425b-9be8-6b86719f2865,2018.11.15 10:11,UNKNOWN,0,100,0,HDAC,WITHDRAWAL,,,,0,COMPLETED,0,sum-user-id,1638233.947,airdrop-20181115-hdac-sum-user-id-withdrawal,accac570-de75-11e8-bd11-2f9252c4dc2f,AIRDROP,0
airdrop-20181115-hdac-a21aa582-2cf3-4350-b0ac-f0214e83fe87-withdrawal-exchange,2018.11.15 10:11,UNKNOWN,,UNKNOWN-55c0f2b7-dc24-425b-9be8-6b86719f2865,2018.11.15 10:11,UNKNOWN,0,100,0,HDAC,WITHDRAWAL,,,,0,COMPLETED,0,sum-user-id,1638133.947,airdrop-20181115-hdac-sum-user-id-withdrawal,accac570-de75-11e8-bd11-2f9252c4dc2f,AIRDROP,0
airdrop-20181115-hdac-a21aec85-84da-4df3-9f3f-a209d3cd2448-withdrawal-exchange,2018.11.15 10:11,UNKNOWN,,UNKNOWN-55c0f2b7-dc24-425b-9be8-6b86719f2865,2018.11.15 10:11,UNKNOWN,0,100,0,HDAC,WITHDRAWAL,,,,0,COMPLETED,0,sum-user-id,1638033.947,airdrop-20181115-hdac-sum-user-id-withdrawal,accac570-de75-11e8-bd11-2f9252c4dc2f,AIRDROP,0
airdrop-20181115-hdac-a2503d89-fbca-4d31-9ec5-b02020d5de36-withdrawal-exchange,2018.11.15 10:11,UNKNOWN,,UNKNOWN-55c0f2b7-dc24-425b-9be8-6b86719f2865,2018.11.15 10:11,UNKNOWN,0,100,0,HDAC,WITHDRAWAL,,,,0,COMPLETED,0,sum-user-id,1637933.947,airdrop-20181115-hdac-sum-user-id-withdrawal,accac570-de75-11e8-bd11-2f9252c4dc2f,AIRDROP,0
airdrop-20181115-hdac-a2587240-a2b6-4e22-851f-1e71e0afd945-withdrawal-exchange,2018.11.15 10:11,UNKNOWN,,UNKNOWN-55c0f2b7-dc24-425b-9be8-6b86719f2865,2018.11.15 10:11,UNKNOWN,0,100,0,HDAC,WITHDRAWAL,,,,0,COMPLETED,0,sum-user-id,1637833.947,airdrop-20181115-hdac-sum-user-id-withdrawal,accac570-de75-11e8-bd11-2f9252c4dc2f,AIRDROP,0
airdrop-20181115-hdac-a261546c-2f06-49ff-b86b-e7a4f391e4d8-withdrawal-exchange,2018.11.15 10:11,UNKNOWN,,UNKNOWN-55c0f2b7-dc24-425b-9be8-6b86719f2865,2018.11.15 10:11,UNKNOWN,0,100,0,HDAC,WITHDRAWAL,,,,0,COMPLETED,0,sum-user-id,1637733.947,airdrop-20181115-hdac-sum-user-id-withdrawal,accac570-de75-11e8-bd11-2f9252c4dc2f,AIRDROP,0
airdrop-20181115-hdac-a27c53db-3284-4748-b987-8a6994b4ee50-withdrawal-exchange,2018.11.15 10:11,UNKNOWN,,UNKNOWN-55c0f2b7-dc24-425b-9be8-6b86719f2865,2018.11.15 10:11,UNKNOWN,0,100,0,HDAC,WITHDRAWAL,,,,0,COMPLETED,0,sum-user-id,1637633.947,airdrop-20181115-hdac-sum-user-id-withdrawal,accac570-de75-11e8-bd11-2f9252c4dc2f,AIRDROP,0
airdrop-20181115-hdac-a2838b5c-5a1c-4920-9d84-0c545b223ffc-withdrawal-exchange,2018.11.15 10:11,UNKNOWN,,UNKNOWN-55c0f2b7-dc24-425b-9be8-6b86719f2865,2018.11.15 10:11,UNKNOWN,0,100,0,HDAC,WITHDRAWAL,,,,0,COMPLETED,0,sum-user-id,1637533.947,airdrop-20181115-hdac-sum-user-id-withdrawal,accac570-de75-11e8-bd11-2f9252c4dc2f,AIRDROP,0
airdrop-20181115-hdac-a28f953b-aff9-4ac2-979a-2166e9f4fbf2-withdrawal-exchange,2018.11.15 10:11,UNKNOWN,,UNKNOWN-55c0f2b7-dc24-425b-9be8-6b86719f2865,2018.11.15 10:11,UNKNOWN,0,100,0,HDAC,WITHDRAWAL,,,,0,COMPLETED,0,sum-user-id,1637433.947,airdrop-20181115-hdac-sum-user-id-withdrawal,accac570-de75-11e8-bd11-2f9252c4dc2f,AIRDROP,0
airdrop-20181115-hdac-a29146fe-bfac-426b-9487-cf7ab76ad2f1-withdrawal-exchange,2018.11.15 10:11,UNKNOWN,,UNKNOWN-55c0f2b7-dc24-425b-9be8-6b86719f2865,2018.11.15 10:11,UNKNOWN,0,100,0,HDAC,WITHDRAWAL,,,,0,COMPLETED,0,sum-user-id,1637333.947,airdrop-20181115-hdac-sum-user-id-withdrawal,accac570-de75-11e8-bd11-2f9252c4dc2f,AIRDROP,0
airdrop-20181115-hdac-a295dcfa-8a5c-4c29-9e92-a5d8399a9ae0-withdrawal-exchange,2018.11.15 10:12,UNKNOWN,,UNKNOWN-55c0f2b7-dc24-425b-9be8-6b86719f2865,2018.11.15 10:12,UNKNOWN,0,2010.73,0,HDAC,WITHDRAWAL,,,,0,COMPLETED,0,sum-user-id,1241461.18,airdrop-20181115-hdac-sum-user-id-withdrawal,accac570-de75-11e8-bd11-2f9252c4dc2f,AIRDROP,0
airdrop-20181115-hdac-a3869acc-186f-476d-9163-2d037f656a8b-withdrawal-exchange,2018.11.15 10:11,UNKNOWN,,UNKNOWN-55c0f2b7-dc24-425b-9be8-6b86719f2865,2018.11.15 10:11,UNKNOWN,0,100,0,HDAC,WITHDRAWAL,,,,0,COMPLETED,0,sum-user-id,1637233.947,airdrop-20181115-hdac-sum-user-id-withdrawal,accac570-de75-11e8-bd11-2f9252c4dc2f,AIRDROP,0
airdrop-20181115-hdac-a3939245-8f90-400d-bce1-51f7b20f62b1-withdrawal-exchange,2018.11.15 10:11,UNKNOWN,,UNKNOWN-55c0f2b7-dc24-425b-9be8-6b86719f2865,2018.11.15 10:11,UNKNOWN,0,100,0,HDAC,WITHDRAWAL,,,,0,COMPLETED,0,sum-user-id,1637133.947,airdrop-20181115-hdac-sum-user-id-withdrawal,accac570-de75-11e8-bd11-2f9252c4dc2f,AIRDROP,0
airdrop-20181115-hdac-a3bbbd50-ecad-41fc-8838-355511811081-withdrawal-exchange,2018.11.15 10:11,UNKNOWN,,UNKNOWN-55c0f2b7-dc24-425b-9be8-6b86719f2865,2018.11.15 10:11,UNKNOWN,0,100,0,HDAC,WITHDRAWAL,,,,0,COMPLETED,0,sum-user-id,1637033.947,airdrop-20181115-hdac-sum-user-id-withdrawal,accac570-de75-11e8-bd11-2f9252c4dc2f,AIRDROP,0
airdrop-20181115-hdac-a3ffadfa-4829-4f4f-b089-34378683af80-withdrawal-exchange,2018.11.15 10:11,UNKNOWN,,UNKNOWN-55c0f2b7-dc24-425b-9be8-6b86719f2865,2018.11.15 10:11,UNKNOWN,0,100,0,HDAC,WITHDRAWAL,,,,0,COMPLETED,0,sum-user-id,1636933.947,airdrop-20181115-hdac-sum-user-id-withdrawal,accac570-de75-11e8-bd11-2f9252c4dc2f,AIRDROP,0
airdrop-20181115-hdac-a4103460-0c10-4e44-9526-4dcbc2063652-withdrawal-exchange,2018.11.15 10:11,UNKNOWN,,UNKNOWN-55c0f2b7-dc24-425b-9be8-6b86719f2865,2018.11.15 10:11,UNKNOWN,0,100,0,HDAC,WITHDRAWAL,,,,0,COMPLETED,0,sum-user-id,1636833.947,airdrop-20181115-hdac-sum-user-id-withdrawal,accac570-de75-11e8-bd11-2f9252c4dc2f,AIRDROP,0
airdrop-20181115-hdac-a4164976-dd74-455a-b6c4-c3e85d09fa12-withdrawal-exchange,2018.11.15 10:11,UNKNOWN,,UNKNOWN-55c0f2b7-dc24-425b-9be8-6b86719f2865,2018.11.15 10:11,UNKNOWN,0,100,0,HDAC,WITHDRAWAL,,,,0,COMPLETED,0,sum-user-id,1636733.947,airdrop-20181115-hdac-sum-user-id-withdrawal,accac570-de75-11e8-bd11-2f9252c4dc2f,AIRDROP,0
airdrop-20181115-hdac-a42e9a27-9e94-44b3-876f-55ef28dcb036-withdrawal-exchange,2018.11.15 10:11,UNKNOWN,,UNKNOWN-55c0f2b7-dc24-425b-9be8-6b86719f2865,2018.11.15 10:11,UNKNOWN,0,100,0,HDAC,WITHDRAWAL,,,,0,COMPLETED,0,sum-user-id,1636633.947,airdrop-20181115-hdac-sum-user-id-withdrawal,accac570-de75-11e8-bd11-2f9252c4dc2f,AIRDROP,0
airdrop-20181115-hdac-a43bff3c-6ff6-4cbc-b67b-1daa3ef104ca-withdrawal-exchange,2018.11.15 10:11,UNKNOWN,,UNKNOWN-55c0f2b7-dc24-425b-9be8-6b86719f2865,2018.11.15 10:11,UNKNOWN,0,22173.39595,0,HDAC,WITHDRAWAL,,,,0,COMPLETED,0,sum-user-id,1614460.551,airdrop-20181115-hdac-sum-user-id-withdrawal,accac570-de75-11e8-bd11-2f9252c4dc2f,AIRDROP,0
airdrop-20181115-hdac-a4827b39-b8c9-4d12-afd9-f136bf1d2404-withdrawal-exchange,2018.11.15 10:11,UNKNOWN,,UNKNOWN-55c0f2b7-dc24-425b-9be8-6b86719f2865,2018.11.15 10:11,UNKNOWN,0,100,0,HDAC,WITHDRAWAL,,,,0,COMPLETED,0,sum-user-id,1614360.551,airdrop-20181115-hdac-sum-user-id-withdrawal,accac570-de75-11e8-bd11-2f9252c4dc2f,AIRDROP,0
airdrop-20181115-hdac-a488dc73-feb2-4f10-a76c-457ea8be7b4b-withdrawal-exchange,2018.11.15 10:11,UNKNOWN,,UNKNOWN-55c0f2b7-dc24-425b-9be8-6b86719f2865,2018.11.15 10:11,UNKNOWN,0,100,0,HDAC,WITHDRAWAL,,,,0,COMPLETED,0,sum-user-id,1614260.551,airdrop-20181115-hdac-sum-user-id-withdrawal,accac570-de75-11e8-bd11-2f9252c4dc2f,AIRDROP,0
airdrop-20181115-hdac-a496cfc2-6a18-4a1f-b9cf-d578d4839bbc-withdrawal-exchange,2018.11.15 10:11,UNKNOWN,,UNKNOWN-55c0f2b7-dc24-425b-9be8-6b86719f2865,2018.11.15 10:11,UNKNOWN,0,100,0,HDAC,WITHDRAWAL,,,,0,COMPLETED,0,sum-user-id,1614160.551,airdrop-20181115-hdac-sum-user-id-withdrawal,accac570-de75-11e8-bd11-2f9252c4dc2f,AIRDROP,0
airdrop-20181115-hdac-a4da1f7d-2256-47b6-86f0-6f51f841f22b-withdrawal-exchange,2018.11.15 10:11,UNKNOWN,,UNKNOWN-55c0f2b7-dc24-425b-9be8-6b86719f2865,2018.11.15 10:11,UNKNOWN,0,100,0,HDAC,WITHDRAWAL,,,,0,COMPLETED,0,sum-user-id,1614060.551,airdrop-20181115-hdac-sum-user-id-withdrawal,accac570-de75-11e8-bd11-2f9252c4dc2f,AIRDROP,0
airdrop-20181115-hdac-a4ee8540-a304-41b5-8d6f-56faacfc2a15-withdrawal-exchange,2018.11.15 10:11,UNKNOWN,,UNKNOWN-55c0f2b7-dc24-425b-9be8-6b86719f2865,2018.11.15 10:11,UNKNOWN,0,100,0,HDAC,WITHDRAWAL,,,,0,COMPLETED,0,sum-user-id,1613960.551,airdrop-20181115-hdac-sum-user-id-withdrawal,accac570-de75-11e8-bd11-2f9252c4dc2f,AIRDROP,0
airdrop-20181115-hdac-a511e2cc-0201-4e2f-a04c-9d27d0c63174-withdrawal-exchange,2018-11-15 10:11:58.015,UNKNOWN,,UNKNOWN-55c0f2b7-dc24-425b-9be8-6b86719f2865,2018-11-15 10:11:58.015,UNKNOWN,0,100,0,HDAC,WITHDRAWAL,,,,0,COMPLETED,0,sum-user-id,1613860.551,airdrop-20181115-hdac-sum-user-id-withdrawal,accac570-de75-11e8-bd11-2f9252c4dc2f,AIRDROP,0
airdrop-20181115-hdac-a574ec08-124d-4a6e-b2f8-9f0816917050-withdrawal-exchange,2018-11-15 10:11:58.048,UNKNOWN,,UNKNOWN-55c0f2b7-dc24-425b-9be8-6b86719f2865,2018-11-15 10:11:58.048,UNKNOWN,0,100,0,HDAC,WITHDRAWAL,,,,0,COMPLETED,0,sum-user-id,1613760.551,airdrop-20181115-hdac-sum-user-id-withdrawal,accac570-de75-11e8-bd11-2f9252c4dc2f,AIRDROP,0
airdrop-20181115-hdac-a57a5ef5-b982-4509-a1c0-fd9a023b48d9-withdrawal-exchange,2018-11-15 10:11:58.076,UNKNOWN,,UNKNOWN-55c0f2b7-dc24-425b-9be8-6b86719f2865,2018-11-15 10:11:58.076,UNKNOWN,0,100,0,HDAC,WITHDRAWAL,,,,0,COMPLETED,0,sum-user-id,1613660.551,airdrop-20181115-hdac-sum-user-id-withdrawal,accac570-de75-11e8-bd11-2f9252c4dc2f,AIRDROP,0
airdrop-20181115-hdac-a57bed02-523c-4f2c-8376-5e4a7cb57e07-withdrawal-exchange,2018.11.15 10:11,UNKNOWN,,UNKNOWN-55c0f2b7-dc24-425b-9be8-6b86719f2865,2018.11.15 10:11,UNKNOWN,0,100,0,HDAC,WITHDRAWAL,,,,0,COMPLETED,0,sum-user-id,1613560.551,airdrop-20181115-hdac-sum-user-id-withdrawal,accac570-de75-11e8-bd11-2f9252c4dc2f,AIRDROP,0
airdrop-20181115-hdac-a580c295-ce05-481d-93ca-cbddc171da4a-withdrawal-exchange,2018.11.15 10:11,UNKNOWN,,UNKNOWN-55c0f2b7-dc24-425b-9be8-6b86719f2865,2018.11.15 10:11,UNKNOWN,0,100,0,HDAC,WITHDRAWAL,,,,0,COMPLETED,0,sum-user-id,1613460.551,airdrop-20181115-hdac-sum-user-id-withdrawal,accac570-de75-11e8-bd11-2f9252c4dc2f,AIRDROP,0
airdrop-20181115-hdac-a5c8fab0-fa64-4811-aba0-5389453d8c26-withdrawal-exchange,2018.11.15 10:11,UNKNOWN,,UNKNOWN-55c0f2b7-dc24-425b-9be8-6b86719f2865,2018.11.15 10:11,UNKNOWN,0,10411.99794,0,HDAC,WITHDRAWAL,,,,0,COMPLETED,0,sum-user-id,1603048.553,airdrop-20181115-hdac-sum-user-id-withdrawal,accac570-de75-11e8-bd11-2f9252c4dc2f,AIRDROP,0
airdrop-20181115-hdac-a5f66cf2-80de-4958-a53d-6b48b81cee54-withdrawal-exchange,2018.11.15 10:11,UNKNOWN,,UNKNOWN-55c0f2b7-dc24-425b-9be8-6b86719f2865,2018.11.15 10:11,UNKNOWN,0,100,0,HDAC,WITHDRAWAL,,,,0,COMPLETED,0,sum-user-id,1602948.553,airdrop-20181115-hdac-sum-user-id-withdrawal,accac570-de75-11e8-bd11-2f9252c4dc2f,AIRDROP,0
airdrop-20181115-hdac-a60bf9e2-9692-40d4-93c4-6751a8cdbaa9-withdrawal-exchange,2018.11.15 10:11,UNKNOWN,,UNKNOWN-55c0f2b7-dc24-425b-9be8-6b86719f2865,2018.11.15 10:11,UNKNOWN,0,100,0,HDAC,WITHDRAWAL,,,,0,COMPLETED,0,sum-user-id,1602848.553,airdrop-20181115-hdac-sum-user-id-withdrawal,accac570-de75-11e8-bd11-2f9252c4dc2f,AIRDROP,0
airdrop-20181115-hdac-a62f23dc-995c-4ab2-a301-53d161a10ecc-withdrawal-exchange,2018.11.15 10:11,UNKNOWN,,UNKNOWN-55c0f2b7-dc24-425b-9be8-6b86719f2865,2018.11.15 10:11,UNKNOWN,0,100,0,HDAC,WITHDRAWAL,,,,0,COMPLETED,0,sum-user-id,1602748.553,airdrop-20181115-hdac-sum-user-id-withdrawal,accac570-de75-11e8-bd11-2f9252c4dc2f,AIRDROP,0
airdrop-20181115-hdac-a6357aa3-b2ec-41d9-bfdc-6d088f18aaef-withdrawal-exchange,2018.11.15 10:11,UNKNOWN,,UNKNOWN-55c0f2b7-dc24-425b-9be8-6b86719f2865,2018.11.15 10:11,UNKNOWN,0,100,0,HDAC,WITHDRAWAL,,,,0,COMPLETED,0,sum-user-id,1602648.553,airdrop-20181115-hdac-sum-user-id-withdrawal,accac570-de75-11e8-bd11-2f9252c4dc2f,AIRDROP,0
airdrop-20181115-hdac-a6364498-1e93-4d97-9572-e724513fa16f-withdrawal-exchange,2018.11.15 10:11,UNKNOWN,,UNKNOWN-55c0f2b7-dc24-425b-9be8-6b86719f2865,2018.11.15 10:11,UNKNOWN,0,100,0,HDAC,WITHDRAWAL,,,,0,COMPLETED,0,sum-user-id,1602548.553,airdrop-20181115-hdac-sum-user-id-withdrawal,accac570-de75-11e8-bd11-2f9252c4dc2f,AIRDROP,0
airdrop-20181115-hdac-a64defe6-8b75-4a9c-a644-9e31ed90f769-withdrawal-exchange,2018.11.15 10:11,UNKNOWN,,UNKNOWN-55c0f2b7-dc24-425b-9be8-6b86719f2865,2018.11.15 10:11,UNKNOWN,0,100,0,HDAC,WITHDRAWAL,,,,0,COMPLETED,0,sum-user-id,1602448.553,airdrop-20181115-hdac-sum-user-id-withdrawal,accac570-de75-11e8-bd11-2f9252c4dc2f,AIRDROP,0
airdrop-20181115-hdac-a6b19e06-2e56-4a6f-8b1d-33c290e8a398-withdrawal-exchange,2018.11.15 10:11,UNKNOWN,,UNKNOWN-55c0f2b7-dc24-425b-9be8-6b86719f2865,2018.11.15 10:11,UNKNOWN,0,100,0,HDAC,WITHDRAWAL,,,,0,COMPLETED,0,sum-user-id,1602348.553,airdrop-20181115-hdac-sum-user-id-withdrawal,accac570-de75-11e8-bd11-2f9252c4dc2f,AIRDROP,0
airdrop-20181115-hdac-a6ba0191-2290-4ac0-aed3-f7bd06b23dbe-withdrawal-exchange,2018.11.15 10:11,UNKNOWN,,UNKNOWN-55c0f2b7-dc24-425b-9be8-6b86719f2865,2018.11.15 10:11,UNKNOWN,0,100,0,HDAC,WITHDRAWAL,,,,0,COMPLETED,0,sum-user-id,1602248.553,airdrop-20181115-hdac-sum-user-id-withdrawal,accac570-de75-11e8-bd11-2f9252c4dc2f,AIRDROP,0
airdrop-20181115-hdac-a6ec4906-e103-4c1c-819c-96d111edcc84-withdrawal-exchange,2018.11.15 10:11,UNKNOWN,,UNKNOWN-55c0f2b7-dc24-425b-9be8-6b86719f2865,2018.11.15 10:11,UNKNOWN,0,100,0,HDAC,WITHDRAWAL,,,,0,COMPLETED,0,sum-user-id,1602148.553,airdrop-20181115-hdac-sum-user-id-withdrawal,accac570-de75-11e8-bd11-2f9252c4dc2f,AIRDROP,0
airdrop-20181115-hdac-a6eee22e-0ac8-4ce8-bc63-91265e0f693c-withdrawal-exchange,2018.11.15 10:11,UNKNOWN,,UNKNOWN-55c0f2b7-dc24-425b-9be8-6b86719f2865,2018.11.15 10:11,UNKNOWN,0,100,0,HDAC,WITHDRAWAL,,,,0,COMPLETED,0,sum-user-id,1602048.553,airdrop-20181115-hdac-sum-user-id-withdrawal,accac570-de75-11e8-bd11-2f9252c4dc2f,AIRDROP,0
airdrop-20181115-hdac-a752c03c-e4e5-4db2-acf4-52cff9e5e858-withdrawal-exchange,2018.11.15 10:11,UNKNOWN,,UNKNOWN-55c0f2b7-dc24-425b-9be8-6b86719f2865,2018.11.15 10:11,UNKNOWN,0,100,0,HDAC,WITHDRAWAL,,,,0,COMPLETED,0,sum-user-id,1601948.553,airdrop-20181115-hdac-sum-user-id-withdrawal,accac570-de75-11e8-bd11-2f9252c4dc2f,AIRDROP,0
airdrop-20181115-hdac-a767bea1-ac23-4d08-98ae-3ec88af99cb7-withdrawal-exchange,2018.11.15 10:11,UNKNOWN,,UNKNOWN-55c0f2b7-dc24-425b-9be8-6b86719f2865,2018.11.15 10:11,UNKNOWN,0,100,0,HDAC,WITHDRAWAL,,,,0,COMPLETED,0,sum-user-id,1601848.553,airdrop-20181115-hdac-sum-user-id-withdrawal,accac570-de75-11e8-bd11-2f9252c4dc2f,AIRDROP,0
airdrop-20181115-hdac-a7809b86-5a80-4baa-9818-5c6322448ab0-withdrawal-exchange,2018.11.15 10:11,UNKNOWN,,UNKNOWN-55c0f2b7-dc24-425b-9be8-6b86719f2865,2018.11.15 10:11,UNKNOWN,0,100,0,HDAC,WITHDRAWAL,,,,0,COMPLETED,0,sum-user-id,1601748.553,airdrop-20181115-hdac-sum-user-id-withdrawal,accac570-de75-11e8-bd11-2f9252c4dc2f,AIRDROP,0
airdrop-20181115-hdac-a7a4d983-4e3b-4dda-bbfd-dfbc5a7909d7-withdrawal-exchange,2018.11.15 10:11,UNKNOWN,,UNKNOWN-55c0f2b7-dc24-425b-9be8-6b86719f2865,2018.11.15 10:11,UNKNOWN,0,100,0,HDAC,WITHDRAWAL,,,,0,COMPLETED,0,sum-user-id,1601648.553,airdrop-20181115-hdac-sum-user-id-withdrawal,accac570-de75-11e8-bd11-2f9252c4dc2f,AIRDROP,0
airdrop-20181115-hdac-a7aef53c-a85c-4011-85c9-4e3952b88afb-withdrawal-exchange,2018.11.15 10:11,UNKNOWN,,UNKNOWN-55c0f2b7-dc24-425b-9be8-6b86719f2865,2018.11.15 10:11,UNKNOWN,0,100,0,HDAC,WITHDRAWAL,,,,0,COMPLETED,0,sum-user-id,1601548.553,airdrop-20181115-hdac-sum-user-id-withdrawal,accac570-de75-11e8-bd11-2f9252c4dc2f,AIRDROP,0
airdrop-20181115-hdac-a7b72204-6532-4b1c-b8d0-933f5a00ecfe-withdrawal-exchange,2018.11.15 10:11,UNKNOWN,,UNKNOWN-55c0f2b7-dc24-425b-9be8-6b86719f2865,2018.11.15 10:11,UNKNOWN,0,100,0,HDAC,WITHDRAWAL,,,,0,COMPLETED,0,sum-user-id,1601448.553,airdrop-20181115-hdac-sum-user-id-withdrawal,accac570-de75-11e8-bd11-2f9252c4dc2f,AIRDROP,0
airdrop-20181115-hdac-a7c870f1-23f6-4b76-ab83-04451c03a9a3-withdrawal-exchange,2018.11.15 10:11,UNKNOWN,,UNKNOWN-55c0f2b7-dc24-425b-9be8-6b86719f2865,2018.11.15 10:11,UNKNOWN,0,100,0,HDAC,WITHDRAWAL,,,,0,COMPLETED,0,sum-user-id,1601348.553,airdrop-20181115-hdac-sum-user-id-withdrawal,accac570-de75-11e8-bd11-2f9252c4dc2f,AIRDROP,0
airdrop-20181115-hdac-a7eaf1e8-33b3-46bb-a995-68c057870211-withdrawal-exchange,2018.11.15 10:11,UNKNOWN,,UNKNOWN-55c0f2b7-dc24-425b-9be8-6b86719f2865,2018.11.15 10:11,UNKNOWN,0,100,0,HDAC,WITHDRAWAL,,,,0,COMPLETED,0,sum-user-id,1601248.553,airdrop-20181115-hdac-sum-user-id-withdrawal,accac570-de75-11e8-bd11-2f9252c4dc2f,AIRDROP,0
airdrop-20181115-hdac-a812c34e-cd63-4766-bce9-2a3aa7f682cc-withdrawal-exchange,2018.11.15 10:11,UNKNOWN,,UNKNOWN-55c0f2b7-dc24-425b-9be8-6b86719f2865,2018.11.15 10:11,UNKNOWN,0,100,0,HDAC,WITHDRAWAL,,,,0,COMPLETED,0,sum-user-id,1601148.553,airdrop-20181115-hdac-sum-user-id-withdrawal,accac570-de75-11e8-bd11-2f9252c4dc2f,AIRDROP,0
airdrop-20181115-hdac-a824de02-ae32-4e6f-aa9e-2716fd187b6a-withdrawal-exchange,2018.11.15 10:11,UNKNOWN,,UNKNOWN-55c0f2b7-dc24-425b-9be8-6b86719f2865,2018.11.15 10:11,UNKNOWN,0,100,0,HDAC,WITHDRAWAL,,,,0,COMPLETED,0,sum-user-id,1601048.553,airdrop-20181115-hdac-sum-user-id-withdrawal,accac570-de75-11e8-bd11-2f9252c4dc2f,AIRDROP,0
airdrop-20181115-hdac-a85bfe73-8d3c-49bf-a8fd-4eb5da1fccb8-withdrawal-exchange,2018.11.15 10:11,UNKNOWN,,UNKNOWN-55c0f2b7-dc24-425b-9be8-6b86719f2865,2018.11.15 10:11,UNKNOWN,0,100,0,HDAC,WITHDRAWAL,,,,0,COMPLETED,0,sum-user-id,1600948.553,airdrop-20181115-hdac-sum-user-id-withdrawal,accac570-de75-11e8-bd11-2f9252c4dc2f,AIRDROP,0
airdrop-20181115-hdac-a86cd89b-45d3-4814-b857-cf0c9e24391a-withdrawal-exchange,2018.11.15 10:11,UNKNOWN,,UNKNOWN-55c0f2b7-dc24-425b-9be8-6b86719f2865,2018.11.15 10:11,UNKNOWN,0,100,0,HDAC,WITHDRAWAL,,,,0,COMPLETED,0,sum-user-id,1600848.553,airdrop-20181115-hdac-sum-user-id-withdrawal,accac570-de75-11e8-bd11-2f9252c4dc2f,AIRDROP,0
airdrop-20181115-hdac-a8a9aaa9-f14b-4b7c-9392-5da012b02a24-withdrawal-exchange,2018.11.15 10:11,UNKNOWN,,UNKNOWN-55c0f2b7-dc24-425b-9be8-6b86719f2865,2018.11.15 10:11,UNKNOWN,0,100,0,HDAC,WITHDRAWAL,,,,0,COMPLETED,0,sum-user-id,1600748.553,airdrop-20181115-hdac-sum-user-id-withdrawal,accac570-de75-11e8-bd11-2f9252c4dc2f,AIRDROP,0
airdrop-20181115-hdac-a8b7dc98-81a4-4ec2-8825-f1e451deb191-withdrawal-exchange,2018.11.15 10:11,UNKNOWN,,UNKNOWN-55c0f2b7-dc24-425b-9be8-6b86719f2865,2018.11.15 10:11,UNKNOWN,0,100,0,HDAC,WITHDRAWAL,,,,0,COMPLETED,0,sum-user-id,1600648.553,airdrop-20181115-hdac-sum-user-id-withdrawal,accac570-de75-11e8-bd11-2f9252c4dc2f,AIRDROP,0
airdrop-20181115-hdac-a8d309b4-9d9a-4f01-9ad3-50b6f4622de8-withdrawal-exchange,2018.11.15 10:11,UNKNOWN,,UNKNOWN-55c0f2b7-dc24-425b-9be8-6b86719f2865,2018.11.15 10:11,UNKNOWN,0,100,0,HDAC,WITHDRAWAL,,,,0,COMPLETED,0,sum-user-id,1600548.553,airdrop-20181115-hdac-sum-user-id-withdrawal,accac570-de75-11e8-bd11-2f9252c4dc2f,AIRDROP,0
airdrop-20181115-hdac-a8d681a5-ec16-4e3d-953f-3e4a7f3fe432-withdrawal-exchange,2018.11.15 10:11,UNKNOWN,,UNKNOWN-55c0f2b7-dc24-425b-9be8-6b86719f2865,2018.11.15 10:11,UNKNOWN,0,100,0,HDAC,WITHDRAWAL,,,,0,COMPLETED,0,sum-user-id,1600448.553,airdrop-20181115-hdac-sum-user-id-withdrawal,accac570-de75-11e8-bd11-2f9252c4dc2f,AIRDROP,0
airdrop-20181115-hdac-a8ecc1de-f686-4766-9c23-32f21460de41-withdrawal-exchange,2018-11-15 10:11:59.011,UNKNOWN,,UNKNOWN-55c0f2b7-dc24-425b-9be8-6b86719f2865,2018-11-15 10:11:59.011,UNKNOWN,0,100,0,HDAC,WITHDRAWAL,,,,0,COMPLETED,0,sum-user-id,1600348.553,airdrop-20181115-hdac-sum-user-id-withdrawal,accac570-de75-11e8-bd11-2f9252c4dc2f,AIRDROP,0
airdrop-20181115-hdac-a9005ea5-a671-423e-9d53-1a6eaf385c42-withdrawal-exchange,2018-11-15 10:11:59.043,UNKNOWN,,UNKNOWN-55c0f2b7-dc24-425b-9be8-6b86719f2865,2018-11-15 10:11:59.043,UNKNOWN,0,100,0,HDAC,WITHDRAWAL,,,,0,COMPLETED,0,sum-user-id,1600248.553,airdrop-20181115-hdac-sum-user-id-withdrawal,accac570-de75-11e8-bd11-2f9252c4dc2f,AIRDROP,0
airdrop-20181115-hdac-a904caae-eab6-44eb-be35-0d944c112e84-withdrawal-exchange,2018-11-15 10:11:59.074,UNKNOWN,,UNKNOWN-55c0f2b7-dc24-425b-9be8-6b86719f2865,2018-11-15 10:11:59.074,UNKNOWN,0,100,0,HDAC,WITHDRAWAL,,,,0,COMPLETED,0,sum-user-id,1600148.553,airdrop-20181115-hdac-sum-user-id-withdrawal,accac570-de75-11e8-bd11-2f9252c4dc2f,AIRDROP,0
airdrop-20181115-hdac-a918be09-04e2-4ad0-b711-21ef6c9e48dc-withdrawal-exchange,2018.11.15 10:11,UNKNOWN,,UNKNOWN-55c0f2b7-dc24-425b-9be8-6b86719f2865,2018.11.15 10:11,UNKNOWN,0,100,0,HDAC,WITHDRAWAL,,,,0,COMPLETED,0,sum-user-id,1600048.553,airdrop-20181115-hdac-sum-user-id-withdrawal,accac570-de75-11e8-bd11-2f9252c4dc2f,AIRDROP,0
airdrop-20181115-hdac-a93eee3c-bd71-46e6-9c24-f1a960dcb882-withdrawal-exchange,2018.11.15 10:11,UNKNOWN,,UNKNOWN-55c0f2b7-dc24-425b-9be8-6b86719f2865,2018.11.15 10:11,UNKNOWN,0,100,0,HDAC,WITHDRAWAL,,,,0,COMPLETED,0,sum-user-id,1599948.553,airdrop-20181115-hdac-sum-user-id-withdrawal,accac570-de75-11e8-bd11-2f9252c4dc2f,AIRDROP,0
airdrop-20181115-hdac-a96ad59c-cbfa-4408-96ff-7124fc7be1d5-withdrawal-exchange,2018.11.15 10:11,UNKNOWN,,UNKNOWN-55c0f2b7-dc24-425b-9be8-6b86719f2865,2018.11.15 10:11,UNKNOWN,0,100,0,HDAC,WITHDRAWAL,,,,0,COMPLETED,0,sum-user-id,1599848.553,airdrop-20181115-hdac-sum-user-id-withdrawal,accac570-de75-11e8-bd11-2f9252c4dc2f,AIRDROP,0
airdrop-20181115-hdac-a96e43b5-0bb6-4443-8216-769feae618b2-withdrawal-exchange,2018.11.15 10:11,UNKNOWN,,UNKNOWN-55c0f2b7-dc24-425b-9be8-6b86719f2865,2018.11.15 10:11,UNKNOWN,0,100,0,HDAC,WITHDRAWAL,,,,0,COMPLETED,0,sum-user-id,1599748.553,airdrop-20181115-hdac-sum-user-id-withdrawal,accac570-de75-11e8-bd11-2f9252c4dc2f,AIRDROP,0
airdrop-20181115-hdac-a9779de7-1cee-4df9-842b-b6ad1575c68c-withdrawal-exchange,2018.11.15 10:11,UNKNOWN,,UNKNOWN-55c0f2b7-dc24-425b-9be8-6b86719f2865,2018.11.15 10:11,UNKNOWN,0,100,0,HDAC,WITHDRAWAL,,,,0,COMPLETED,0,sum-user-id,1599648.553,airdrop-20181115-hdac-sum-user-id-withdrawal,accac570-de75-11e8-bd11-2f9252c4dc2f,AIRDROP,0
airdrop-20181115-hdac-a9833b23-b92d-408b-b7c8-c6b4bcd4d95a-withdrawal-exchange,2018.11.15 10:11,UNKNOWN,,UNKNOWN-55c0f2b7-dc24-425b-9be8-6b86719f2865,2018.11.15 10:11,UNKNOWN,0,100,0,HDAC,WITHDRAWAL,,,,0,COMPLETED,0,sum-user-id,1599548.553,airdrop-20181115-hdac-sum-user-id-withdrawal,accac570-de75-11e8-bd11-2f9252c4dc2f,AIRDROP,0
airdrop-20181115-hdac-a9ca425d-c718-4215-8563-4086bbae5c93-withdrawal-exchange,2018.11.15 10:11,UNKNOWN,,UNKNOWN-55c0f2b7-dc24-425b-9be8-6b86719f2865,2018.11.15 10:11,UNKNOWN,0,100,0,HDAC,WITHDRAWAL,,,,0,COMPLETED,0,sum-user-id,1599448.553,airdrop-20181115-hdac-sum-user-id-withdrawal,accac570-de75-11e8-bd11-2f9252c4dc2f,AIRDROP,0
airdrop-20181115-hdac-a9d357de-03b3-48c5-a89a-ec86895c4402-withdrawal-exchange,2018.11.15 10:11,UNKNOWN,,UNKNOWN-55c0f2b7-dc24-425b-9be8-6b86719f2865,2018.11.15 10:11,UNKNOWN,0,100,0,HDAC,WITHDRAWAL,,,,0,COMPLETED,0,sum-user-id,1599348.553,airdrop-20181115-hdac-sum-user-id-withdrawal,accac570-de75-11e8-bd11-2f9252c4dc2f,AIRDROP,0
airdrop-20181115-hdac-a9e40ceb-fd8a-4bb5-bfb8-0e646efc63c0-withdrawal-exchange,2018.11.15 10:11,UNKNOWN,,UNKNOWN-55c0f2b7-dc24-425b-9be8-6b86719f2865,2018.11.15 10:11,UNKNOWN,0,100,0,HDAC,WITHDRAWAL,,,,0,COMPLETED,0,sum-user-id,1599248.553,airdrop-20181115-hdac-sum-user-id-withdrawal,accac570-de75-11e8-bd11-2f9252c4dc2f,AIRDROP,0
airdrop-20181115-hdac-a9ea0e33-9acb-4935-8655-aeedf1a8ce3d-withdrawal-exchange,2018.11.15 10:11,UNKNOWN,,UNKNOWN-55c0f2b7-dc24-425b-9be8-6b86719f2865,2018.11.15 10:11,UNKNOWN,0,100,0,HDAC,WITHDRAWAL,,,,0,COMPLETED,0,sum-user-id,1599148.553,airdrop-20181115-hdac-sum-user-id-withdrawal,accac570-de75-11e8-bd11-2f9252c4dc2f,AIRDROP,0
airdrop-20181115-hdac-a9efe378-f29d-4b46-8f7b-559f964baf6a-withdrawal-exchange,2018.11.15 10:11,UNKNOWN,,UNKNOWN-55c0f2b7-dc24-425b-9be8-6b86719f2865,2018.11.15 10:11,UNKNOWN,0,100,0,HDAC,WITHDRAWAL,,,,0,COMPLETED,0,sum-user-id,1599048.553,airdrop-20181115-hdac-sum-user-id-withdrawal,accac570-de75-11e8-bd11-2f9252c4dc2f,AIRDROP,0
airdrop-20181115-hdac-aa27fa88-4d5c-4b3c-a48f-d50b39dfbdbd-withdrawal-exchange,2018.11.15 10:11,UNKNOWN,,UNKNOWN-55c0f2b7-dc24-425b-9be8-6b86719f2865,2018.11.15 10:11,UNKNOWN,0,100,0,HDAC,WITHDRAWAL,,,,0,COMPLETED,0,sum-user-id,1598948.553,airdrop-20181115-hdac-sum-user-id-withdrawal,accac570-de75-11e8-bd11-2f9252c4dc2f,AIRDROP,0
airdrop-20181115-hdac-aa3a498e-4072-4e9c-bb68-1ab8325530a9-withdrawal-exchange,2018.11.15 10:11,UNKNOWN,,UNKNOWN-55c0f2b7-dc24-425b-9be8-6b86719f2865,2018.11.15 10:11,UNKNOWN,0,100,0,HDAC,WITHDRAWAL,,,,0,COMPLETED,0,sum-user-id,1598848.553,airdrop-20181115-hdac-sum-user-id-withdrawal,accac570-de75-11e8-bd11-2f9252c4dc2f,AIRDROP,0
airdrop-20181115-hdac-aa43e1f3-ec71-44ef-b587-e1eed61c6e91-withdrawal-exchange,2018.11.15 10:11,UNKNOWN,,UNKNOWN-55c0f2b7-dc24-425b-9be8-6b86719f2865,2018.11.15 10:11,UNKNOWN,0,100,0,HDAC,WITHDRAWAL,,,,0,COMPLETED,0,sum-user-id,1598748.553,airdrop-20181115-hdac-sum-user-id-withdrawal,accac570-de75-11e8-bd11-2f9252c4dc2f,AIRDROP,0
airdrop-20181115-hdac-aa483b9e-d382-4fbd-b447-f561776add4a-withdrawal-exchange,2018.11.15 10:11,UNKNOWN,,UNKNOWN-55c0f2b7-dc24-425b-9be8-6b86719f2865,2018.11.15 10:11,UNKNOWN,0,100,0,HDAC,WITHDRAWAL,,,,0,COMPLETED,0,sum-user-id,1598648.553,airdrop-20181115-hdac-sum-user-id-withdrawal,accac570-de75-11e8-bd11-2f9252c4dc2f,AIRDROP,0
airdrop-20181115-hdac-aa4e6f3b-f26f-4e58-81de-5e35a5084478-withdrawal-exchange,2018.11.15 10:11,UNKNOWN,,UNKNOWN-55c0f2b7-dc24-425b-9be8-6b86719f2865,2018.11.15 10:11,UNKNOWN,0,100,0,HDAC,WITHDRAWAL,,,,0,COMPLETED,0,sum-user-id,1598548.553,airdrop-20181115-hdac-sum-user-id-withdrawal,accac570-de75-11e8-bd11-2f9252c4dc2f,AIRDROP,0
airdrop-20181115-hdac-aa974b7a-e44f-4a52-b41a-db001aba1b01-withdrawal-exchange,2018.11.15 10:11,UNKNOWN,,UNKNOWN-55c0f2b7-dc24-425b-9be8-6b86719f2865,2018.11.15 10:11,UNKNOWN,0,100,0,HDAC,WITHDRAWAL,,,,0,COMPLETED,0,sum-user-id,1598448.553,airdrop-20181115-hdac-sum-user-id-withdrawal,accac570-de75-11e8-bd11-2f9252c4dc2f,AIRDROP,0
airdrop-20181115-hdac-aaa21ab0-69b6-4a16-ad79-3679e1339e9e-withdrawal-exchange,2018.11.15 10:11,UNKNOWN,,UNKNOWN-55c0f2b7-dc24-425b-9be8-6b86719f2865,2018.11.15 10:11,UNKNOWN,0,100,0,HDAC,WITHDRAWAL,,,,0,COMPLETED,0,sum-user-id,1598348.553,airdrop-20181115-hdac-sum-user-id-withdrawal,accac570-de75-11e8-bd11-2f9252c4dc2f,AIRDROP,0
airdrop-20181115-hdac-aac0598a-480d-4d98-960d-12d8b9e85cfe-withdrawal-exchange,2018.11.15 10:11,UNKNOWN,,UNKNOWN-55c0f2b7-dc24-425b-9be8-6b86719f2865,2018.11.15 10:11,UNKNOWN,0,100,0,HDAC,WITHDRAWAL,,,,0,COMPLETED,0,sum-user-id,1598248.553,airdrop-20181115-hdac-sum-user-id-withdrawal,accac570-de75-11e8-bd11-2f9252c4dc2f,AIRDROP,0
airdrop-20181115-hdac-aac67585-ccb1-40d9-a187-8b8b118bdec5-withdrawal-exchange,2018.11.15 10:11,UNKNOWN,,UNKNOWN-55c0f2b7-dc24-425b-9be8-6b86719f2865,2018.11.15 10:11,UNKNOWN,0,100,0,HDAC,WITHDRAWAL,,,,0,COMPLETED,0,sum-user-id,1598148.553,airdrop-20181115-hdac-sum-user-id-withdrawal,accac570-de75-11e8-bd11-2f9252c4dc2f,AIRDROP,0
airdrop-20181115-hdac-aad6f97c-96ee-40b8-8cac-ccdfbec0ad37-withdrawal-exchange,2018.11.15 10:11,UNKNOWN,,UNKNOWN-55c0f2b7-dc24-425b-9be8-6b86719f2865,2018.11.15 10:11,UNKNOWN,0,100,0,HDAC,WITHDRAWAL,,,,0,COMPLETED,0,sum-user-id,1598048.553,airdrop-20181115-hdac-sum-user-id-withdrawal,accac570-de75-11e8-bd11-2f9252c4dc2f,AIRDROP,0
airdrop-20181115-hdac-aadd34bc-3ea6-4e6f-a48e-0d0b9baf297a-withdrawal-exchange,2018.11.15 10:11,UNKNOWN,,UNKNOWN-55c0f2b7-dc24-425b-9be8-6b86719f2865,2018.11.15 10:11,UNKNOWN,0,100,0,HDAC,WITHDRAWAL,,,,0,COMPLETED,0,sum-user-id,1597948.553,airdrop-20181115-hdac-sum-user-id-withdrawal,accac570-de75-11e8-bd11-2f9252c4dc2f,AIRDROP,0
airdrop-20181115-hdac-aaec4eda-b4a0-4dd2-bdd7-85c5be2cb8da-withdrawal-exchange,2018.11.15 10:11,UNKNOWN,,UNKNOWN-55c0f2b7-dc24-425b-9be8-6b86719f2865,2018.11.15 10:11,UNKNOWN,0,100,0,HDAC,WITHDRAWAL,,,,0,COMPLETED,0,sum-user-id,1597848.553,airdrop-20181115-hdac-sum-user-id-withdrawal,accac570-de75-11e8-bd11-2f9252c4dc2f,AIRDROP,0
airdrop-20181115-hdac-aaecdc59-0f65-4059-9566-fd85ee00ef0a-withdrawal-exchange,2018.11.15 10:11,UNKNOWN,,UNKNOWN-55c0f2b7-dc24-425b-9be8-6b86719f2865,2018.11.15 10:11,UNKNOWN,0,100,0,HDAC,WITHDRAWAL,,,,0,COMPLETED,0,sum-user-id,1597748.553,airdrop-20181115-hdac-sum-user-id-withdrawal,accac570-de75-11e8-bd11-2f9252c4dc2f,AIRDROP,0
airdrop-20181115-hdac-ab061e24-b0db-48aa-ba4b-2dcc8b27ccc0-withdrawal-exchange,2018.11.15 10:11,UNKNOWN,,UNKNOWN-55c0f2b7-dc24-425b-9be8-6b86719f2865,2018.11.15 10:11,UNKNOWN,0,20763.85799,0,HDAC,WITHDRAWAL,,,,0,COMPLETED,0,sum-user-id,1576984.695,airdrop-20181115-hdac-sum-user-id-withdrawal,accac570-de75-11e8-bd11-2f9252c4dc2f,AIRDROP,0
airdrop-20181115-hdac-ab19f5d0-5b01-43a1-8cce-163a00a994f1-withdrawal-exchange,2018.11.15 10:11,UNKNOWN,,UNKNOWN-55c0f2b7-dc24-425b-9be8-6b86719f2865,2018.11.15 10:11,UNKNOWN,0,100,0,HDAC,WITHDRAWAL,,,,0,COMPLETED,0,sum-user-id,1576884.695,airdrop-20181115-hdac-sum-user-id-withdrawal,accac570-de75-11e8-bd11-2f9252c4dc2f,AIRDROP,0
airdrop-20181115-hdac-ab2b9603-7523-40e9-a350-8b03455141f1-withdrawal-exchange,2018.11.15 10:11,UNKNOWN,,UNKNOWN-55c0f2b7-dc24-425b-9be8-6b86719f2865,2018.11.15 10:11,UNKNOWN,0,100,0,HDAC,WITHDRAWAL,,,,0,COMPLETED,0,sum-user-id,1576784.695,airdrop-20181115-hdac-sum-user-id-withdrawal,accac570-de75-11e8-bd11-2f9252c4dc2f,AIRDROP,0
airdrop-20181115-hdac-ab2be950-946f-4ddb-94a3-4069685c0a1e-withdrawal-exchange,2018.11.15 10:11,UNKNOWN,,UNKNOWN-55c0f2b7-dc24-425b-9be8-6b86719f2865,2018.11.15 10:11,UNKNOWN,0,100,0,HDAC,WITHDRAWAL,,,,0,COMPLETED,0,sum-user-id,1576684.695,airdrop-20181115-hdac-sum-user-id-withdrawal,accac570-de75-11e8-bd11-2f9252c4dc2f,AIRDROP,0
airdrop-20181115-hdac-ab3b1e66-6932-4fb5-949b-69685bb27421-withdrawal-exchange,2018.11.15 10:11,UNKNOWN,,UNKNOWN-55c0f2b7-dc24-425b-9be8-6b86719f2865,2018.11.15 10:11,UNKNOWN,0,100,0,HDAC,WITHDRAWAL,,,,0,COMPLETED,0,sum-user-id,1576584.695,airdrop-20181115-hdac-sum-user-id-withdrawal,accac570-de75-11e8-bd11-2f9252c4dc2f,AIRDROP,0
airdrop-20181115-hdac-aba03451-636c-4016-a517-967161556215-withdrawal-exchange,2018.11.15 10:11,UNKNOWN,,UNKNOWN-55c0f2b7-dc24-425b-9be8-6b86719f2865,2018.11.15 10:11,UNKNOWN,0,100,0,HDAC,WITHDRAWAL,,,,0,COMPLETED,0,sum-user-id,1576484.695,airdrop-20181115-hdac-sum-user-id-withdrawal,accac570-de75-11e8-bd11-2f9252c4dc2f,AIRDROP,0
airdrop-20181115-hdac-abaa9341-2f1f-43af-9c7f-de201ef7b51a-withdrawal-exchange,2018-11-15 10:12:00.033,UNKNOWN,,UNKNOWN-55c0f2b7-dc24-425b-9be8-6b86719f2865,2018-11-15 10:12:00.033,UNKNOWN,0,100,0,HDAC,WITHDRAWAL,,,,0,COMPLETED,0,sum-user-id,1576384.695,airdrop-20181115-hdac-sum-user-id-withdrawal,accac570-de75-11e8-bd11-2f9252c4dc2f,AIRDROP,0
airdrop-20181115-hdac-abaaa67b-88a9-4474-a9a9-756918611b0c-withdrawal-exchange,2018-11-15 10:12:00.070,UNKNOWN,,UNKNOWN-55c0f2b7-dc24-425b-9be8-6b86719f2865,2018-11-15 10:12:00.070,UNKNOWN,0,100,0,HDAC,WITHDRAWAL,,,,0,COMPLETED,0,sum-user-id,1576284.695,airdrop-20181115-hdac-sum-user-id-withdrawal,accac570-de75-11e8-bd11-2f9252c4dc2f,AIRDROP,0
airdrop-20181115-hdac-abb5d81c-de91-48ce-a9a7-6a5c487197ce-withdrawal-exchange,2018.11.15 10:12,UNKNOWN,,UNKNOWN-55c0f2b7-dc24-425b-9be8-6b86719f2865,2018.11.15 10:12,UNKNOWN,0,100,0,HDAC,WITHDRAWAL,,,,0,COMPLETED,0,sum-user-id,1576184.695,airdrop-20181115-hdac-sum-user-id-withdrawal,accac570-de75-11e8-bd11-2f9252c4dc2f,AIRDROP,0
airdrop-20181115-hdac-abbe93f8-c1e8-46b2-a068-a964c8e8f481-withdrawal-exchange,2018.11.15 10:12,UNKNOWN,,UNKNOWN-55c0f2b7-dc24-425b-9be8-6b86719f2865,2018.11.15 10:12,UNKNOWN,0,100,0,HDAC,WITHDRAWAL,,,,0,COMPLETED,0,sum-user-id,1576084.695,airdrop-20181115-hdac-sum-user-id-withdrawal,accac570-de75-11e8-bd11-2f9252c4dc2f,AIRDROP,0
airdrop-20181115-hdac-abc6be33-ba3a-4268-b16c-604dfd031ad7-withdrawal-exchange,2018.11.15 10:12,UNKNOWN,,UNKNOWN-55c0f2b7-dc24-425b-9be8-6b86719f2865,2018.11.15 10:12,UNKNOWN,0,100,0,HDAC,WITHDRAWAL,,,,0,COMPLETED,0,sum-user-id,1575984.695,airdrop-20181115-hdac-sum-user-id-withdrawal,accac570-de75-11e8-bd11-2f9252c4dc2f,AIRDROP,0
airdrop-20181115-hdac-abc9b829-a70e-4db7-b45c-1399993490b6-withdrawal-exchange,2018.11.15 10:12,UNKNOWN,,UNKNOWN-55c0f2b7-dc24-425b-9be8-6b86719f2865,2018.11.15 10:12,UNKNOWN,0,100,0,HDAC,WITHDRAWAL,,,,0,COMPLETED,0,sum-user-id,1575884.695,airdrop-20181115-hdac-sum-user-id-withdrawal,accac570-de75-11e8-bd11-2f9252c4dc2f,AIRDROP,0
airdrop-20181115-hdac-abd4a8e7-1269-449e-9ecd-1e58121ad96d-withdrawal-exchange,2018.11.15 10:12,UNKNOWN,,UNKNOWN-55c0f2b7-dc24-425b-9be8-6b86719f2865,2018.11.15 10:12,UNKNOWN,0,100,0,HDAC,WITHDRAWAL,,,,0,COMPLETED,0,sum-user-id,1575784.695,airdrop-20181115-hdac-sum-user-id-withdrawal,accac570-de75-11e8-bd11-2f9252c4dc2f,AIRDROP,0
airdrop-20181115-hdac-abe00437-bbed-44d3-bbfa-6debfe039479-withdrawal-exchange,2018.11.15 10:12,UNKNOWN,,UNKNOWN-55c0f2b7-dc24-425b-9be8-6b86719f2865,2018.11.15 10:12,UNKNOWN,0,100,0,HDAC,WITHDRAWAL,,,,0,COMPLETED,0,sum-user-id,1575684.695,airdrop-20181115-hdac-sum-user-id-withdrawal,accac570-de75-11e8-bd11-2f9252c4dc2f,AIRDROP,0
airdrop-20181115-hdac-abef7b94-562b-4a26-81b0-822e4a4b1a75-withdrawal-exchange,2018.11.15 10:12,UNKNOWN,,UNKNOWN-55c0f2b7-dc24-425b-9be8-6b86719f2865,2018.11.15 10:12,UNKNOWN,0,100,0,HDAC,WITHDRAWAL,,,,0,COMPLETED,0,sum-user-id,1575584.695,airdrop-20181115-hdac-sum-user-id-withdrawal,accac570-de75-11e8-bd11-2f9252c4dc2f,AIRDROP,0
airdrop-20181115-hdac-abf3331c-683b-4810-9843-180ff08b864f-withdrawal-exchange,2018.11.15 10:12,UNKNOWN,,UNKNOWN-55c0f2b7-dc24-425b-9be8-6b86719f2865,2018.11.15 10:12,UNKNOWN,0,100,0,HDAC,WITHDRAWAL,,,,0,COMPLETED,0,sum-user-id,1575484.695,airdrop-20181115-hdac-sum-user-id-withdrawal,accac570-de75-11e8-bd11-2f9252c4dc2f,AIRDROP,0
airdrop-20181115-hdac-abfefea1-d470-4840-bdc9-ed979715fef0-withdrawal-exchange,2018.11.15 10:12,UNKNOWN,,UNKNOWN-55c0f2b7-dc24-425b-9be8-6b86719f2865,2018.11.15 10:12,UNKNOWN,0,100,0,HDAC,WITHDRAWAL,,,,0,COMPLETED,0,sum-user-id,1575384.695,airdrop-20181115-hdac-sum-user-id-withdrawal,accac570-de75-11e8-bd11-2f9252c4dc2f,AIRDROP,0
airdrop-20181115-hdac-abffa461-0ac6-42e0-a9ba-cd46d6453a57-withdrawal-exchange,2018.11.15 10:12,UNKNOWN,,UNKNOWN-55c0f2b7-dc24-425b-9be8-6b86719f2865,2018.11.15 10:12,UNKNOWN,0,100,0,HDAC,WITHDRAWAL,,,,0,COMPLETED,0,sum-user-id,1575284.695,airdrop-20181115-hdac-sum-user-id-withdrawal,accac570-de75-11e8-bd11-2f9252c4dc2f,AIRDROP,0
airdrop-20181115-hdac-ac169452-b7f0-4ab7-bf29-10b91aa45899-withdrawal-exchange,2018.11.15 10:12,UNKNOWN,,UNKNOWN-55c0f2b7-dc24-425b-9be8-6b86719f2865,2018.11.15 10:12,UNKNOWN,0,100,0,HDAC,WITHDRAWAL,,,,0,COMPLETED,0,sum-user-id,1575184.695,airdrop-20181115-hdac-sum-user-id-withdrawal,accac570-de75-11e8-bd11-2f9252c4dc2f,AIRDROP,0
airdrop-20181115-hdac-ac2dc619-8136-472a-aef9-b8d687662c09-withdrawal-exchange,2018.11.15 10:12,UNKNOWN,,UNKNOWN-55c0f2b7-dc24-425b-9be8-6b86719f2865,2018.11.15 10:12,UNKNOWN,0,100,0,HDAC,WITHDRAWAL,,,,0,COMPLETED,0,sum-user-id,1575084.695,airdrop-20181115-hdac-sum-user-id-withdrawal,accac570-de75-11e8-bd11-2f9252c4dc2f,AIRDROP,0
airdrop-20181115-hdac-ac575e18-9845-4aaf-a95d-f5b0421c509b-withdrawal-exchange,2018.11.15 10:12,UNKNOWN,,UNKNOWN-55c0f2b7-dc24-425b-9be8-6b86719f2865,2018.11.15 10:12,UNKNOWN,0,100,0,HDAC,WITHDRAWAL,,,,0,COMPLETED,0,sum-user-id,1574984.695,airdrop-20181115-hdac-sum-user-id-withdrawal,accac570-de75-11e8-bd11-2f9252c4dc2f,AIRDROP,0
airdrop-20181115-hdac-ac60a262-ce2d-476a-89ec-df5ce550ddec-withdrawal-exchange,2018.11.15 10:12,UNKNOWN,,UNKNOWN-55c0f2b7-dc24-425b-9be8-6b86719f2865,2018.11.15 10:12,UNKNOWN,0,100,0,HDAC,WITHDRAWAL,,,,0,COMPLETED,0,sum-user-id,1574884.695,airdrop-20181115-hdac-sum-user-id-withdrawal,accac570-de75-11e8-bd11-2f9252c4dc2f,AIRDROP,0
airdrop-20181115-hdac-ac896e6b-ec74-421d-b03a-fdb903e7ee02-withdrawal-exchange,2018.11.15 10:12,UNKNOWN,,UNKNOWN-55c0f2b7-dc24-425b-9be8-6b86719f2865,2018.11.15 10:12,UNKNOWN,0,100,0,HDAC,WITHDRAWAL,,,,0,COMPLETED,0,sum-user-id,1574784.695,airdrop-20181115-hdac-sum-user-id-withdrawal,accac570-de75-11e8-bd11-2f9252c4dc2f,AIRDROP,0
airdrop-20181115-hdac-ac988986-0ca1-4a27-a1ae-550fc81fb0d8-withdrawal-exchange,2018.11.15 10:12,UNKNOWN,,UNKNOWN-55c0f2b7-dc24-425b-9be8-6b86719f2865,2018.11.15 10:12,UNKNOWN,0,100,0,HDAC,WITHDRAWAL,,,,0,COMPLETED,0,sum-user-id,1574684.695,airdrop-20181115-hdac-sum-user-id-withdrawal,accac570-de75-11e8-bd11-2f9252c4dc2f,AIRDROP,0
airdrop-20181115-hdac-ac9bd6d6-f6c5-465f-85e8-f74354ba6093-withdrawal-exchange,2018.11.15 10:12,UNKNOWN,,UNKNOWN-55c0f2b7-dc24-425b-9be8-6b86719f2865,2018.11.15 10:12,UNKNOWN,0,100,0,HDAC,WITHDRAWAL,,,,0,COMPLETED,0,sum-user-id,1574584.695,airdrop-20181115-hdac-sum-user-id-withdrawal,accac570-de75-11e8-bd11-2f9252c4dc2f,AIRDROP,0
airdrop-20181115-hdac-aca2035a-0f53-4adf-a3cc-ab536b11e9ca-withdrawal-exchange,2018.11.15 10:12,UNKNOWN,,UNKNOWN-55c0f2b7-dc24-425b-9be8-6b86719f2865,2018.11.15 10:12,UNKNOWN,0,100,0,HDAC,WITHDRAWAL,,,,0,COMPLETED,0,sum-user-id,1574484.695,airdrop-20181115-hdac-sum-user-id-withdrawal,accac570-de75-11e8-bd11-2f9252c4dc2f,AIRDROP,0
airdrop-20181115-hdac-aca6fda0-ce9c-4459-80a2-8a70978d88c4-withdrawal-exchange,2018.11.15 10:12,UNKNOWN,,UNKNOWN-55c0f2b7-dc24-425b-9be8-6b86719f2865,2018.11.15 10:12,UNKNOWN,0,100,0,HDAC,WITHDRAWAL,,,,0,COMPLETED,0,sum-user-id,1574384.695,airdrop-20181115-hdac-sum-user-id-withdrawal,accac570-de75-11e8-bd11-2f9252c4dc2f,AIRDROP,0
airdrop-20181115-hdac-aca7d6e7-c8be-47ad-9965-32c6368f3711-withdrawal-exchange,2018.11.15 10:12,UNKNOWN,,UNKNOWN-55c0f2b7-dc24-425b-9be8-6b86719f2865,2018.11.15 10:12,UNKNOWN,0,100,0,HDAC,WITHDRAWAL,,,,0,COMPLETED,0,sum-user-id,1574284.695,airdrop-20181115-hdac-sum-user-id-withdrawal,accac570-de75-11e8-bd11-2f9252c4dc2f,AIRDROP,0
airdrop-20181115-hdac-acaf0c36-331d-45d3-8882-a8c6fa138e88-withdrawal-exchange,2018.11.15 10:12,UNKNOWN,,UNKNOWN-55c0f2b7-dc24-425b-9be8-6b86719f2865,2018.11.15 10:12,UNKNOWN,0,100,0,HDAC,WITHDRAWAL,,,,0,COMPLETED,0,sum-user-id,1574184.695,airdrop-20181115-hdac-sum-user-id-withdrawal,accac570-de75-11e8-bd11-2f9252c4dc2f,AIRDROP,0
airdrop-20181115-hdac-acbe4c89-e0eb-4ce6-b4c3-43e9d1b1bc9f-withdrawal-exchange,2018.11.15 10:12,UNKNOWN,,UNKNOWN-55c0f2b7-dc24-425b-9be8-6b86719f2865,2018.11.15 10:12,UNKNOWN,0,100,0,HDAC,WITHDRAWAL,,,,0,COMPLETED,0,sum-user-id,1574084.695,airdrop-20181115-hdac-sum-user-id-withdrawal,accac570-de75-11e8-bd11-2f9252c4dc2f,AIRDROP,0
airdrop-20181115-hdac-aceb6807-cd4e-4b09-b0b7-68ba7e385c04-withdrawal-exchange,2018.11.15 10:12,UNKNOWN,,UNKNOWN-55c0f2b7-dc24-425b-9be8-6b86719f2865,2018.11.15 10:12,UNKNOWN,0,100,0,HDAC,WITHDRAWAL,,,,0,COMPLETED,0,sum-user-id,1573984.695,airdrop-20181115-hdac-sum-user-id-withdrawal,accac570-de75-11e8-bd11-2f9252c4dc2f,AIRDROP,0
airdrop-20181115-hdac-ad0261b2-1ea3-49c4-85bf-c50d2885acc1-withdrawal-exchange,2018.11.15 10:12,UNKNOWN,,UNKNOWN-55c0f2b7-dc24-425b-9be8-6b86719f2865,2018.11.15 10:12,UNKNOWN,0,100,0,HDAC,WITHDRAWAL,,,,0,COMPLETED,0,sum-user-id,1573884.695,airdrop-20181115-hdac-sum-user-id-withdrawal,accac570-de75-11e8-bd11-2f9252c4dc2f,AIRDROP,0
airdrop-20181115-hdac-ad7eaa8e-0dde-4087-9421-d921e77c95bd-withdrawal-exchange,2018.11.15 10:12,UNKNOWN,,UNKNOWN-55c0f2b7-dc24-425b-9be8-6b86719f2865,2018.11.15 10:12,UNKNOWN,0,100,0,HDAC,WITHDRAWAL,,,,0,COMPLETED,0,sum-user-id,1573784.695,airdrop-20181115-hdac-sum-user-id-withdrawal,accac570-de75-11e8-bd11-2f9252c4dc2f,AIRDROP,0
airdrop-20181115-hdac-ad836b07-76b1-42d4-b950-a4d397d76335-withdrawal-exchange,2018.11.15 10:12,UNKNOWN,,UNKNOWN-55c0f2b7-dc24-425b-9be8-6b86719f2865,2018.11.15 10:12,UNKNOWN,0,100,0,HDAC,WITHDRAWAL,,,,0,COMPLETED,0,sum-user-id,1573684.695,airdrop-20181115-hdac-sum-user-id-withdrawal,accac570-de75-11e8-bd11-2f9252c4dc2f,AIRDROP,0
airdrop-20181115-hdac-ad8ca3fa-af9f-4d1f-8fd9-a9d1b12058bc-withdrawal-exchange,2018.11.15 10:12,UNKNOWN,,UNKNOWN-55c0f2b7-dc24-425b-9be8-6b86719f2865,2018.11.15 10:12,UNKNOWN,0,100,0,HDAC,WITHDRAWAL,,,,0,COMPLETED,0,sum-user-id,1573584.695,airdrop-20181115-hdac-sum-user-id-withdrawal,accac570-de75-11e8-bd11-2f9252c4dc2f,AIRDROP,0
airdrop-20181115-hdac-ad93b0bc-f73a-4401-ac78-4d4f42e0ffd2-withdrawal-exchange,2018.11.15 10:12,UNKNOWN,,UNKNOWN-55c0f2b7-dc24-425b-9be8-6b86719f2865,2018.11.15 10:12,UNKNOWN,0,100,0,HDAC,WITHDRAWAL,,,,0,COMPLETED,0,sum-user-id,1573484.695,airdrop-20181115-hdac-sum-user-id-withdrawal,accac570-de75-11e8-bd11-2f9252c4dc2f,AIRDROP,0
airdrop-20181115-hdac-ad9c863a-027a-417e-a01c-5ec2c15f23b5-withdrawal-exchange,2018.11.15 10:12,UNKNOWN,,UNKNOWN-55c0f2b7-dc24-425b-9be8-6b86719f2865,2018.11.15 10:12,UNKNOWN,0,100,0,HDAC,WITHDRAWAL,,,,0,COMPLETED,0,sum-user-id,1573384.695,airdrop-20181115-hdac-sum-user-id-withdrawal,accac570-de75-11e8-bd11-2f9252c4dc2f,AIRDROP,0
airdrop-20181115-hdac-ada4e294-f186-4f4b-a29b-20d0d08bbd2b-withdrawal-exchange,2018-11-15 10:12:01.026,UNKNOWN,,UNKNOWN-55c0f2b7-dc24-425b-9be8-6b86719f2865,2018-11-15 10:12:01.026,UNKNOWN,0,100,0,HDAC,WITHDRAWAL,,,,0,COMPLETED,0,sum-user-id,1573284.695,airdrop-20181115-hdac-sum-user-id-withdrawal,accac570-de75-11e8-bd11-2f9252c4dc2f,AIRDROP,0
airdrop-20181115-hdac-adac0433-0ebd-42b7-b2e6-fa4b0aeb0184-withdrawal-exchange,2018-11-15 10:12:01.058,UNKNOWN,,UNKNOWN-55c0f2b7-dc24-425b-9be8-6b86719f2865,2018-11-15 10:12:01.058,UNKNOWN,0,100,0,HDAC,WITHDRAWAL,,,,0,COMPLETED,0,sum-user-id,1573184.695,airdrop-20181115-hdac-sum-user-id-withdrawal,accac570-de75-11e8-bd11-2f9252c4dc2f,AIRDROP,0
airdrop-20181115-hdac-adbf78a4-85b7-4aa0-9931-222ef297157f-withdrawal-exchange,2018-11-15 10:12:01.085,UNKNOWN,,UNKNOWN-55c0f2b7-dc24-425b-9be8-6b86719f2865,2018-11-15 10:12:01.085,UNKNOWN,0,100,0,HDAC,WITHDRAWAL,,,,0,COMPLETED,0,sum-user-id,1573084.695,airdrop-20181115-hdac-sum-user-id-withdrawal,accac570-de75-11e8-bd11-2f9252c4dc2f,AIRDROP,0
airdrop-20181115-hdac-ade6e680-c2d5-4ec5-bb19-b83dd77efab7-withdrawal-exchange,2018.11.15 10:12,UNKNOWN,,UNKNOWN-55c0f2b7-dc24-425b-9be8-6b86719f2865,2018.11.15 10:12,UNKNOWN,0,100,0,HDAC,WITHDRAWAL,,,,0,COMPLETED,0,sum-user-id,1572984.695,airdrop-20181115-hdac-sum-user-id-withdrawal,accac570-de75-11e8-bd11-2f9252c4dc2f,AIRDROP,0
airdrop-20181115-hdac-ae23f970-f8f8-45a0-8746-d615c36f4e96-withdrawal-exchange,2018.11.15 10:12,UNKNOWN,,UNKNOWN-55c0f2b7-dc24-425b-9be8-6b86719f2865,2018.11.15 10:12,UNKNOWN,0,100,0,HDAC,WITHDRAWAL,,,,0,COMPLETED,0,sum-user-id,1572884.695,airdrop-20181115-hdac-sum-user-id-withdrawal,accac570-de75-11e8-bd11-2f9252c4dc2f,AIRDROP,0
airdrop-20181115-hdac-ae3a953c-70a3-40bf-b705-6c2175d4c1d9-withdrawal-exchange,2018.11.15 10:12,UNKNOWN,,UNKNOWN-55c0f2b7-dc24-425b-9be8-6b86719f2865,2018.11.15 10:12,UNKNOWN,0,100,0,HDAC,WITHDRAWAL,,,,0,COMPLETED,0,sum-user-id,1572784.695,airdrop-20181115-hdac-sum-user-id-withdrawal,accac570-de75-11e8-bd11-2f9252c4dc2f,AIRDROP,0
airdrop-20181115-hdac-ae4d415c-7ee6-4798-a264-bfd4714e8643-withdrawal-exchange,2018.11.15 10:12,UNKNOWN,,UNKNOWN-55c0f2b7-dc24-425b-9be8-6b86719f2865,2018.11.15 10:12,UNKNOWN,0,100,0,HDAC,WITHDRAWAL,,,,0,COMPLETED,0,sum-user-id,1572684.695,airdrop-20181115-hdac-sum-user-id-withdrawal,accac570-de75-11e8-bd11-2f9252c4dc2f,AIRDROP,0
airdrop-20181115-hdac-ae528879-8d72-4f41-8755-1be8df3eddf4-withdrawal-exchange,2018.11.15 10:12,UNKNOWN,,UNKNOWN-55c0f2b7-dc24-425b-9be8-6b86719f2865,2018.11.15 10:12,UNKNOWN,0,100,0,HDAC,WITHDRAWAL,,,,0,COMPLETED,0,sum-user-id,1572584.695,airdrop-20181115-hdac-sum-user-id-withdrawal,accac570-de75-11e8-bd11-2f9252c4dc2f,AIRDROP,0
airdrop-20181115-hdac-ae798de3-9656-49c4-86ef-7280d0b53104-withdrawal-exchange,2018.11.15 10:12,UNKNOWN,,UNKNOWN-55c0f2b7-dc24-425b-9be8-6b86719f2865,2018.11.15 10:12,UNKNOWN,0,100,0,HDAC,WITHDRAWAL,,,,0,COMPLETED,0,sum-user-id,1572484.695,airdrop-20181115-hdac-sum-user-id-withdrawal,accac570-de75-11e8-bd11-2f9252c4dc2f,AIRDROP,0
airdrop-20181115-hdac-ae7d1bc3-beaa-4518-adc0-9c1825d365cf-withdrawal-exchange,2018.11.15 10:12,UNKNOWN,,UNKNOWN-55c0f2b7-dc24-425b-9be8-6b86719f2865,2018.11.15 10:12,UNKNOWN,0,100,0,HDAC,WITHDRAWAL,,,,0,COMPLETED,0,sum-user-id,1572384.695,airdrop-20181115-hdac-sum-user-id-withdrawal,accac570-de75-11e8-bd11-2f9252c4dc2f,AIRDROP,0
airdrop-20181115-hdac-aea8b435-b10b-4bf7-bd4c-808849e7f3cb-withdrawal-exchange,2018.11.15 10:12,UNKNOWN,,UNKNOWN-55c0f2b7-dc24-425b-9be8-6b86719f2865,2018.11.15 10:12,UNKNOWN,0,100,0,HDAC,WITHDRAWAL,,,,0,COMPLETED,0,sum-user-id,1572284.695,airdrop-20181115-hdac-sum-user-id-withdrawal,accac570-de75-11e8-bd11-2f9252c4dc2f,AIRDROP,0
airdrop-20181115-hdac-aeb5b7d9-de1c-4f47-a9d3-90ae397cfeac-withdrawal-exchange,2018.11.15 10:12,UNKNOWN,,UNKNOWN-55c0f2b7-dc24-425b-9be8-6b86719f2865,2018.11.15 10:12,UNKNOWN,0,100,0,HDAC,WITHDRAWAL,,,,0,COMPLETED,0,sum-user-id,1572184.695,airdrop-20181115-hdac-sum-user-id-withdrawal,accac570-de75-11e8-bd11-2f9252c4dc2f,AIRDROP,0
airdrop-20181115-hdac-aeb86f03-8c73-4528-ae93-e0468775486b-withdrawal-exchange,2018.11.15 10:12,UNKNOWN,,UNKNOWN-55c0f2b7-dc24-425b-9be8-6b86719f2865,2018.11.15 10:12,UNKNOWN,0,100,0,HDAC,WITHDRAWAL,,,,0,COMPLETED,0,sum-user-id,1572084.695,airdrop-20181115-hdac-sum-user-id-withdrawal,accac570-de75-11e8-bd11-2f9252c4dc2f,AIRDROP,0
airdrop-20181115-hdac-aebb3a88-8eeb-48be-9d4e-6e0e3616d148-withdrawal-exchange,2018.11.15 10:12,UNKNOWN,,UNKNOWN-55c0f2b7-dc24-425b-9be8-6b86719f2865,2018.11.15 10:12,UNKNOWN,0,100,0,HDAC,WITHDRAWAL,,,,0,COMPLETED,0,sum-user-id,1571984.695,airdrop-20181115-hdac-sum-user-id-withdrawal,accac570-de75-11e8-bd11-2f9252c4dc2f,AIRDROP,0
airdrop-20181115-hdac-aec5b871-3457-468c-b6af-8b1667cb0e65-withdrawal-exchange,2018.11.15 10:12,UNKNOWN,,UNKNOWN-55c0f2b7-dc24-425b-9be8-6b86719f2865,2018.11.15 10:12,UNKNOWN,0,100,0,HDAC,WITHDRAWAL,,,,0,COMPLETED,0,sum-user-id,1571884.695,airdrop-20181115-hdac-sum-user-id-withdrawal,accac570-de75-11e8-bd11-2f9252c4dc2f,AIRDROP,0
airdrop-20181115-hdac-aed48634-309f-4f74-aa54-caf0581adc52-withdrawal-exchange,2018.11.15 10:12,UNKNOWN,,UNKNOWN-55c0f2b7-dc24-425b-9be8-6b86719f2865,2018.11.15 10:12,UNKNOWN,0,100,0,HDAC,WITHDRAWAL,,,,0,COMPLETED,0,sum-user-id,1571784.695,airdrop-20181115-hdac-sum-user-id-withdrawal,accac570-de75-11e8-bd11-2f9252c4dc2f,AIRDROP,0
airdrop-20181115-hdac-aee14a3c-eecd-4a4c-a97d-e1015c2dc7fb-withdrawal-exchange,2018.11.15 10:12,UNKNOWN,,UNKNOWN-55c0f2b7-dc24-425b-9be8-6b86719f2865,2018.11.15 10:12,UNKNOWN,0,100,0,HDAC,WITHDRAWAL,,,,0,COMPLETED,0,sum-user-id,1571684.695,airdrop-20181115-hdac-sum-user-id-withdrawal,accac570-de75-11e8-bd11-2f9252c4dc2f,AIRDROP,0
airdrop-20181115-hdac-aefaec1f-9eda-4934-8791-caa7415b5c2b-withdrawal-exchange,2018.11.15 10:12,UNKNOWN,,UNKNOWN-55c0f2b7-dc24-425b-9be8-6b86719f2865,2018.11.15 10:12,UNKNOWN,0,100,0,HDAC,WITHDRAWAL,,,,0,COMPLETED,0,sum-user-id,1571584.695,airdrop-20181115-hdac-sum-user-id-withdrawal,accac570-de75-11e8-bd11-2f9252c4dc2f,AIRDROP,0
airdrop-20181115-hdac-af06f57c-8d93-4ec5-8c8a-12121d441cc2-withdrawal-exchange,2018.11.15 10:12,UNKNOWN,,UNKNOWN-55c0f2b7-dc24-425b-9be8-6b86719f2865,2018.11.15 10:12,UNKNOWN,0,100,0,HDAC,WITHDRAWAL,,,,0,COMPLETED,0,sum-user-id,1571484.695,airdrop-20181115-hdac-sum-user-id-withdrawal,accac570-de75-11e8-bd11-2f9252c4dc2f,AIRDROP,0
airdrop-20181115-hdac-af24abac-e6e8-4a70-a530-ec717cc178b2-withdrawal-exchange,2018.11.15 10:12,UNKNOWN,,UNKNOWN-55c0f2b7-dc24-425b-9be8-6b86719f2865,2018.11.15 10:12,UNKNOWN,0,100,0,HDAC,WITHDRAWAL,,,,0,COMPLETED,0,sum-user-id,1571384.695,airdrop-20181115-hdac-sum-user-id-withdrawal,accac570-de75-11e8-bd11-2f9252c4dc2f,AIRDROP,0
airdrop-20181115-hdac-af372365-e177-4755-abb1-4992e65785da-withdrawal-exchange,2018.11.15 10:12,UNKNOWN,,UNKNOWN-55c0f2b7-dc24-425b-9be8-6b86719f2865,2018.11.15 10:12,UNKNOWN,0,100,0,HDAC,WITHDRAWAL,,,,0,COMPLETED,0,sum-user-id,1571284.695,airdrop-20181115-hdac-sum-user-id-withdrawal,accac570-de75-11e8-bd11-2f9252c4dc2f,AIRDROP,0
airdrop-20181115-hdac-af375cb8-3725-4fd8-8d13-648eb31e25f2-withdrawal-exchange,2018.11.15 10:12,UNKNOWN,,UNKNOWN-55c0f2b7-dc24-425b-9be8-6b86719f2865,2018.11.15 10:12,UNKNOWN,0,211.155914,0,HDAC,WITHDRAWAL,,,,0,COMPLETED,0,sum-user-id,1571073.539,airdrop-20181115-hdac-sum-user-id-withdrawal,accac570-de75-11e8-bd11-2f9252c4dc2f,AIRDROP,0
airdrop-20181115-hdac-af7c56c4-2589-4f16-b157-1502c516535e-withdrawal-exchange,2018.11.15 10:12,UNKNOWN,,UNKNOWN-55c0f2b7-dc24-425b-9be8-6b86719f2865,2018.11.15 10:12,UNKNOWN,0,100,0,HDAC,WITHDRAWAL,,,,0,COMPLETED,0,sum-user-id,1570973.539,airdrop-20181115-hdac-sum-user-id-withdrawal,accac570-de75-11e8-bd11-2f9252c4dc2f,AIRDROP,0
airdrop-20181115-hdac-af8a12c0-f9cd-4219-b15a-9c76c792f0b8-withdrawal-exchange,2018.11.15 10:12,UNKNOWN,,UNKNOWN-55c0f2b7-dc24-425b-9be8-6b86719f2865,2018.11.15 10:12,UNKNOWN,0,100,0,HDAC,WITHDRAWAL,,,,0,COMPLETED,0,sum-user-id,1570873.539,airdrop-20181115-hdac-sum-user-id-withdrawal,accac570-de75-11e8-bd11-2f9252c4dc2f,AIRDROP,0
airdrop-20181115-hdac-af9cbd3a-0723-491e-a87e-5d987cb2f266-withdrawal-exchange,2018.11.15 10:12,UNKNOWN,,UNKNOWN-55c0f2b7-dc24-425b-9be8-6b86719f2865,2018.11.15 10:12,UNKNOWN,0,100,0,HDAC,WITHDRAWAL,,,,0,COMPLETED,0,sum-user-id,1570773.539,airdrop-20181115-hdac-sum-user-id-withdrawal,accac570-de75-11e8-bd11-2f9252c4dc2f,AIRDROP,0
airdrop-20181115-hdac-afa94d89-94f5-472f-9f53-44b5aa5c03b8-withdrawal-exchange,2018.11.15 10:12,UNKNOWN,,UNKNOWN-55c0f2b7-dc24-425b-9be8-6b86719f2865,2018.11.15 10:12,UNKNOWN,0,100,0,HDAC,WITHDRAWAL,,,,0,COMPLETED,0,sum-user-id,1570673.539,airdrop-20181115-hdac-sum-user-id-withdrawal,accac570-de75-11e8-bd11-2f9252c4dc2f,AIRDROP,0
airdrop-20181115-hdac-afbf7569-be38-4a0e-896f-f3e26421b889-withdrawal-exchange,2018.11.15 10:12,UNKNOWN,,UNKNOWN-55c0f2b7-dc24-425b-9be8-6b86719f2865,2018.11.15 10:12,UNKNOWN,0,100,0,HDAC,WITHDRAWAL,,,,0,COMPLETED,0,sum-user-id,1570573.539,airdrop-20181115-hdac-sum-user-id-withdrawal,accac570-de75-11e8-bd11-2f9252c4dc2f,AIRDROP,0
airdrop-20181115-hdac-afcbb4bb-098b-416d-9a71-7660f5b72145-withdrawal-exchange,2018.11.15 10:12,UNKNOWN,,UNKNOWN-55c0f2b7-dc24-425b-9be8-6b86719f2865,2018.11.15 10:12,UNKNOWN,0,100,0,HDAC,WITHDRAWAL,,,,0,COMPLETED,0,sum-user-id,1570473.539,airdrop-20181115-hdac-sum-user-id-withdrawal,accac570-de75-11e8-bd11-2f9252c4dc2f,AIRDROP,0
airdrop-20181115-hdac-afe3ac90-6411-46af-be3b-dfc3ffb88e25-withdrawal-exchange,2018.11.15 10:12,UNKNOWN,,UNKNOWN-55c0f2b7-dc24-425b-9be8-6b86719f2865,2018.11.15 10:12,UNKNOWN,0,100,0,HDAC,WITHDRAWAL,,,,0,COMPLETED,0,sum-user-id,1570373.539,airdrop-20181115-hdac-sum-user-id-withdrawal,accac570-de75-11e8-bd11-2f9252c4dc2f,AIRDROP,0
airdrop-20181115-hdac-aff7f350-6b63-4ffe-a17a-d02af7538d75-withdrawal-exchange,2018.11.15 10:12,UNKNOWN,,UNKNOWN-55c0f2b7-dc24-425b-9be8-6b86719f2865,2018.11.15 10:12,UNKNOWN,0,100,0,HDAC,WITHDRAWAL,,,,0,COMPLETED,0,sum-user-id,1570273.539,airdrop-20181115-hdac-sum-user-id-withdrawal,accac570-de75-11e8-bd11-2f9252c4dc2f,AIRDROP,0
airdrop-20181115-hdac-b002d944-f8b3-4753-889c-30cf467efa6c-withdrawal-exchange,2018.11.15 10:12,UNKNOWN,,UNKNOWN-55c0f2b7-dc24-425b-9be8-6b86719f2865,2018.11.15 10:12,UNKNOWN,0,100,0,HDAC,WITHDRAWAL,,,,0,COMPLETED,0,sum-user-id,1570173.539,airdrop-20181115-hdac-sum-user-id-withdrawal,accac570-de75-11e8-bd11-2f9252c4dc2f,AIRDROP,0
airdrop-20181115-hdac-b003b9f4-0861-440e-9bf2-bfa9db342c2e-withdrawal-exchange,2018-11-15 10:12:02.002,UNKNOWN,,UNKNOWN-55c0f2b7-dc24-425b-9be8-6b86719f2865,2018-11-15 10:12:02.002,UNKNOWN,0,100,0,HDAC,WITHDRAWAL,,,,0,COMPLETED,0,sum-user-id,1570073.539,airdrop-20181115-hdac-sum-user-id-withdrawal,accac570-de75-11e8-bd11-2f9252c4dc2f,AIRDROP,0
airdrop-20181115-hdac-b036e883-c3a4-4e4b-bcb8-229c366cda90-withdrawal-exchange,2018-11-15 10:12:02.036,UNKNOWN,,UNKNOWN-55c0f2b7-dc24-425b-9be8-6b86719f2865,2018-11-15 10:12:02.036,UNKNOWN,0,100,0,HDAC,WITHDRAWAL,,,,0,COMPLETED,0,sum-user-id,1569973.539,airdrop-20181115-hdac-sum-user-id-withdrawal,accac570-de75-11e8-bd11-2f9252c4dc2f,AIRDROP,0
airdrop-20181115-hdac-b04193f9-e90e-4dd4-95f6-e742f14e421d-withdrawal-exchange,2018-11-15 10:12:02.064,UNKNOWN,,UNKNOWN-55c0f2b7-dc24-425b-9be8-6b86719f2865,2018-11-15 10:12:02.064,UNKNOWN,0,100,0,HDAC,WITHDRAWAL,,,,0,COMPLETED,0,sum-user-id,1569873.539,airdrop-20181115-hdac-sum-user-id-withdrawal,accac570-de75-11e8-bd11-2f9252c4dc2f,AIRDROP,0
airdrop-20181115-hdac-b044c68c-ff7a-4817-96e8-58d59506cb1f-withdrawal-exchange,2018-11-15 10:12:02.096,UNKNOWN,,UNKNOWN-55c0f2b7-dc24-425b-9be8-6b86719f2865,2018-11-15 10:12:02.096,UNKNOWN,0,100,0,HDAC,WITHDRAWAL,,,,0,COMPLETED,0,sum-user-id,1569773.539,airdrop-20181115-hdac-sum-user-id-withdrawal,accac570-de75-11e8-bd11-2f9252c4dc2f,AIRDROP,0
airdrop-20181115-hdac-b0644b65-5571-4724-b31d-251d38d4ec22-withdrawal-exchange,2018.11.15 10:12,UNKNOWN,,UNKNOWN-55c0f2b7-dc24-425b-9be8-6b86719f2865,2018.11.15 10:12,UNKNOWN,0,100,0,HDAC,WITHDRAWAL,,,,0,COMPLETED,0,sum-user-id,1569673.539,airdrop-20181115-hdac-sum-user-id-withdrawal,accac570-de75-11e8-bd11-2f9252c4dc2f,AIRDROP,0
airdrop-20181115-hdac-b06fb4d3-8ddf-48e3-abf2-a701983e59e5-withdrawal-exchange,2018.11.15 10:12,UNKNOWN,,UNKNOWN-55c0f2b7-dc24-425b-9be8-6b86719f2865,2018.11.15 10:12,UNKNOWN,0,100,0,HDAC,WITHDRAWAL,,,,0,COMPLETED,0,sum-user-id,1569573.539,airdrop-20181115-hdac-sum-user-id-withdrawal,accac570-de75-11e8-bd11-2f9252c4dc2f,AIRDROP,0
airdrop-20181115-hdac-b07e4eb7-b2b2-4bcc-a5e1-126bd45d2cc3-withdrawal-exchange,2018.11.15 10:12,UNKNOWN,,UNKNOWN-55c0f2b7-dc24-425b-9be8-6b86719f2865,2018.11.15 10:12,UNKNOWN,0,100,0,HDAC,WITHDRAWAL,,,,0,COMPLETED,0,sum-user-id,1569473.539,airdrop-20181115-hdac-sum-user-id-withdrawal,accac570-de75-11e8-bd11-2f9252c4dc2f,AIRDROP,0
airdrop-20181115-hdac-b07e8876-6eb4-4d10-ac04-a3961087b2e1-withdrawal-exchange,2018.11.15 10:12,UNKNOWN,,UNKNOWN-55c0f2b7-dc24-425b-9be8-6b86719f2865,2018.11.15 10:12,UNKNOWN,0,100,0,HDAC,WITHDRAWAL,,,,0,COMPLETED,0,sum-user-id,1569373.539,airdrop-20181115-hdac-sum-user-id-withdrawal,accac570-de75-11e8-bd11-2f9252c4dc2f,AIRDROP,0
airdrop-20181115-hdac-b0986044-fbb3-492a-a31e-f2bbd2e85c1a-withdrawal-exchange,2018.11.15 10:12,UNKNOWN,,UNKNOWN-55c0f2b7-dc24-425b-9be8-6b86719f2865,2018.11.15 10:12,UNKNOWN,0,100,0,HDAC,WITHDRAWAL,,,,0,COMPLETED,0,sum-user-id,1569273.539,airdrop-20181115-hdac-sum-user-id-withdrawal,accac570-de75-11e8-bd11-2f9252c4dc2f,AIRDROP,0
airdrop-20181115-hdac-b0af1e9f-07de-42d1-85af-eab361eba817-withdrawal-exchange,2018.11.15 10:12,UNKNOWN,,UNKNOWN-55c0f2b7-dc24-425b-9be8-6b86719f2865,2018.11.15 10:12,UNKNOWN,0,100,0,HDAC,WITHDRAWAL,,,,0,COMPLETED,0,sum-user-id,1569173.539,airdrop-20181115-hdac-sum-user-id-withdrawal,accac570-de75-11e8-bd11-2f9252c4dc2f,AIRDROP,0
airdrop-20181115-hdac-b0beccb9-d72f-42b6-a5a0-03482be8178b-withdrawal-exchange,2018.11.15 10:12,UNKNOWN,,UNKNOWN-55c0f2b7-dc24-425b-9be8-6b86719f2865,2018.11.15 10:12,UNKNOWN,0,100,0,HDAC,WITHDRAWAL,,,,0,COMPLETED,0,sum-user-id,1569073.539,airdrop-20181115-hdac-sum-user-id-withdrawal,accac570-de75-11e8-bd11-2f9252c4dc2f,AIRDROP,0
airdrop-20181115-hdac-b0c09a6b-4059-43d0-831e-d7e3a4b2742b-withdrawal-exchange,2018.11.15 10:12,UNKNOWN,,UNKNOWN-55c0f2b7-dc24-425b-9be8-6b86719f2865,2018.11.15 10:12,UNKNOWN,0,100,0,HDAC,WITHDRAWAL,,,,0,COMPLETED,0,sum-user-id,1568973.539,airdrop-20181115-hdac-sum-user-id-withdrawal,accac570-de75-11e8-bd11-2f9252c4dc2f,AIRDROP,0
airdrop-20181115-hdac-b0c9c521-2a04-4389-85a2-e51a6d2e02b1-withdrawal-exchange,2018.11.15 10:12,UNKNOWN,,UNKNOWN-55c0f2b7-dc24-425b-9be8-6b86719f2865,2018.11.15 10:12,UNKNOWN,0,100,0,HDAC,WITHDRAWAL,,,,0,COMPLETED,0,sum-user-id,1568873.539,airdrop-20181115-hdac-sum-user-id-withdrawal,accac570-de75-11e8-bd11-2f9252c4dc2f,AIRDROP,0
airdrop-20181115-hdac-b0cf9e7a-5915-4bb9-813c-2ebd41a92659-withdrawal-exchange,2018.11.15 10:12,UNKNOWN,,UNKNOWN-55c0f2b7-dc24-425b-9be8-6b86719f2865,2018.11.15 10:12,UNKNOWN,0,100,0,HDAC,WITHDRAWAL,,,,0,COMPLETED,0,sum-user-id,1568773.539,airdrop-20181115-hdac-sum-user-id-withdrawal,accac570-de75-11e8-bd11-2f9252c4dc2f,AIRDROP,0
airdrop-20181115-hdac-b0d0482b-857c-4a73-9cf5-ea9cb4def7a4-withdrawal-exchange,2018.11.15 10:12,UNKNOWN,,UNKNOWN-55c0f2b7-dc24-425b-9be8-6b86719f2865,2018.11.15 10:12,UNKNOWN,0,100,0,HDAC,WITHDRAWAL,,,,0,COMPLETED,0,sum-user-id,1568673.539,airdrop-20181115-hdac-sum-user-id-withdrawal,accac570-de75-11e8-bd11-2f9252c4dc2f,AIRDROP,0
airdrop-20181115-hdac-b0dd7cbf-25a6-42bf-a88f-42726d3413ae-withdrawal-exchange,2018.11.15 10:12,UNKNOWN,,UNKNOWN-55c0f2b7-dc24-425b-9be8-6b86719f2865,2018.11.15 10:12,UNKNOWN,0,100,0,HDAC,WITHDRAWAL,,,,0,COMPLETED,0,sum-user-id,1568573.539,airdrop-20181115-hdac-sum-user-id-withdrawal,accac570-de75-11e8-bd11-2f9252c4dc2f,AIRDROP,0
airdrop-20181115-hdac-b0dda4af-9a6a-4455-a147-053624ed8b26-withdrawal-exchange,2018.11.15 10:12,UNKNOWN,,UNKNOWN-55c0f2b7-dc24-425b-9be8-6b86719f2865,2018.11.15 10:12,UNKNOWN,0,100,0,HDAC,WITHDRAWAL,,,,0,COMPLETED,0,sum-user-id,1568473.539,airdrop-20181115-hdac-sum-user-id-withdrawal,accac570-de75-11e8-bd11-2f9252c4dc2f,AIRDROP,0
airdrop-20181115-hdac-b112fd84-1b6a-4d2e-80f3-fc8cd3bf7455-withdrawal-exchange,2018.11.15 10:12,UNKNOWN,,UNKNOWN-55c0f2b7-dc24-425b-9be8-6b86719f2865,2018.11.15 10:12,UNKNOWN,0,100,0,HDAC,WITHDRAWAL,,,,0,COMPLETED,0,sum-user-id,1568373.539,airdrop-20181115-hdac-sum-user-id-withdrawal,accac570-de75-11e8-bd11-2f9252c4dc2f,AIRDROP,0
airdrop-20181115-hdac-b115487c-c1b0-41e8-9291-bbca72e9898b-withdrawal-exchange,2018.11.15 10:12,UNKNOWN,,UNKNOWN-55c0f2b7-dc24-425b-9be8-6b86719f2865,2018.11.15 10:12,UNKNOWN,0,100,0,HDAC,WITHDRAWAL,,,,0,COMPLETED,0,sum-user-id,1568273.539,airdrop-20181115-hdac-sum-user-id-withdrawal,accac570-de75-11e8-bd11-2f9252c4dc2f,AIRDROP,0
airdrop-20181115-hdac-b120563f-b418-4c1e-bb47-bdc2d4741eee-withdrawal-exchange,2018.11.15 10:12,UNKNOWN,,UNKNOWN-55c0f2b7-dc24-425b-9be8-6b86719f2865,2018.11.15 10:12,UNKNOWN,0,100,0,HDAC,WITHDRAWAL,,,,0,COMPLETED,0,sum-user-id,1568173.539,airdrop-20181115-hdac-sum-user-id-withdrawal,accac570-de75-11e8-bd11-2f9252c4dc2f,AIRDROP,0
airdrop-20181115-hdac-b15999ed-7f36-4adc-b14e-a5e181610f7e-withdrawal-exchange,2018.11.15 10:12,UNKNOWN,,UNKNOWN-55c0f2b7-dc24-425b-9be8-6b86719f2865,2018.11.15 10:12,UNKNOWN,0,100,0,HDAC,WITHDRAWAL,,,,0,COMPLETED,0,sum-user-id,1568073.539,airdrop-20181115-hdac-sum-user-id-withdrawal,accac570-de75-11e8-bd11-2f9252c4dc2f,AIRDROP,0
airdrop-20181115-hdac-b15ce367-d697-4e74-b060-d02f8f633fc4-withdrawal-exchange,2018.11.15 10:12,UNKNOWN,,UNKNOWN-55c0f2b7-dc24-425b-9be8-6b86719f2865,2018.11.15 10:12,UNKNOWN,0,100,0,HDAC,WITHDRAWAL,,,,0,COMPLETED,0,sum-user-id,1567973.539,airdrop-20181115-hdac-sum-user-id-withdrawal,accac570-de75-11e8-bd11-2f9252c4dc2f,AIRDROP,0
airdrop-20181115-hdac-b1798f73-7b43-4286-b604-56eba4f7edee-withdrawal-exchange,2018.11.15 10:12,UNKNOWN,,UNKNOWN-55c0f2b7-dc24-425b-9be8-6b86719f2865,2018.11.15 10:12,UNKNOWN,0,100,0,HDAC,WITHDRAWAL,,,,0,COMPLETED,0,sum-user-id,1567873.539,airdrop-20181115-hdac-sum-user-id-withdrawal,accac570-de75-11e8-bd11-2f9252c4dc2f,AIRDROP,0
airdrop-20181115-hdac-b19b30bd-25ac-465b-8d7d-5f12b6a79ded-withdrawal-exchange,2018.11.15 10:12,UNKNOWN,,UNKNOWN-55c0f2b7-dc24-425b-9be8-6b86719f2865,2018.11.15 10:12,UNKNOWN,0,100,0,HDAC,WITHDRAWAL,,,,0,COMPLETED,0,sum-user-id,1567773.539,airdrop-20181115-hdac-sum-user-id-withdrawal,accac570-de75-11e8-bd11-2f9252c4dc2f,AIRDROP,0
airdrop-20181115-hdac-b1a0ef1b-c078-4077-bc02-64feecb531c2-withdrawal-exchange,2018.11.15 10:12,UNKNOWN,,UNKNOWN-55c0f2b7-dc24-425b-9be8-6b86719f2865,2018.11.15 10:12,UNKNOWN,0,100,0,HDAC,WITHDRAWAL,,,,0,COMPLETED,0,sum-user-id,1567673.539,airdrop-20181115-hdac-sum-user-id-withdrawal,accac570-de75-11e8-bd11-2f9252c4dc2f,AIRDROP,0
airdrop-20181115-hdac-b1c462c4-9f56-42cf-aeb2-86537ae58ab6-withdrawal-exchange,2018.11.15 10:12,UNKNOWN,,UNKNOWN-55c0f2b7-dc24-425b-9be8-6b86719f2865,2018.11.15 10:12,UNKNOWN,0,100,0,HDAC,WITHDRAWAL,,,,0,COMPLETED,0,sum-user-id,1567573.539,airdrop-20181115-hdac-sum-user-id-withdrawal,accac570-de75-11e8-bd11-2f9252c4dc2f,AIRDROP,0
airdrop-20181115-hdac-b1e2169a-65be-4be6-8178-bcdb27ec61e6-withdrawal-exchange,2018.11.15 10:12,UNKNOWN,,UNKNOWN-55c0f2b7-dc24-425b-9be8-6b86719f2865,2018.11.15 10:12,UNKNOWN,0,100,0,HDAC,WITHDRAWAL,,,,0,COMPLETED,0,sum-user-id,1567473.539,airdrop-20181115-hdac-sum-user-id-withdrawal,accac570-de75-11e8-bd11-2f9252c4dc2f,AIRDROP,0
airdrop-20181115-hdac-b1e649a5-14e6-4b58-a3fc-10f9d81a7b13-withdrawal-exchange,2018.11.15 10:12,UNKNOWN,,UNKNOWN-55c0f2b7-dc24-425b-9be8-6b86719f2865,2018.11.15 10:12,UNKNOWN,0,100,0,HDAC,WITHDRAWAL,,,,0,COMPLETED,0,sum-user-id,1567373.539,airdrop-20181115-hdac-sum-user-id-withdrawal,accac570-de75-11e8-bd11-2f9252c4dc2f,AIRDROP,0
airdrop-20181115-hdac-b20077de-4eba-4a8d-b6b3-6f431bffb26d-withdrawal-exchange,2018.11.15 10:12,UNKNOWN,,UNKNOWN-55c0f2b7-dc24-425b-9be8-6b86719f2865,2018.11.15 10:12,UNKNOWN,0,100,0,HDAC,WITHDRAWAL,,,,0,COMPLETED,0,sum-user-id,1567273.539,airdrop-20181115-hdac-sum-user-id-withdrawal,accac570-de75-11e8-bd11-2f9252c4dc2f,AIRDROP,0
airdrop-20181115-hdac-b2495128-7e71-476a-961b-b611a32bdeea-withdrawal-exchange,2018.11.15 10:12,UNKNOWN,,UNKNOWN-55c0f2b7-dc24-425b-9be8-6b86719f2865,2018.11.15 10:12,UNKNOWN,0,100,0,HDAC,WITHDRAWAL,,,,0,COMPLETED,0,sum-user-id,1567173.539,airdrop-20181115-hdac-sum-user-id-withdrawal,accac570-de75-11e8-bd11-2f9252c4dc2f,AIRDROP,0
airdrop-20181115-hdac-b26768fb-5c96-467f-b9b0-08de6e2287eb-withdrawal-exchange,2018.11.15 10:12,UNKNOWN,,UNKNOWN-55c0f2b7-dc24-425b-9be8-6b86719f2865,2018.11.15 10:12,UNKNOWN,0,100,0,HDAC,WITHDRAWAL,,,,0,COMPLETED,0,sum-user-id,1567073.539,airdrop-20181115-hdac-sum-user-id-withdrawal,accac570-de75-11e8-bd11-2f9252c4dc2f,AIRDROP,0
airdrop-20181115-hdac-b2bf1c1d-f043-4991-b2c9-82fa936e8e85-withdrawal-exchange,2018-11-15 10:12:03.012,UNKNOWN,,UNKNOWN-55c0f2b7-dc24-425b-9be8-6b86719f2865,2018-11-15 10:12:03.012,UNKNOWN,0,100,0,HDAC,WITHDRAWAL,,,,0,COMPLETED,0,sum-user-id,1566973.539,airdrop-20181115-hdac-sum-user-id-withdrawal,accac570-de75-11e8-bd11-2f9252c4dc2f,AIRDROP,0
airdrop-20181115-hdac-b2cf74e8-d457-4521-9431-9861054417c3-withdrawal-exchange,2018-11-15 10:12:03.043,UNKNOWN,,UNKNOWN-55c0f2b7-dc24-425b-9be8-6b86719f2865,2018-11-15 10:12:03.043,UNKNOWN,0,100,0,HDAC,WITHDRAWAL,,,,0,COMPLETED,0,sum-user-id,1566873.539,airdrop-20181115-hdac-sum-user-id-withdrawal,accac570-de75-11e8-bd11-2f9252c4dc2f,AIRDROP,0
airdrop-20181115-hdac-b2f81bfd-025b-4182-97d2-b3c0bdaa128c-withdrawal-exchange,2018-11-15 10:12:03.076,UNKNOWN,,UNKNOWN-55c0f2b7-dc24-425b-9be8-6b86719f2865,2018-11-15 10:12:03.076,UNKNOWN,0,100,0,HDAC,WITHDRAWAL,,,,0,COMPLETED,0,sum-user-id,1566773.539,airdrop-20181115-hdac-sum-user-id-withdrawal,accac570-de75-11e8-bd11-2f9252c4dc2f,AIRDROP,0
airdrop-20181115-hdac-b30128cc-dca2-4b52-a24f-4dd39c6eacd9-withdrawal-exchange,2018.11.15 10:12,UNKNOWN,,UNKNOWN-55c0f2b7-dc24-425b-9be8-6b86719f2865,2018.11.15 10:12,UNKNOWN,0,11762.83917,0,HDAC,WITHDRAWAL,,,,0,COMPLETED,0,sum-user-id,1555010.7,airdrop-20181115-hdac-sum-user-id-withdrawal,accac570-de75-11e8-bd11-2f9252c4dc2f,AIRDROP,0
airdrop-20181115-hdac-b309707a-4afe-4401-a588-5e1cbfc76612-withdrawal-exchange,2018.11.15 10:12,UNKNOWN,,UNKNOWN-55c0f2b7-dc24-425b-9be8-6b86719f2865,2018.11.15 10:12,UNKNOWN,0,100,0,HDAC,WITHDRAWAL,,,,0,COMPLETED,0,sum-user-id,1554910.7,airdrop-20181115-hdac-sum-user-id-withdrawal,accac570-de75-11e8-bd11-2f9252c4dc2f,AIRDROP,0
airdrop-20181115-hdac-b334e489-887f-4301-8da6-c9339f79e611-withdrawal-exchange,2018.11.15 10:12,UNKNOWN,,UNKNOWN-55c0f2b7-dc24-425b-9be8-6b86719f2865,2018.11.15 10:12,UNKNOWN,0,100,0,HDAC,WITHDRAWAL,,,,0,COMPLETED,0,sum-user-id,1554810.7,airdrop-20181115-hdac-sum-user-id-withdrawal,accac570-de75-11e8-bd11-2f9252c4dc2f,AIRDROP,0
airdrop-20181115-hdac-b336289f-361b-45e6-8120-0a95e91d4830-withdrawal-exchange,2018.11.15 10:12,UNKNOWN,,UNKNOWN-55c0f2b7-dc24-425b-9be8-6b86719f2865,2018.11.15 10:12,UNKNOWN,0,100,0,HDAC,WITHDRAWAL,,,,0,COMPLETED,0,sum-user-id,1554710.7,airdrop-20181115-hdac-sum-user-id-withdrawal,accac570-de75-11e8-bd11-2f9252c4dc2f,AIRDROP,0
airdrop-20181115-hdac-b3551c49-a140-49f4-b811-66691eb3835d-withdrawal-exchange,2018.11.15 10:12,UNKNOWN,,UNKNOWN-55c0f2b7-dc24-425b-9be8-6b86719f2865,2018.11.15 10:12,UNKNOWN,0,100,0,HDAC,WITHDRAWAL,,,,0,COMPLETED,0,sum-user-id,1554610.7,airdrop-20181115-hdac-sum-user-id-withdrawal,accac570-de75-11e8-bd11-2f9252c4dc2f,AIRDROP,0
airdrop-20181115-hdac-b37e39a7-e9c0-438e-9393-51bd2ae0d39f-withdrawal-exchange,2018.11.15 10:12,UNKNOWN,,UNKNOWN-55c0f2b7-dc24-425b-9be8-6b86719f2865,2018.11.15 10:12,UNKNOWN,0,100,0,HDAC,WITHDRAWAL,,,,0,COMPLETED,0,sum-user-id,1554510.7,airdrop-20181115-hdac-sum-user-id-withdrawal,accac570-de75-11e8-bd11-2f9252c4dc2f,AIRDROP,0
airdrop-20181115-hdac-b3a21bf1-a1c9-4fb9-8486-d5aafc894097-withdrawal-exchange,2018.11.15 10:12,UNKNOWN,,UNKNOWN-55c0f2b7-dc24-425b-9be8-6b86719f2865,2018.11.15 10:12,UNKNOWN,0,100,0,HDAC,WITHDRAWAL,,,,0,COMPLETED,0,sum-user-id,1554410.7,airdrop-20181115-hdac-sum-user-id-withdrawal,accac570-de75-11e8-bd11-2f9252c4dc2f,AIRDROP,0
airdrop-20181115-hdac-b3b36df6-25f6-404b-9189-e17aab0345ba-withdrawal-exchange,2018.11.15 10:12,UNKNOWN,,UNKNOWN-55c0f2b7-dc24-425b-9be8-6b86719f2865,2018.11.15 10:12,UNKNOWN,0,100,0,HDAC,WITHDRAWAL,,,,0,COMPLETED,0,sum-user-id,1554310.7,airdrop-20181115-hdac-sum-user-id-withdrawal,accac570-de75-11e8-bd11-2f9252c4dc2f,AIRDROP,0
airdrop-20181115-hdac-b403d135-c902-4b7b-b93e-b3767c8f7cee-withdrawal-exchange,2018.11.15 10:12,UNKNOWN,,UNKNOWN-55c0f2b7-dc24-425b-9be8-6b86719f2865,2018.11.15 10:12,UNKNOWN,0,100,0,HDAC,WITHDRAWAL,,,,0,COMPLETED,0,sum-user-id,1554210.7,airdrop-20181115-hdac-sum-user-id-withdrawal,accac570-de75-11e8-bd11-2f9252c4dc2f,AIRDROP,0
airdrop-20181115-hdac-b40d40c8-af37-48b9-99ad-647ed57d0b93-withdrawal-exchange,2018.11.15 10:12,UNKNOWN,,UNKNOWN-55c0f2b7-dc24-425b-9be8-6b86719f2865,2018.11.15 10:12,UNKNOWN,0,100,0,HDAC,WITHDRAWAL,,,,0,COMPLETED,0,sum-user-id,1554110.7,airdrop-20181115-hdac-sum-user-id-withdrawal,accac570-de75-11e8-bd11-2f9252c4dc2f,AIRDROP,0
airdrop-20181115-hdac-b41887fa-ea2d-4031-ab18-467a70a9b448-withdrawal-exchange,2018.11.15 10:12,UNKNOWN,,UNKNOWN-55c0f2b7-dc24-425b-9be8-6b86719f2865,2018.11.15 10:12,UNKNOWN,0,100,0,HDAC,WITHDRAWAL,,,,0,COMPLETED,0,sum-user-id,1554010.7,airdrop-20181115-hdac-sum-user-id-withdrawal,accac570-de75-11e8-bd11-2f9252c4dc2f,AIRDROP,0
airdrop-20181115-hdac-b450cb0b-3e71-4283-b948-5f30a9d21c24-withdrawal-exchange,2018.11.15 10:12,UNKNOWN,,UNKNOWN-55c0f2b7-dc24-425b-9be8-6b86719f2865,2018.11.15 10:12,UNKNOWN,0,100,0,HDAC,WITHDRAWAL,,,,0,COMPLETED,0,sum-user-id,1553910.7,airdrop-20181115-hdac-sum-user-id-withdrawal,accac570-de75-11e8-bd11-2f9252c4dc2f,AIRDROP,0
airdrop-20181115-hdac-b466e247-7293-4b7b-9dd9-059baf5328fc-withdrawal-exchange,2018.11.15 10:12,UNKNOWN,,UNKNOWN-55c0f2b7-dc24-425b-9be8-6b86719f2865,2018.11.15 10:12,UNKNOWN,0,100,0,HDAC,WITHDRAWAL,,,,0,COMPLETED,0,sum-user-id,1553810.7,airdrop-20181115-hdac-sum-user-id-withdrawal,accac570-de75-11e8-bd11-2f9252c4dc2f,AIRDROP,0
airdrop-20181115-hdac-b4856d9f-2e0d-40cf-bf80-1f6300e00bb6-withdrawal-exchange,2018.11.15 10:12,UNKNOWN,,UNKNOWN-55c0f2b7-dc24-425b-9be8-6b86719f2865,2018.11.15 10:12,UNKNOWN,0,100,0,HDAC,WITHDRAWAL,,,,0,COMPLETED,0,sum-user-id,1553710.7,airdrop-20181115-hdac-sum-user-id-withdrawal,accac570-de75-11e8-bd11-2f9252c4dc2f,AIRDROP,0
airdrop-20181115-hdac-b496424e-0370-4e35-8940-c12f29b854ee-withdrawal-exchange,2018.11.15 10:12,UNKNOWN,,UNKNOWN-55c0f2b7-dc24-425b-9be8-6b86719f2865,2018.11.15 10:12,UNKNOWN,0,100,0,HDAC,WITHDRAWAL,,,,0,COMPLETED,0,sum-user-id,1553610.7,airdrop-20181115-hdac-sum-user-id-withdrawal,accac570-de75-11e8-bd11-2f9252c4dc2f,AIRDROP,0
airdrop-20181115-hdac-b4adc7a5-c135-4f0a-9f5d-af88f5438839-withdrawal-exchange,2018.11.15 10:12,UNKNOWN,,UNKNOWN-55c0f2b7-dc24-425b-9be8-6b86719f2865,2018.11.15 10:12,UNKNOWN,0,100,0,HDAC,WITHDRAWAL,,,,0,COMPLETED,0,sum-user-id,1553510.7,airdrop-20181115-hdac-sum-user-id-withdrawal,accac570-de75-11e8-bd11-2f9252c4dc2f,AIRDROP,0
airdrop-20181115-hdac-b4b1509e-f9e7-467c-83be-07075802a8da-withdrawal-exchange,2018.11.15 10:12,UNKNOWN,,UNKNOWN-55c0f2b7-dc24-425b-9be8-6b86719f2865,2018.11.15 10:12,UNKNOWN,0,100,0,HDAC,WITHDRAWAL,,,,0,COMPLETED,0,sum-user-id,1553410.7,airdrop-20181115-hdac-sum-user-id-withdrawal,accac570-de75-11e8-bd11-2f9252c4dc2f,AIRDROP,0
airdrop-20181115-hdac-b4e4efe3-89a7-49a4-8538-1ab908401fc3-withdrawal-exchange,2018.11.15 10:12,UNKNOWN,,UNKNOWN-55c0f2b7-dc24-425b-9be8-6b86719f2865,2018.11.15 10:12,UNKNOWN,0,100,0,HDAC,WITHDRAWAL,,,,0,COMPLETED,0,sum-user-id,1553310.7,airdrop-20181115-hdac-sum-user-id-withdrawal,accac570-de75-11e8-bd11-2f9252c4dc2f,AIRDROP,0
airdrop-20181115-hdac-b4edb8de-1df6-40d0-8782-312ebd2f2ecd-withdrawal-exchange,2018.11.15 10:12,UNKNOWN,,UNKNOWN-55c0f2b7-dc24-425b-9be8-6b86719f2865,2018.11.15 10:12,UNKNOWN,0,100,0,HDAC,WITHDRAWAL,,,,0,COMPLETED,0,sum-user-id,1553210.7,airdrop-20181115-hdac-sum-user-id-withdrawal,accac570-de75-11e8-bd11-2f9252c4dc2f,AIRDROP,0
airdrop-20181115-hdac-b4f6aaff-0c31-4050-810f-e8e311601920-withdrawal-exchange,2018.11.15 10:12,UNKNOWN,,UNKNOWN-55c0f2b7-dc24-425b-9be8-6b86719f2865,2018.11.15 10:12,UNKNOWN,0,100,0,HDAC,WITHDRAWAL,,,,0,COMPLETED,0,sum-user-id,1553110.7,airdrop-20181115-hdac-sum-user-id-withdrawal,accac570-de75-11e8-bd11-2f9252c4dc2f,AIRDROP,0
airdrop-20181115-hdac-b4f804e2-ef5b-4265-bf92-331654792035-withdrawal-exchange,2018.11.15 10:12,UNKNOWN,,UNKNOWN-55c0f2b7-dc24-425b-9be8-6b86719f2865,2018.11.15 10:12,UNKNOWN,0,1942.552874,0,HDAC,WITHDRAWAL,,,,0,COMPLETED,0,sum-user-id,1551168.147,airdrop-20181115-hdac-sum-user-id-withdrawal,accac570-de75-11e8-bd11-2f9252c4dc2f,AIRDROP,0
airdrop-20181115-hdac-b5038fbb-f49a-4a55-aaeb-267124dc35af-withdrawal-exchange,2018.11.15 10:12,UNKNOWN,,UNKNOWN-55c0f2b7-dc24-425b-9be8-6b86719f2865,2018.11.15 10:12,UNKNOWN,0,100,0,HDAC,WITHDRAWAL,,,,0,COMPLETED,0,sum-user-id,1551068.147,airdrop-20181115-hdac-sum-user-id-withdrawal,accac570-de75-11e8-bd11-2f9252c4dc2f,AIRDROP,0
airdrop-20181115-hdac-b563d6ca-1643-48e4-b96f-09d9992d83cf-withdrawal-exchange,2018.11.15 10:12,UNKNOWN,,UNKNOWN-55c0f2b7-dc24-425b-9be8-6b86719f2865,2018.11.15 10:12,UNKNOWN,0,5889.005483,0,HDAC,WITHDRAWAL,,,,0,COMPLETED,0,sum-user-id,1235572.174,airdrop-20181115-hdac-sum-user-id-withdrawal,accac570-de75-11e8-bd11-2f9252c4dc2f,AIRDROP,0
airdrop-20181115-hdac-b592265c-ee91-4094-b88c-3ed6a5c5a4aa-withdrawal-exchange,2018.11.15 10:12,UNKNOWN,,UNKNOWN-55c0f2b7-dc24-425b-9be8-6b86719f2865,2018.11.15 10:12,UNKNOWN,0,100,0,HDAC,WITHDRAWAL,,,,0,COMPLETED,0,sum-user-id,1550968.147,airdrop-20181115-hdac-sum-user-id-withdrawal,accac570-de75-11e8-bd11-2f9252c4dc2f,AIRDROP,0
airdrop-20181115-hdac-b5a34b12-18d9-46c9-aa72-3b3bfab406f7-withdrawal-exchange,2018.11.15 10:12,UNKNOWN,,UNKNOWN-55c0f2b7-dc24-425b-9be8-6b86719f2865,2018.11.15 10:12,UNKNOWN,0,100,0,HDAC,WITHDRAWAL,,,,0,COMPLETED,0,sum-user-id,1550868.147,airdrop-20181115-hdac-sum-user-id-withdrawal,accac570-de75-11e8-bd11-2f9252c4dc2f,AIRDROP,0
airdrop-20181115-hdac-b5af92ff-02e8-4a59-92e1-b9355d07b810-withdrawal-exchange,2018.11.15 10:12,UNKNOWN,,UNKNOWN-55c0f2b7-dc24-425b-9be8-6b86719f2865,2018.11.15 10:12,UNKNOWN,0,100,0,HDAC,WITHDRAWAL,,,,0,COMPLETED,0,sum-user-id,1550768.147,airdrop-20181115-hdac-sum-user-id-withdrawal,accac570-de75-11e8-bd11-2f9252c4dc2f,AIRDROP,0
airdrop-20181115-hdac-b5d73fe5-f803-44a8-8915-56a3aa7e0e0b-withdrawal-exchange,2018.11.15 10:12,UNKNOWN,,UNKNOWN-55c0f2b7-dc24-425b-9be8-6b86719f2865,2018.11.15 10:12,UNKNOWN,0,100,0,HDAC,WITHDRAWAL,,,,0,COMPLETED,0,sum-user-id,1550668.147,airdrop-20181115-hdac-sum-user-id-withdrawal,accac570-de75-11e8-bd11-2f9252c4dc2f,AIRDROP,0
airdrop-20181115-hdac-b6078bff-5beb-4859-b875-f9aba77d575c-withdrawal-exchange,2018.11.15 10:12,UNKNOWN,,UNKNOWN-55c0f2b7-dc24-425b-9be8-6b86719f2865,2018.11.15 10:12,UNKNOWN,0,100,0,HDAC,WITHDRAWAL,,,,0,COMPLETED,0,sum-user-id,1550568.147,airdrop-20181115-hdac-sum-user-id-withdrawal,accac570-de75-11e8-bd11-2f9252c4dc2f,AIRDROP,0
airdrop-20181115-hdac-b621294f-32ea-473b-9fcf-74e92cd224cd-withdrawal-exchange,2018.11.15 10:12,UNKNOWN,,UNKNOWN-55c0f2b7-dc24-425b-9be8-6b86719f2865,2018.11.15 10:12,UNKNOWN,0,100,0,HDAC,WITHDRAWAL,,,,0,COMPLETED,0,sum-user-id,1550468.147,airdrop-20181115-hdac-sum-user-id-withdrawal,accac570-de75-11e8-bd11-2f9252c4dc2f,AIRDROP,0
airdrop-20181115-hdac-b6365637-64f5-471d-855b-e707c820a1d5-withdrawal-exchange,2018.11.15 10:12,UNKNOWN,,UNKNOWN-55c0f2b7-dc24-425b-9be8-6b86719f2865,2018.11.15 10:12,UNKNOWN,0,100,0,HDAC,WITHDRAWAL,,,,0,COMPLETED,0,sum-user-id,1550368.147,airdrop-20181115-hdac-sum-user-id-withdrawal,accac570-de75-11e8-bd11-2f9252c4dc2f,AIRDROP,0
airdrop-20181115-hdac-b64bde09-b435-438f-be38-36d005e988b1-withdrawal-exchange,2018-11-15 10:12:04.019,UNKNOWN,,UNKNOWN-55c0f2b7-dc24-425b-9be8-6b86719f2865,2018-11-15 10:12:04.019,UNKNOWN,0,100,0,HDAC,WITHDRAWAL,,,,0,COMPLETED,0,sum-user-id,1550268.147,airdrop-20181115-hdac-sum-user-id-withdrawal,accac570-de75-11e8-bd11-2f9252c4dc2f,AIRDROP,0
airdrop-20181115-hdac-b65a2833-856d-4b95-b132-6f8dc0a64ba9-withdrawal-exchange,2018-11-15 10:12:04.054,UNKNOWN,,UNKNOWN-55c0f2b7-dc24-425b-9be8-6b86719f2865,2018-11-15 10:12:04.054,UNKNOWN,0,100,0,HDAC,WITHDRAWAL,,,,0,COMPLETED,0,sum-user-id,1550168.147,airdrop-20181115-hdac-sum-user-id-withdrawal,accac570-de75-11e8-bd11-2f9252c4dc2f,AIRDROP,0
airdrop-20181115-hdac-b66bc191-b761-48a6-b373-efcf5858eb56-withdrawal-exchange,2018-11-15 10:12:04.086,UNKNOWN,,UNKNOWN-55c0f2b7-dc24-425b-9be8-6b86719f2865,2018-11-15 10:12:04.086,UNKNOWN,0,100,0,HDAC,WITHDRAWAL,,,,0,COMPLETED,0,sum-user-id,1550068.147,airdrop-20181115-hdac-sum-user-id-withdrawal,accac570-de75-11e8-bd11-2f9252c4dc2f,AIRDROP,0
airdrop-20181115-hdac-b67811e4-9dee-4212-8db1-83ad4c203fa5-withdrawal-exchange,2018.11.15 10:12,UNKNOWN,,UNKNOWN-55c0f2b7-dc24-425b-9be8-6b86719f2865,2018.11.15 10:12,UNKNOWN,0,100,0,HDAC,WITHDRAWAL,,,,0,COMPLETED,0,sum-user-id,1549968.147,airdrop-20181115-hdac-sum-user-id-withdrawal,accac570-de75-11e8-bd11-2f9252c4dc2f,AIRDROP,0
airdrop-20181115-hdac-b681da83-f5b8-4b67-9551-d601dd26e06d-withdrawal-exchange,2018.11.15 10:12,UNKNOWN,,UNKNOWN-55c0f2b7-dc24-425b-9be8-6b86719f2865,2018.11.15 10:12,UNKNOWN,0,100,0,HDAC,WITHDRAWAL,,,,0,COMPLETED,0,sum-user-id,1549868.147,airdrop-20181115-hdac-sum-user-id-withdrawal,accac570-de75-11e8-bd11-2f9252c4dc2f,AIRDROP,0
airdrop-20181115-hdac-b69aa6ce-930b-4c7c-954b-46c553f0b7de-withdrawal-exchange,2018.11.15 10:12,UNKNOWN,,UNKNOWN-55c0f2b7-dc24-425b-9be8-6b86719f2865,2018.11.15 10:12,UNKNOWN,0,100,0,HDAC,WITHDRAWAL,,,,0,COMPLETED,0,sum-user-id,1549768.147,airdrop-20181115-hdac-sum-user-id-withdrawal,accac570-de75-11e8-bd11-2f9252c4dc2f,AIRDROP,0
airdrop-20181115-hdac-b69e8506-daa2-40f2-ac96-6b0fd6e77e83-withdrawal-exchange,2018.11.15 10:12,UNKNOWN,,UNKNOWN-55c0f2b7-dc24-425b-9be8-6b86719f2865,2018.11.15 10:12,UNKNOWN,0,100,0,HDAC,WITHDRAWAL,,,,0,COMPLETED,0,sum-user-id,1549668.147,airdrop-20181115-hdac-sum-user-id-withdrawal,accac570-de75-11e8-bd11-2f9252c4dc2f,AIRDROP,0
airdrop-20181115-hdac-b6b76705-7db5-4089-b2d0-1d18700dc5f4-withdrawal-exchange,2018.11.15 10:12,UNKNOWN,,UNKNOWN-55c0f2b7-dc24-425b-9be8-6b86719f2865,2018.11.15 10:12,UNKNOWN,0,100,0,HDAC,WITHDRAWAL,,,,0,COMPLETED,0,sum-user-id,1549568.147,airdrop-20181115-hdac-sum-user-id-withdrawal,accac570-de75-11e8-bd11-2f9252c4dc2f,AIRDROP,0
airdrop-20181115-hdac-b6ded53f-3c01-4292-b7e5-8f83f397bed8-withdrawal-exchange,2018.11.15 10:12,UNKNOWN,,UNKNOWN-55c0f2b7-dc24-425b-9be8-6b86719f2865,2018.11.15 10:12,UNKNOWN,0,100,0,HDAC,WITHDRAWAL,,,,0,COMPLETED,0,sum-user-id,1549468.147,airdrop-20181115-hdac-sum-user-id-withdrawal,accac570-de75-11e8-bd11-2f9252c4dc2f,AIRDROP,0
airdrop-20181115-hdac-b6e36aa9-4e0b-4e15-9cf7-4eacb0afd351-withdrawal-exchange,2018.11.15 10:12,UNKNOWN,,UNKNOWN-55c0f2b7-dc24-425b-9be8-6b86719f2865,2018.11.15 10:12,UNKNOWN,0,100,0,HDAC,WITHDRAWAL,,,,0,COMPLETED,0,sum-user-id,1549368.147,airdrop-20181115-hdac-sum-user-id-withdrawal,accac570-de75-11e8-bd11-2f9252c4dc2f,AIRDROP,0
airdrop-20181115-hdac-b6e78bd6-97b3-48ed-be89-cb4a260b19ef-withdrawal-exchange,2018.11.15 10:12,UNKNOWN,,UNKNOWN-55c0f2b7-dc24-425b-9be8-6b86719f2865,2018.11.15 10:12,UNKNOWN,0,100,0,HDAC,WITHDRAWAL,,,,0,COMPLETED,0,sum-user-id,1549268.147,airdrop-20181115-hdac-sum-user-id-withdrawal,accac570-de75-11e8-bd11-2f9252c4dc2f,AIRDROP,0
airdrop-20181115-hdac-b6f67da4-32b9-4773-ba3f-e9c0f5e4b084-withdrawal-exchange,2018.11.15 10:12,UNKNOWN,,UNKNOWN-55c0f2b7-dc24-425b-9be8-6b86719f2865,2018.11.15 10:12,UNKNOWN,0,100,0,HDAC,WITHDRAWAL,,,,0,COMPLETED,0,sum-user-id,1549168.147,airdrop-20181115-hdac-sum-user-id-withdrawal,accac570-de75-11e8-bd11-2f9252c4dc2f,AIRDROP,0
airdrop-20181115-hdac-b7023dac-745c-4c3e-8c26-0194d09c6583-withdrawal-exchange,2018.11.15 10:12,UNKNOWN,,UNKNOWN-55c0f2b7-dc24-425b-9be8-6b86719f2865,2018.11.15 10:12,UNKNOWN,0,100,0,HDAC,WITHDRAWAL,,,,0,COMPLETED,0,sum-user-id,1549068.147,airdrop-20181115-hdac-sum-user-id-withdrawal,accac570-de75-11e8-bd11-2f9252c4dc2f,AIRDROP,0
airdrop-20181115-hdac-b735c465-aa81-41a9-b4f0-2421c6e44369-withdrawal-exchange,2018.11.15 10:12,UNKNOWN,,UNKNOWN-55c0f2b7-dc24-425b-9be8-6b86719f2865,2018.11.15 10:12,UNKNOWN,0,100,0,HDAC,WITHDRAWAL,,,,0,COMPLETED,0,sum-user-id,1548968.147,airdrop-20181115-hdac-sum-user-id-withdrawal,accac570-de75-11e8-bd11-2f9252c4dc2f,AIRDROP,0
airdrop-20181115-hdac-b7d8f5f1-b2f3-489e-81df-c1631f3e69ce-withdrawal-exchange,2018.11.15 10:12,UNKNOWN,,UNKNOWN-55c0f2b7-dc24-425b-9be8-6b86719f2865,2018.11.15 10:12,UNKNOWN,0,100,0,HDAC,WITHDRAWAL,,,,0,COMPLETED,0,sum-user-id,1548868.147,airdrop-20181115-hdac-sum-user-id-withdrawal,accac570-de75-11e8-bd11-2f9252c4dc2f,AIRDROP,0
airdrop-20181115-hdac-b801cce3-255d-403c-acf9-c45aca06b223-withdrawal-exchange,2018.11.15 10:12,UNKNOWN,,UNKNOWN-55c0f2b7-dc24-425b-9be8-6b86719f2865,2018.11.15 10:12,UNKNOWN,0,100,0,HDAC,WITHDRAWAL,,,,0,COMPLETED,0,sum-user-id,1548768.147,airdrop-20181115-hdac-sum-user-id-withdrawal,accac570-de75-11e8-bd11-2f9252c4dc2f,AIRDROP,0
airdrop-20181115-hdac-b8624a8a-ff78-405f-b9d8-3f64e81d9103-withdrawal-exchange,2018.11.15 10:12,UNKNOWN,,UNKNOWN-55c0f2b7-dc24-425b-9be8-6b86719f2865,2018.11.15 10:12,UNKNOWN,0,100,0,HDAC,WITHDRAWAL,,,,0,COMPLETED,0,sum-user-id,1548668.147,airdrop-20181115-hdac-sum-user-id-withdrawal,accac570-de75-11e8-bd11-2f9252c4dc2f,AIRDROP,0
airdrop-20181115-hdac-b862d3da-995e-4f8b-b89f-d0a40b9f3857-withdrawal-exchange,2018.11.15 10:12,UNKNOWN,,UNKNOWN-55c0f2b7-dc24-425b-9be8-6b86719f2865,2018.11.15 10:12,UNKNOWN,0,100,0,HDAC,WITHDRAWAL,,,,0,COMPLETED,0,sum-user-id,1548568.147,airdrop-20181115-hdac-sum-user-id-withdrawal,accac570-de75-11e8-bd11-2f9252c4dc2f,AIRDROP,0
airdrop-20181115-hdac-b866ce5c-ae77-46ac-a14b-f5339d3d2f72-withdrawal-exchange,2018.11.15 10:12,UNKNOWN,,UNKNOWN-55c0f2b7-dc24-425b-9be8-6b86719f2865,2018.11.15 10:12,UNKNOWN,0,100,0,HDAC,WITHDRAWAL,,,,0,COMPLETED,0,sum-user-id,1548468.147,airdrop-20181115-hdac-sum-user-id-withdrawal,accac570-de75-11e8-bd11-2f9252c4dc2f,AIRDROP,0
airdrop-20181115-hdac-b870592a-8574-452a-a742-4da10747646c-withdrawal-exchange,2018.11.15 10:12,UNKNOWN,,UNKNOWN-55c0f2b7-dc24-425b-9be8-6b86719f2865,2018.11.15 10:12,UNKNOWN,0,100,0,HDAC,WITHDRAWAL,,,,0,COMPLETED,0,sum-user-id,1548368.147,airdrop-20181115-hdac-sum-user-id-withdrawal,accac570-de75-11e8-bd11-2f9252c4dc2f,AIRDROP,0
airdrop-20181115-hdac-b8733179-c61e-46be-a768-ed30fedb9476-withdrawal-exchange,2018.11.15 10:12,UNKNOWN,,UNKNOWN-55c0f2b7-dc24-425b-9be8-6b86719f2865,2018.11.15 10:12,UNKNOWN,0,100,0,HDAC,WITHDRAWAL,,,,0,COMPLETED,0,sum-user-id,1548268.147,airdrop-20181115-hdac-sum-user-id-withdrawal,accac570-de75-11e8-bd11-2f9252c4dc2f,AIRDROP,0
airdrop-20181115-hdac-b88a2fb2-edb3-4e6d-bf43-ab639ad24bda-withdrawal-exchange,2018.11.15 10:12,UNKNOWN,,UNKNOWN-55c0f2b7-dc24-425b-9be8-6b86719f2865,2018.11.15 10:12,UNKNOWN,0,100,0,HDAC,WITHDRAWAL,,,,0,COMPLETED,0,sum-user-id,1548168.147,airdrop-20181115-hdac-sum-user-id-withdrawal,accac570-de75-11e8-bd11-2f9252c4dc2f,AIRDROP,0
airdrop-20181115-hdac-b88f05d8-c528-4efd-987f-caa48af31eda-withdrawal-exchange,2018.11.15 10:12,UNKNOWN,,UNKNOWN-55c0f2b7-dc24-425b-9be8-6b86719f2865,2018.11.15 10:12,UNKNOWN,0,100,0,HDAC,WITHDRAWAL,,,,0,COMPLETED,0,sum-user-id,1548068.147,airdrop-20181115-hdac-sum-user-id-withdrawal,accac570-de75-11e8-bd11-2f9252c4dc2f,AIRDROP,0
airdrop-20181115-hdac-b8a1ee00-8081-46a1-a770-b11479c7d093-withdrawal-exchange,2018.11.15 10:12,UNKNOWN,,UNKNOWN-55c0f2b7-dc24-425b-9be8-6b86719f2865,2018.11.15 10:12,UNKNOWN,0,100,0,HDAC,WITHDRAWAL,,,,0,COMPLETED,0,sum-user-id,1547968.147,airdrop-20181115-hdac-sum-user-id-withdrawal,accac570-de75-11e8-bd11-2f9252c4dc2f,AIRDROP,0
airdrop-20181115-hdac-b8aef4fd-fad8-42f6-bdd2-32e457a5cc26-withdrawal-exchange,2018.11.15 10:12,UNKNOWN,,UNKNOWN-55c0f2b7-dc24-425b-9be8-6b86719f2865,2018.11.15 10:12,UNKNOWN,0,100,0,HDAC,WITHDRAWAL,,,,0,COMPLETED,0,sum-user-id,1547868.147,airdrop-20181115-hdac-sum-user-id-withdrawal,accac570-de75-11e8-bd11-2f9252c4dc2f,AIRDROP,0
airdrop-20181115-hdac-b8cca873-14e4-46f6-b116-dd5639499c2f-withdrawal-exchange,2018.11.15 10:12,UNKNOWN,,UNKNOWN-55c0f2b7-dc24-425b-9be8-6b86719f2865,2018.11.15 10:12,UNKNOWN,0,100,0,HDAC,WITHDRAWAL,,,,0,COMPLETED,0,sum-user-id,1547768.147,airdrop-20181115-hdac-sum-user-id-withdrawal,accac570-de75-11e8-bd11-2f9252c4dc2f,AIRDROP,0
airdrop-20181115-hdac-b8f96b94-eb1c-49d3-9016-1ab8b9cde8f4-withdrawal-exchange,2018.11.15 10:12,UNKNOWN,,UNKNOWN-55c0f2b7-dc24-425b-9be8-6b86719f2865,2018.11.15 10:12,UNKNOWN,0,100,0,HDAC,WITHDRAWAL,,,,0,COMPLETED,0,sum-user-id,1547668.147,airdrop-20181115-hdac-sum-user-id-withdrawal,accac570-de75-11e8-bd11-2f9252c4dc2f,AIRDROP,0
airdrop-20181115-hdac-b90b535a-49ca-40a8-b631-9d848aa79ed1-withdrawal-exchange,2018.11.15 10:12,UNKNOWN,,UNKNOWN-55c0f2b7-dc24-425b-9be8-6b86719f2865,2018.11.15 10:12,UNKNOWN,0,100,0,HDAC,WITHDRAWAL,,,,0,COMPLETED,0,sum-user-id,1547568.147,airdrop-20181115-hdac-sum-user-id-withdrawal,accac570-de75-11e8-bd11-2f9252c4dc2f,AIRDROP,0
airdrop-20181115-hdac-b90d33d6-474b-4901-acc2-893a5ea66644-withdrawal-exchange,2018.11.15 10:12,UNKNOWN,,UNKNOWN-55c0f2b7-dc24-425b-9be8-6b86719f2865,2018.11.15 10:12,UNKNOWN,0,100,0,HDAC,WITHDRAWAL,,,,0,COMPLETED,0,sum-user-id,1547468.147,airdrop-20181115-hdac-sum-user-id-withdrawal,accac570-de75-11e8-bd11-2f9252c4dc2f,AIRDROP,0
airdrop-20181115-hdac-b9121985-f129-4810-bb81-8c18c4d63daa-withdrawal-exchange,2018.11.15 10:12,UNKNOWN,,UNKNOWN-55c0f2b7-dc24-425b-9be8-6b86719f2865,2018.11.15 10:12,UNKNOWN,0,100,0,HDAC,WITHDRAWAL,,,,0,COMPLETED,0,sum-user-id,1547368.147,airdrop-20181115-hdac-sum-user-id-withdrawal,accac570-de75-11e8-bd11-2f9252c4dc2f,AIRDROP,0
airdrop-20181115-hdac-b926e7e4-73dc-44f8-bdbd-1a1f64043aba-withdrawal-exchange,2018.11.15 10:12,UNKNOWN,,UNKNOWN-55c0f2b7-dc24-425b-9be8-6b86719f2865,2018.11.15 10:12,UNKNOWN,0,100,0,HDAC,WITHDRAWAL,,,,0,COMPLETED,0,sum-user-id,1547268.147,airdrop-20181115-hdac-sum-user-id-withdrawal,accac570-de75-11e8-bd11-2f9252c4dc2f,AIRDROP,0
airdrop-20181115-hdac-b98b3eb0-b79a-4a18-b830-2ee1882b45fd-withdrawal-exchange,2018-11-15 10:12:05.017,UNKNOWN,,UNKNOWN-55c0f2b7-dc24-425b-9be8-6b86719f2865,2018-11-15 10:12:05.017,UNKNOWN,0,100,0,HDAC,WITHDRAWAL,,,,0,COMPLETED,0,sum-user-id,1547168.147,airdrop-20181115-hdac-sum-user-id-withdrawal,accac570-de75-11e8-bd11-2f9252c4dc2f,AIRDROP,0
airdrop-20181115-hdac-b990c4df-1e7e-493f-bc07-b808d1f2b536-withdrawal-exchange,2018-11-15 10:12:05.048,UNKNOWN,,UNKNOWN-55c0f2b7-dc24-425b-9be8-6b86719f2865,2018-11-15 10:12:05.048,UNKNOWN,0,100,0,HDAC,WITHDRAWAL,,,,0,COMPLETED,0,sum-user-id,1547068.147,airdrop-20181115-hdac-sum-user-id-withdrawal,accac570-de75-11e8-bd11-2f9252c4dc2f,AIRDROP,0
airdrop-20181115-hdac-b9a85e39-be63-4424-bdff-1dfd9974d8df-withdrawal-exchange,2018-11-15 10:12:05.076,UNKNOWN,,UNKNOWN-55c0f2b7-dc24-425b-9be8-6b86719f2865,2018-11-15 10:12:05.076,UNKNOWN,0,100,0,HDAC,WITHDRAWAL,,,,0,COMPLETED,0,sum-user-id,1546968.147,airdrop-20181115-hdac-sum-user-id-withdrawal,accac570-de75-11e8-bd11-2f9252c4dc2f,AIRDROP,0
airdrop-20181115-hdac-b9e0199f-e1da-42da-91d1-7adbc7a08dfb-withdrawal-exchange,2018.11.15 10:12,UNKNOWN,,UNKNOWN-55c0f2b7-dc24-425b-9be8-6b86719f2865,2018.11.15 10:12,UNKNOWN,0,100,0,HDAC,WITHDRAWAL,,,,0,COMPLETED,0,sum-user-id,1546868.147,airdrop-20181115-hdac-sum-user-id-withdrawal,accac570-de75-11e8-bd11-2f9252c4dc2f,AIRDROP,0
airdrop-20181115-hdac-b9f3ebc5-dade-4229-b6d2-f741d3180ca2-withdrawal-exchange,2018.11.15 10:12,UNKNOWN,,UNKNOWN-55c0f2b7-dc24-425b-9be8-6b86719f2865,2018.11.15 10:12,UNKNOWN,0,100,0,HDAC,WITHDRAWAL,,,,0,COMPLETED,0,sum-user-id,1546768.147,airdrop-20181115-hdac-sum-user-id-withdrawal,accac570-de75-11e8-bd11-2f9252c4dc2f,AIRDROP,0
airdrop-20181115-hdac-b9fb2530-967c-4921-9689-db5291d1849f-withdrawal-exchange,2018.11.15 10:12,UNKNOWN,,UNKNOWN-55c0f2b7-dc24-425b-9be8-6b86719f2865,2018.11.15 10:12,UNKNOWN,0,100,0,HDAC,WITHDRAWAL,,,,0,COMPLETED,0,sum-user-id,1546668.147,airdrop-20181115-hdac-sum-user-id-withdrawal,accac570-de75-11e8-bd11-2f9252c4dc2f,AIRDROP,0
airdrop-20181115-hdac-b9fdef2e-bf73-45a0-96d4-033577706e01-withdrawal-exchange,2018.11.15 10:12,UNKNOWN,,UNKNOWN-55c0f2b7-dc24-425b-9be8-6b86719f2865,2018.11.15 10:12,UNKNOWN,0,100,0,HDAC,WITHDRAWAL,,,,0,COMPLETED,0,sum-user-id,1546568.147,airdrop-20181115-hdac-sum-user-id-withdrawal,accac570-de75-11e8-bd11-2f9252c4dc2f,AIRDROP,0
airdrop-20181115-hdac-ba0944c3-8bbe-4432-b91f-1dc26e11810d-withdrawal-exchange,2018.11.15 10:12,UNKNOWN,,UNKNOWN-55c0f2b7-dc24-425b-9be8-6b86719f2865,2018.11.15 10:12,UNKNOWN,0,100,0,HDAC,WITHDRAWAL,,,,0,COMPLETED,0,sum-user-id,1546468.147,airdrop-20181115-hdac-sum-user-id-withdrawal,accac570-de75-11e8-bd11-2f9252c4dc2f,AIRDROP,0
airdrop-20181115-hdac-ba200079-12bd-4e43-9f89-a92581d17564-withdrawal-exchange,2018.11.15 10:12,UNKNOWN,,UNKNOWN-55c0f2b7-dc24-425b-9be8-6b86719f2865,2018.11.15 10:12,UNKNOWN,0,100,0,HDAC,WITHDRAWAL,,,,0,COMPLETED,0,sum-user-id,1546368.147,airdrop-20181115-hdac-sum-user-id-withdrawal,accac570-de75-11e8-bd11-2f9252c4dc2f,AIRDROP,0
airdrop-20181115-hdac-ba2847fc-e43b-4d0c-963e-a39307742cba-withdrawal-exchange,2018.11.15 10:12,UNKNOWN,,UNKNOWN-55c0f2b7-dc24-425b-9be8-6b86719f2865,2018.11.15 10:12,UNKNOWN,0,100,0,HDAC,WITHDRAWAL,,,,0,COMPLETED,0,sum-user-id,1546268.147,airdrop-20181115-hdac-sum-user-id-withdrawal,accac570-de75-11e8-bd11-2f9252c4dc2f,AIRDROP,0
airdrop-20181115-hdac-ba2a6ed3-b53d-4d64-896c-82de09dcdff7-withdrawal-exchange,2018.11.15 10:12,UNKNOWN,,UNKNOWN-55c0f2b7-dc24-425b-9be8-6b86719f2865,2018.11.15 10:12,UNKNOWN,0,100,0,HDAC,WITHDRAWAL,,,,0,COMPLETED,0,sum-user-id,1546168.147,airdrop-20181115-hdac-sum-user-id-withdrawal,accac570-de75-11e8-bd11-2f9252c4dc2f,AIRDROP,0
airdrop-20181115-hdac-ba2e3155-e671-4463-856c-759f7ca31d7d-withdrawal-exchange,2018.11.15 10:12,UNKNOWN,,UNKNOWN-55c0f2b7-dc24-425b-9be8-6b86719f2865,2018.11.15 10:12,UNKNOWN,0,100,0,HDAC,WITHDRAWAL,,,,0,COMPLETED,0,sum-user-id,1546068.147,airdrop-20181115-hdac-sum-user-id-withdrawal,accac570-de75-11e8-bd11-2f9252c4dc2f,AIRDROP,0
airdrop-20181115-hdac-ba2fe372-e73a-4203-813b-0396916d01b7-withdrawal-exchange,2018.11.15 10:12,UNKNOWN,,UNKNOWN-55c0f2b7-dc24-425b-9be8-6b86719f2865,2018.11.15 10:12,UNKNOWN,0,100,0,HDAC,WITHDRAWAL,,,,0,COMPLETED,0,sum-user-id,1545968.147,airdrop-20181115-hdac-sum-user-id-withdrawal,accac570-de75-11e8-bd11-2f9252c4dc2f,AIRDROP,0
airdrop-20181115-hdac-ba40ba31-92ae-45b9-901a-271e8d1a707c-withdrawal-exchange,2018.11.15 10:12,UNKNOWN,,UNKNOWN-55c0f2b7-dc24-425b-9be8-6b86719f2865,2018.11.15 10:12,UNKNOWN,0,100,0,HDAC,WITHDRAWAL,,,,0,COMPLETED,0,sum-user-id,1545868.147,airdrop-20181115-hdac-sum-user-id-withdrawal,accac570-de75-11e8-bd11-2f9252c4dc2f,AIRDROP,0
airdrop-20181115-hdac-ba62a0c5-2919-46ed-927b-5eabb79c0c92-withdrawal-exchange,2018.11.15 10:12,UNKNOWN,,UNKNOWN-55c0f2b7-dc24-425b-9be8-6b86719f2865,2018.11.15 10:12,UNKNOWN,0,100,0,HDAC,WITHDRAWAL,,,,0,COMPLETED,0,sum-user-id,1545768.147,airdrop-20181115-hdac-sum-user-id-withdrawal,accac570-de75-11e8-bd11-2f9252c4dc2f,AIRDROP,0
airdrop-20181115-hdac-ba652bec-6974-4f5c-85a1-9f280d623c1d-withdrawal-exchange,2018.11.15 10:12,UNKNOWN,,UNKNOWN-55c0f2b7-dc24-425b-9be8-6b86719f2865,2018.11.15 10:12,UNKNOWN,0,100,0,HDAC,WITHDRAWAL,,,,0,COMPLETED,0,sum-user-id,1545668.147,airdrop-20181115-hdac-sum-user-id-withdrawal,accac570-de75-11e8-bd11-2f9252c4dc2f,AIRDROP,0
airdrop-20181115-hdac-bad8d5f3-137b-40f6-bf19-ce1c68c92de3-withdrawal-exchange,2018.11.15 10:12,UNKNOWN,,UNKNOWN-55c0f2b7-dc24-425b-9be8-6b86719f2865,2018.11.15 10:12,UNKNOWN,0,100,0,HDAC,WITHDRAWAL,,,,0,COMPLETED,0,sum-user-id,1545568.147,airdrop-20181115-hdac-sum-user-id-withdrawal,accac570-de75-11e8-bd11-2f9252c4dc2f,AIRDROP,0
airdrop-20181115-hdac-baeac47d-7135-455a-bb03-057977f08149-withdrawal-exchange,2018.11.15 10:12,UNKNOWN,,UNKNOWN-55c0f2b7-dc24-425b-9be8-6b86719f2865,2018.11.15 10:12,UNKNOWN,0,100,0,HDAC,WITHDRAWAL,,,,0,COMPLETED,0,sum-user-id,1545468.147,airdrop-20181115-hdac-sum-user-id-withdrawal,accac570-de75-11e8-bd11-2f9252c4dc2f,AIRDROP,0
airdrop-20181115-hdac-bb114359-1da0-4172-ac9d-f711a9f14c68-withdrawal-exchange,2018.11.15 10:12,UNKNOWN,,UNKNOWN-55c0f2b7-dc24-425b-9be8-6b86719f2865,2018.11.15 10:12,UNKNOWN,0,100,0,HDAC,WITHDRAWAL,,,,0,COMPLETED,0,sum-user-id,1545368.147,airdrop-20181115-hdac-sum-user-id-withdrawal,accac570-de75-11e8-bd11-2f9252c4dc2f,AIRDROP,0
airdrop-20181115-hdac-bb191f33-6c97-41f4-b880-e0d681c22e20-withdrawal-exchange,2018.11.15 10:12,UNKNOWN,,UNKNOWN-55c0f2b7-dc24-425b-9be8-6b86719f2865,2018.11.15 10:12,UNKNOWN,0,100,0,HDAC,WITHDRAWAL,,,,0,COMPLETED,0,sum-user-id,1545268.147,airdrop-20181115-hdac-sum-user-id-withdrawal,accac570-de75-11e8-bd11-2f9252c4dc2f,AIRDROP,0
airdrop-20181115-hdac-bb71f987-2c82-4f4d-a20d-342790f7d736-withdrawal-exchange,2018.11.15 10:12,UNKNOWN,,UNKNOWN-55c0f2b7-dc24-425b-9be8-6b86719f2865,2018.11.15 10:12,UNKNOWN,0,62.917221,0,HDAC,WITHDRAWAL,,,,0,COMPLETED,0,sum-user-id,1545205.23,airdrop-20181115-hdac-sum-user-id-withdrawal,accac570-de75-11e8-bd11-2f9252c4dc2f,AIRDROP,0
airdrop-20181115-hdac-bbb660ff-062a-4000-a681-1fd03ba3882b-withdrawal-exchange,2018.11.15 10:12,UNKNOWN,,UNKNOWN-55c0f2b7-dc24-425b-9be8-6b86719f2865,2018.11.15 10:12,UNKNOWN,0,459.68,0,HDAC,WITHDRAWAL,,,,0,COMPLETED,0,sum-user-id,1235112.494,airdrop-20181115-hdac-sum-user-id-withdrawal,accac570-de75-11e8-bd11-2f9252c4dc2f,AIRDROP,0
airdrop-20181115-hdac-bbba5c32-3d18-4d9d-a9d6-4c8aa53c1b51-withdrawal-exchange,2018.11.15 10:12,UNKNOWN,,UNKNOWN-55c0f2b7-dc24-425b-9be8-6b86719f2865,2018.11.15 10:12,UNKNOWN,0,100,0,HDAC,WITHDRAWAL,,,,0,COMPLETED,0,sum-user-id,1545105.23,airdrop-20181115-hdac-sum-user-id-withdrawal,accac570-de75-11e8-bd11-2f9252c4dc2f,AIRDROP,0
airdrop-20181115-hdac-bbebd7b2-1b1e-4f41-a32a-dd2ab20ec90d-withdrawal-exchange,2018.11.15 10:12,UNKNOWN,,UNKNOWN-55c0f2b7-dc24-425b-9be8-6b86719f2865,2018.11.15 10:12,UNKNOWN,0,100,0,HDAC,WITHDRAWAL,,,,0,COMPLETED,0,sum-user-id,1545005.23,airdrop-20181115-hdac-sum-user-id-withdrawal,accac570-de75-11e8-bd11-2f9252c4dc2f,AIRDROP,0
airdrop-20181115-hdac-bc1ae3d7-8549-4141-b177-a7c20b39c9da-withdrawal-exchange,2018.11.15 10:12,UNKNOWN,,UNKNOWN-55c0f2b7-dc24-425b-9be8-6b86719f2865,2018.11.15 10:12,UNKNOWN,0,100,0,HDAC,WITHDRAWAL,,,,0,COMPLETED,0,sum-user-id,1544905.23,airdrop-20181115-hdac-sum-user-id-withdrawal,accac570-de75-11e8-bd11-2f9252c4dc2f,AIRDROP,0
airdrop-20181115-hdac-bc1e0289-2e29-4393-ad5f-5de1dfdc5c57-withdrawal-exchange,2018.11.15 10:12,UNKNOWN,,UNKNOWN-55c0f2b7-dc24-425b-9be8-6b86719f2865,2018.11.15 10:12,UNKNOWN,0,100,0,HDAC,WITHDRAWAL,,,,0,COMPLETED,0,sum-user-id,1544805.23,airdrop-20181115-hdac-sum-user-id-withdrawal,accac570-de75-11e8-bd11-2f9252c4dc2f,AIRDROP,0
airdrop-20181115-hdac-bc7256a4-58df-41ea-9f1c-119c215fda9d-withdrawal-exchange,2018.11.15 10:12,UNKNOWN,,UNKNOWN-55c0f2b7-dc24-425b-9be8-6b86719f2865,2018.11.15 10:12,UNKNOWN,0,100,0,HDAC,WITHDRAWAL,,,,0,COMPLETED,0,sum-user-id,1544705.23,airdrop-20181115-hdac-sum-user-id-withdrawal,accac570-de75-11e8-bd11-2f9252c4dc2f,AIRDROP,0
airdrop-20181115-hdac-bcd64c2d-aa97-422c-bf46-e0989da39faf-withdrawal-exchange,2018.11.15 10:12,UNKNOWN,,UNKNOWN-55c0f2b7-dc24-425b-9be8-6b86719f2865,2018.11.15 10:12,UNKNOWN,0,100,0,HDAC,WITHDRAWAL,,,,0,COMPLETED,0,sum-user-id,1544605.23,airdrop-20181115-hdac-sum-user-id-withdrawal,accac570-de75-11e8-bd11-2f9252c4dc2f,AIRDROP,0
airdrop-20181115-hdac-bcde0443-b221-4e12-838f-55d3a1874684-withdrawal-exchange,2018.11.15 10:12,UNKNOWN,,UNKNOWN-55c0f2b7-dc24-425b-9be8-6b86719f2865,2018.11.15 10:12,UNKNOWN,0,100,0,HDAC,WITHDRAWAL,,,,0,COMPLETED,0,sum-user-id,1544505.23,airdrop-20181115-hdac-sum-user-id-withdrawal,accac570-de75-11e8-bd11-2f9252c4dc2f,AIRDROP,0
airdrop-20181115-hdac-bcdea55d-b75f-4688-a482-04198ae5e89e-withdrawal-exchange,2018.11.15 10:12,UNKNOWN,,UNKNOWN-55c0f2b7-dc24-425b-9be8-6b86719f2865,2018.11.15 10:12,UNKNOWN,0,100,0,HDAC,WITHDRAWAL,,,,0,COMPLETED,0,sum-user-id,1544405.23,airdrop-20181115-hdac-sum-user-id-withdrawal,accac570-de75-11e8-bd11-2f9252c4dc2f,AIRDROP,0
airdrop-20181115-hdac-bcfdf097-7894-4593-8f26-dd22e224b7a1-withdrawal-exchange,2018.11.15 10:12,UNKNOWN,,UNKNOWN-55c0f2b7-dc24-425b-9be8-6b86719f2865,2018.11.15 10:12,UNKNOWN,0,100,0,HDAC,WITHDRAWAL,,,,0,COMPLETED,0,sum-user-id,1544305.23,airdrop-20181115-hdac-sum-user-id-withdrawal,accac570-de75-11e8-bd11-2f9252c4dc2f,AIRDROP,0
airdrop-20181115-hdac-bd01e22d-b5ff-49c2-bb9f-1e52648b7eed-withdrawal-exchange,2018.11.15 10:12,UNKNOWN,,UNKNOWN-55c0f2b7-dc24-425b-9be8-6b86719f2865,2018.11.15 10:12,UNKNOWN,0,100,0,HDAC,WITHDRAWAL,,,,0,COMPLETED,0,sum-user-id,1544205.23,airdrop-20181115-hdac-sum-user-id-withdrawal,accac570-de75-11e8-bd11-2f9252c4dc2f,AIRDROP,0
airdrop-20181115-hdac-bd0815f2-912c-44e4-81bb-871eb1941ca2-withdrawal-exchange,2018-11-15 10:12:06.005,UNKNOWN,,UNKNOWN-55c0f2b7-dc24-425b-9be8-6b86719f2865,2018-11-15 10:12:06.005,UNKNOWN,0,100,0,HDAC,WITHDRAWAL,,,,0,COMPLETED,0,sum-user-id,1544105.23,airdrop-20181115-hdac-sum-user-id-withdrawal,accac570-de75-11e8-bd11-2f9252c4dc2f,AIRDROP,0
airdrop-20181115-hdac-bd2002c5-4f3f-4e60-8c8c-3655f444cd1c-withdrawal-exchange,2018-11-15 10:12:06.039,UNKNOWN,,UNKNOWN-55c0f2b7-dc24-425b-9be8-6b86719f2865,2018-11-15 10:12:06.039,UNKNOWN,0,100,0,HDAC,WITHDRAWAL,,,,0,COMPLETED,0,sum-user-id,1544005.23,airdrop-20181115-hdac-sum-user-id-withdrawal,accac570-de75-11e8-bd11-2f9252c4dc2f,AIRDROP,0
airdrop-20181115-hdac-bd26ce3f-c4d0-4d9e-8f18-502179e57261-withdrawal-exchange,2018-11-15 10:12:06.070,UNKNOWN,,UNKNOWN-55c0f2b7-dc24-425b-9be8-6b86719f2865,2018-11-15 10:12:06.070,UNKNOWN,0,100,0,HDAC,WITHDRAWAL,,,,0,COMPLETED,0,sum-user-id,1543905.23,airdrop-20181115-hdac-sum-user-id-withdrawal,accac570-de75-11e8-bd11-2f9252c4dc2f,AIRDROP,0
airdrop-20181115-hdac-bd7810be-9790-4be9-a945-edfc86aa78cc-withdrawal-exchange,2018-11-15 10:12:06.099,UNKNOWN,,UNKNOWN-55c0f2b7-dc24-425b-9be8-6b86719f2865,2018-11-15 10:12:06.099,UNKNOWN,0,100,0,HDAC,WITHDRAWAL,,,,0,COMPLETED,0,sum-user-id,1543805.23,airdrop-20181115-hdac-sum-user-id-withdrawal,accac570-de75-11e8-bd11-2f9252c4dc2f,AIRDROP,0
airdrop-20181115-hdac-bd7a90dc-3d80-448a-9b86-01bb56fd750d-withdrawal-exchange,2018.11.15 10:12,UNKNOWN,,UNKNOWN-55c0f2b7-dc24-425b-9be8-6b86719f2865,2018.11.15 10:12,UNKNOWN,0,100,0,HDAC,WITHDRAWAL,,,,0,COMPLETED,0,sum-user-id,1543705.23,airdrop-20181115-hdac-sum-user-id-withdrawal,accac570-de75-11e8-bd11-2f9252c4dc2f,AIRDROP,0
airdrop-20181115-hdac-bd7a9777-2b6b-4f1c-bfbd-7fa442a29ee3-withdrawal-exchange,2018.11.15 10:12,UNKNOWN,,UNKNOWN-55c0f2b7-dc24-425b-9be8-6b86719f2865,2018.11.15 10:12,UNKNOWN,0,100,0,HDAC,WITHDRAWAL,,,,0,COMPLETED,0,sum-user-id,1543605.23,airdrop-20181115-hdac-sum-user-id-withdrawal,accac570-de75-11e8-bd11-2f9252c4dc2f,AIRDROP,0
airdrop-20181115-hdac-bdaffc75-e39f-4bda-a5ea-bd78327c67ff-withdrawal-exchange,2018.11.15 10:12,UNKNOWN,,UNKNOWN-55c0f2b7-dc24-425b-9be8-6b86719f2865,2018.11.15 10:12,UNKNOWN,0,100,0,HDAC,WITHDRAWAL,,,,0,COMPLETED,0,sum-user-id,1543505.23,airdrop-20181115-hdac-sum-user-id-withdrawal,accac570-de75-11e8-bd11-2f9252c4dc2f,AIRDROP,0
airdrop-20181115-hdac-bdb5c2f0-4003-4515-a464-cf4d9c7fd0d2-withdrawal-exchange,2018.11.15 10:12,UNKNOWN,,UNKNOWN-55c0f2b7-dc24-425b-9be8-6b86719f2865,2018.11.15 10:12,UNKNOWN,0,100,0,HDAC,WITHDRAWAL,,,,0,COMPLETED,0,sum-user-id,1543405.23,airdrop-20181115-hdac-sum-user-id-withdrawal,accac570-de75-11e8-bd11-2f9252c4dc2f,AIRDROP,0
airdrop-20181115-hdac-bdc4fa19-1013-458a-90cb-8e6d510758b7-withdrawal-exchange,2018.11.15 10:12,UNKNOWN,,UNKNOWN-55c0f2b7-dc24-425b-9be8-6b86719f2865,2018.11.15 10:12,UNKNOWN,0,100,0,HDAC,WITHDRAWAL,,,,0,COMPLETED,0,sum-user-id,1543305.23,airdrop-20181115-hdac-sum-user-id-withdrawal,accac570-de75-11e8-bd11-2f9252c4dc2f,AIRDROP,0
airdrop-20181115-hdac-bdfddacc-2a32-432d-beda-2b4ac03cf3d3-withdrawal-exchange,2018.11.15 10:12,UNKNOWN,,UNKNOWN-55c0f2b7-dc24-425b-9be8-6b86719f2865,2018.11.15 10:12,UNKNOWN,0,100,0,HDAC,WITHDRAWAL,,,,0,COMPLETED,0,sum-user-id,1543205.23,airdrop-20181115-hdac-sum-user-id-withdrawal,accac570-de75-11e8-bd11-2f9252c4dc2f,AIRDROP,0
airdrop-20181115-hdac-be111deb-38ce-4433-bd91-e0f70199e6be-withdrawal-exchange,2018.11.15 10:12,UNKNOWN,,UNKNOWN-55c0f2b7-dc24-425b-9be8-6b86719f2865,2018.11.15 10:12,UNKNOWN,0,100,0,HDAC,WITHDRAWAL,,,,0,COMPLETED,0,sum-user-id,1543105.23,airdrop-20181115-hdac-sum-user-id-withdrawal,accac570-de75-11e8-bd11-2f9252c4dc2f,AIRDROP,0
airdrop-20181115-hdac-be126425-48b0-46d1-b053-ee9dbb26af36-withdrawal-exchange,2018.11.15 10:12,UNKNOWN,,UNKNOWN-55c0f2b7-dc24-425b-9be8-6b86719f2865,2018.11.15 10:12,UNKNOWN,0,100,0,HDAC,WITHDRAWAL,,,,0,COMPLETED,0,sum-user-id,1543005.23,airdrop-20181115-hdac-sum-user-id-withdrawal,accac570-de75-11e8-bd11-2f9252c4dc2f,AIRDROP,0
airdrop-20181115-hdac-be265de1-829e-45fa-839a-54f33247d5c6-withdrawal-exchange,2018.11.15 10:12,UNKNOWN,,UNKNOWN-55c0f2b7-dc24-425b-9be8-6b86719f2865,2018.11.15 10:12,UNKNOWN,0,100,0,HDAC,WITHDRAWAL,,,,0,COMPLETED,0,sum-user-id,1542905.23,airdrop-20181115-hdac-sum-user-id-withdrawal,accac570-de75-11e8-bd11-2f9252c4dc2f,AIRDROP,0
airdrop-20181115-hdac-be2d53ef-d934-42e5-bc3b-843b607eeedc-withdrawal-exchange,2018.11.15 10:12,UNKNOWN,,UNKNOWN-55c0f2b7-dc24-425b-9be8-6b86719f2865,2018.11.15 10:12,UNKNOWN,0,100,0,HDAC,WITHDRAWAL,,,,0,COMPLETED,0,sum-user-id,1542805.23,airdrop-20181115-hdac-sum-user-id-withdrawal,accac570-de75-11e8-bd11-2f9252c4dc2f,AIRDROP,0
airdrop-20181115-hdac-be856fca-40c2-42b3-98af-4921e9b8096b-withdrawal-exchange,2018.11.15 10:12,UNKNOWN,,UNKNOWN-55c0f2b7-dc24-425b-9be8-6b86719f2865,2018.11.15 10:12,UNKNOWN,0,15445.16462,0,HDAC,WITHDRAWAL,,,,0,COMPLETED,0,sum-user-id,1527360.065,airdrop-20181115-hdac-sum-user-id-withdrawal,accac570-de75-11e8-bd11-2f9252c4dc2f,AIRDROP,0
airdrop-20181115-hdac-be88f69f-023c-4fbc-8051-d4ad961e8321-withdrawal-exchange,2018.11.15 10:12,UNKNOWN,,UNKNOWN-55c0f2b7-dc24-425b-9be8-6b86719f2865,2018.11.15 10:12,UNKNOWN,0,100,0,HDAC,WITHDRAWAL,,,,0,COMPLETED,0,sum-user-id,1527260.065,airdrop-20181115-hdac-sum-user-id-withdrawal,accac570-de75-11e8-bd11-2f9252c4dc2f,AIRDROP,0
airdrop-20181115-hdac-bea7d44a-5ece-443e-8873-4ea5476a0ed7-withdrawal-exchange,2018.11.15 10:12,UNKNOWN,,UNKNOWN-55c0f2b7-dc24-425b-9be8-6b86719f2865,2018.11.15 10:12,UNKNOWN,0,100,0,HDAC,WITHDRAWAL,,,,0,COMPLETED,0,sum-user-id,1527160.065,airdrop-20181115-hdac-sum-user-id-withdrawal,accac570-de75-11e8-bd11-2f9252c4dc2f,AIRDROP,0
airdrop-20181115-hdac-beca7fe7-c0b9-48bc-96e3-80b76f19bdc5-withdrawal-exchange,2018.11.15 10:12,UNKNOWN,,UNKNOWN-55c0f2b7-dc24-425b-9be8-6b86719f2865,2018.11.15 10:12,UNKNOWN,0,100,0,HDAC,WITHDRAWAL,,,,0,COMPLETED,0,sum-user-id,1527060.065,airdrop-20181115-hdac-sum-user-id-withdrawal,accac570-de75-11e8-bd11-2f9252c4dc2f,AIRDROP,0
airdrop-20181115-hdac-bed76215-b583-480e-862c-e2397545d62e-withdrawal-exchange,2018.11.15 10:12,UNKNOWN,,UNKNOWN-55c0f2b7-dc24-425b-9be8-6b86719f2865,2018.11.15 10:12,UNKNOWN,0,100,0,HDAC,WITHDRAWAL,,,,0,COMPLETED,0,sum-user-id,1526960.065,airdrop-20181115-hdac-sum-user-id-withdrawal,accac570-de75-11e8-bd11-2f9252c4dc2f,AIRDROP,0
airdrop-20181115-hdac-beee8e4c-135d-4395-b8f7-6343a4107168-withdrawal-exchange,2018.11.15 10:12,UNKNOWN,,UNKNOWN-55c0f2b7-dc24-425b-9be8-6b86719f2865,2018.11.15 10:12,UNKNOWN,0,100,0,HDAC,WITHDRAWAL,,,,0,COMPLETED,0,sum-user-id,1526860.065,airdrop-20181115-hdac-sum-user-id-withdrawal,accac570-de75-11e8-bd11-2f9252c4dc2f,AIRDROP,0
airdrop-20181115-hdac-bef4ada4-52a6-4b85-96c7-7db77630982a-withdrawal-exchange,2018.11.15 10:12,UNKNOWN,,UNKNOWN-55c0f2b7-dc24-425b-9be8-6b86719f2865,2018.11.15 10:12,UNKNOWN,0,100,0,HDAC,WITHDRAWAL,,,,0,COMPLETED,0,sum-user-id,1526760.065,airdrop-20181115-hdac-sum-user-id-withdrawal,accac570-de75-11e8-bd11-2f9252c4dc2f,AIRDROP,0
airdrop-20181115-hdac-bf0892a1-6740-4891-9ff2-ebc47caca789-withdrawal-exchange,2018.11.15 10:12,UNKNOWN,,UNKNOWN-55c0f2b7-dc24-425b-9be8-6b86719f2865,2018.11.15 10:12,UNKNOWN,0,100,0,HDAC,WITHDRAWAL,,,,0,COMPLETED,0,sum-user-id,1526660.065,airdrop-20181115-hdac-sum-user-id-withdrawal,accac570-de75-11e8-bd11-2f9252c4dc2f,AIRDROP,0
airdrop-20181115-hdac-bf1bce07-95bd-41fa-bac4-def72d2b569b-withdrawal-exchange,2018.11.15 10:12,UNKNOWN,,UNKNOWN-55c0f2b7-dc24-425b-9be8-6b86719f2865,2018.11.15 10:12,UNKNOWN,0,100,0,HDAC,WITHDRAWAL,,,,0,COMPLETED,0,sum-user-id,1526560.065,airdrop-20181115-hdac-sum-user-id-withdrawal,accac570-de75-11e8-bd11-2f9252c4dc2f,AIRDROP,0
airdrop-20181115-hdac-bf316d57-8c8c-4572-a209-f291128d4889-withdrawal-exchange,2018.11.15 10:12,UNKNOWN,,UNKNOWN-55c0f2b7-dc24-425b-9be8-6b86719f2865,2018.11.15 10:12,UNKNOWN,0,41545.17597,0,HDAC,WITHDRAWAL,,,,0,COMPLETED,0,sum-user-id,1193567.318,airdrop-20181115-hdac-sum-user-id-withdrawal,accac570-de75-11e8-bd11-2f9252c4dc2f,AIRDROP,0
airdrop-20181115-hdac-bf3eb301-2a4c-4aec-97f2-ff6bc8461735-withdrawal-exchange,2018.11.15 10:12,UNKNOWN,,UNKNOWN-55c0f2b7-dc24-425b-9be8-6b86719f2865,2018.11.15 10:12,UNKNOWN,0,100,0,HDAC,WITHDRAWAL,,,,0,COMPLETED,0,sum-user-id,1526460.065,airdrop-20181115-hdac-sum-user-id-withdrawal,accac570-de75-11e8-bd11-2f9252c4dc2f,AIRDROP,0
airdrop-20181115-hdac-bf534765-3e2d-4225-973d-cd82ab57ab1e-withdrawal-exchange,2018.11.15 10:12,UNKNOWN,,UNKNOWN-55c0f2b7-dc24-425b-9be8-6b86719f2865,2018.11.15 10:12,UNKNOWN,0,100,0,HDAC,WITHDRAWAL,,,,0,COMPLETED,0,sum-user-id,1526360.065,airdrop-20181115-hdac-sum-user-id-withdrawal,accac570-de75-11e8-bd11-2f9252c4dc2f,AIRDROP,0
airdrop-20181115-hdac-bf5f2220-b864-4839-bd3b-f4d42fbaab8b-withdrawal-exchange,2018.11.15 10:12,UNKNOWN,,UNKNOWN-55c0f2b7-dc24-425b-9be8-6b86719f2865,2018.11.15 10:12,UNKNOWN,0,100,0,HDAC,WITHDRAWAL,,,,0,COMPLETED,0,sum-user-id,1526260.065,airdrop-20181115-hdac-sum-user-id-withdrawal,accac570-de75-11e8-bd11-2f9252c4dc2f,AIRDROP,0
airdrop-20181115-hdac-bf8710a6-0de0-4e4a-b7a0-b2be2564fb00-withdrawal-exchange,2018.11.15 10:12,UNKNOWN,,UNKNOWN-55c0f2b7-dc24-425b-9be8-6b86719f2865,2018.11.15 10:12,UNKNOWN,0,100,0,HDAC,WITHDRAWAL,,,,0,COMPLETED,0,sum-user-id,1526160.065,airdrop-20181115-hdac-sum-user-id-withdrawal,accac570-de75-11e8-bd11-2f9252c4dc2f,AIRDROP,0
airdrop-20181115-hdac-bfa72ec1-2d30-4cb4-b630-a299dc733ea6-withdrawal-exchange,2018.11.15 10:12,UNKNOWN,,UNKNOWN-55c0f2b7-dc24-425b-9be8-6b86719f2865,2018.11.15 10:12,UNKNOWN,0,100,0,HDAC,WITHDRAWAL,,,,0,COMPLETED,0,sum-user-id,1526060.065,airdrop-20181115-hdac-sum-user-id-withdrawal,accac570-de75-11e8-bd11-2f9252c4dc2f,AIRDROP,0
airdrop-20181115-hdac-c00e030d-be2e-48cf-bd5d-025aa67495cd-withdrawal-exchange,2018.11.15 10:12,UNKNOWN,,UNKNOWN-55c0f2b7-dc24-425b-9be8-6b86719f2865,2018.11.15 10:12,UNKNOWN,0,100,0,HDAC,WITHDRAWAL,,,,0,COMPLETED,0,sum-user-id,1525960.065,airdrop-20181115-hdac-sum-user-id-withdrawal,accac570-de75-11e8-bd11-2f9252c4dc2f,AIRDROP,0
airdrop-20181115-hdac-c0119233-f24d-49a9-8f43-abc313bb7409-withdrawal-exchange,2018.11.15 10:12,UNKNOWN,,UNKNOWN-55c0f2b7-dc24-425b-9be8-6b86719f2865,2018.11.15 10:12,UNKNOWN,0,100,0,HDAC,WITHDRAWAL,,,,0,COMPLETED,0,sum-user-id,1525860.065,airdrop-20181115-hdac-sum-user-id-withdrawal,accac570-de75-11e8-bd11-2f9252c4dc2f,AIRDROP,0
airdrop-20181115-hdac-c02bbabe-6a71-40ae-be77-9402d3ef2706-withdrawal-exchange,2018.11.15 10:12,UNKNOWN,,UNKNOWN-55c0f2b7-dc24-425b-9be8-6b86719f2865,2018.11.15 10:12,UNKNOWN,0,100,0,HDAC,WITHDRAWAL,,,,0,COMPLETED,0,sum-user-id,1525760.065,airdrop-20181115-hdac-sum-user-id-withdrawal,accac570-de75-11e8-bd11-2f9252c4dc2f,AIRDROP,0
airdrop-20181115-hdac-c04d4aff-ecfe-4d01-90fb-1feb2141648b-withdrawal-exchange,2018.11.15 10:12,UNKNOWN,,UNKNOWN-55c0f2b7-dc24-425b-9be8-6b86719f2865,2018.11.15 10:12,UNKNOWN,0,100,0,HDAC,WITHDRAWAL,,,,0,COMPLETED,0,sum-user-id,1525660.065,airdrop-20181115-hdac-sum-user-id-withdrawal,accac570-de75-11e8-bd11-2f9252c4dc2f,AIRDROP,0
airdrop-20181115-hdac-c0544c92-deee-45ec-b908-5a0874d875ce-withdrawal-exchange,2018.11.15 10:12,UNKNOWN,,UNKNOWN-55c0f2b7-dc24-425b-9be8-6b86719f2865,2018.11.15 10:12,UNKNOWN,0,100,0,HDAC,WITHDRAWAL,,,,0,COMPLETED,0,sum-user-id,1525560.065,airdrop-20181115-hdac-sum-user-id-withdrawal,accac570-de75-11e8-bd11-2f9252c4dc2f,AIRDROP,0
airdrop-20181115-hdac-c07876ba-b07c-48f7-be92-d95727cc58e7-withdrawal-exchange,2018-11-15 10:12:07.022,UNKNOWN,,UNKNOWN-55c0f2b7-dc24-425b-9be8-6b86719f2865,2018-11-15 10:12:07.022,UNKNOWN,0,100,0,HDAC,WITHDRAWAL,,,,0,COMPLETED,0,sum-user-id,1525460.065,airdrop-20181115-hdac-sum-user-id-withdrawal,accac570-de75-11e8-bd11-2f9252c4dc2f,AIRDROP,0
airdrop-20181115-hdac-c0a00abe-2839-498e-a99e-18052c461b9e-withdrawal-exchange,2018-11-15 10:12:07.052,UNKNOWN,,UNKNOWN-55c0f2b7-dc24-425b-9be8-6b86719f2865,2018-11-15 10:12:07.052,UNKNOWN,0,100,0,HDAC,WITHDRAWAL,,,,0,COMPLETED,0,sum-user-id,1525360.065,airdrop-20181115-hdac-sum-user-id-withdrawal,accac570-de75-11e8-bd11-2f9252c4dc2f,AIRDROP,0
airdrop-20181115-hdac-c0bc4c9e-edc7-4a5a-8a65-854f6c004845-withdrawal-exchange,2018-11-15 10:12:07.084,UNKNOWN,,UNKNOWN-55c0f2b7-dc24-425b-9be8-6b86719f2865,2018-11-15 10:12:07.084,UNKNOWN,0,100,0,HDAC,WITHDRAWAL,,,,0,COMPLETED,0,sum-user-id,1525260.065,airdrop-20181115-hdac-sum-user-id-withdrawal,accac570-de75-11e8-bd11-2f9252c4dc2f,AIRDROP,0
airdrop-20181115-hdac-c0c2760c-d5d5-4249-b9d3-ede8de231535-withdrawal-exchange,2018.11.15 10:12,UNKNOWN,,UNKNOWN-55c0f2b7-dc24-425b-9be8-6b86719f2865,2018.11.15 10:12,UNKNOWN,0,100,0,HDAC,WITHDRAWAL,,,,0,COMPLETED,0,sum-user-id,1525160.065,airdrop-20181115-hdac-sum-user-id-withdrawal,accac570-de75-11e8-bd11-2f9252c4dc2f,AIRDROP,0
airdrop-20181115-hdac-c0c93736-6008-470f-a55d-a4aa64d45168-withdrawal-exchange,2018.11.15 10:12,UNKNOWN,,UNKNOWN-55c0f2b7-dc24-425b-9be8-6b86719f2865,2018.11.15 10:12,UNKNOWN,0,100,0,HDAC,WITHDRAWAL,,,,0,COMPLETED,0,sum-user-id,1525060.065,airdrop-20181115-hdac-sum-user-id-withdrawal,accac570-de75-11e8-bd11-2f9252c4dc2f,AIRDROP,0
airdrop-20181115-hdac-c0eabeb0-9052-41df-a00c-ca66865beb84-withdrawal-exchange,2018.11.15 10:12,UNKNOWN,,UNKNOWN-55c0f2b7-dc24-425b-9be8-6b86719f2865,2018.11.15 10:12,UNKNOWN,0,100,0,HDAC,WITHDRAWAL,,,,0,COMPLETED,0,sum-user-id,1524960.065,airdrop-20181115-hdac-sum-user-id-withdrawal,accac570-de75-11e8-bd11-2f9252c4dc2f,AIRDROP,0
airdrop-20181115-hdac-c0f5faa4-e4cd-42cc-b829-2f7e8ff1ebe3-withdrawal-exchange,2018.11.15 10:12,UNKNOWN,,UNKNOWN-55c0f2b7-dc24-425b-9be8-6b86719f2865,2018.11.15 10:12,UNKNOWN,0,100,0,HDAC,WITHDRAWAL,,,,0,COMPLETED,0,sum-user-id,1524860.065,airdrop-20181115-hdac-sum-user-id-withdrawal,accac570-de75-11e8-bd11-2f9252c4dc2f,AIRDROP,0
airdrop-20181115-hdac-c105c3c6-1983-49c4-8ff4-28ce67819589-withdrawal-exchange,2018.11.15 10:12,UNKNOWN,,UNKNOWN-55c0f2b7-dc24-425b-9be8-6b86719f2865,2018.11.15 10:12,UNKNOWN,0,100,0,HDAC,WITHDRAWAL,,,,0,COMPLETED,0,sum-user-id,1524760.065,airdrop-20181115-hdac-sum-user-id-withdrawal,accac570-de75-11e8-bd11-2f9252c4dc2f,AIRDROP,0
airdrop-20181115-hdac-c129cc6b-d839-4cc3-9141-2330c8c4a8e3-withdrawal-exchange,2018.11.15 10:12,UNKNOWN,,UNKNOWN-55c0f2b7-dc24-425b-9be8-6b86719f2865,2018.11.15 10:12,UNKNOWN,0,100,0,HDAC,WITHDRAWAL,,,,0,COMPLETED,0,sum-user-id,1524660.065,airdrop-20181115-hdac-sum-user-id-withdrawal,accac570-de75-11e8-bd11-2f9252c4dc2f,AIRDROP,0
airdrop-20181115-hdac-c12b5167-30ce-4e09-9a5b-5131b99d75f0-withdrawal-exchange,2018.11.15 10:12,UNKNOWN,,UNKNOWN-55c0f2b7-dc24-425b-9be8-6b86719f2865,2018.11.15 10:12,UNKNOWN,0,100,0,HDAC,WITHDRAWAL,,,,0,COMPLETED,0,sum-user-id,1524560.065,airdrop-20181115-hdac-sum-user-id-withdrawal,accac570-de75-11e8-bd11-2f9252c4dc2f,AIRDROP,0
airdrop-20181115-hdac-c130e9a1-eae7-4291-9da2-b17c8aa52435-withdrawal-exchange,2018.11.15 10:12,UNKNOWN,,UNKNOWN-55c0f2b7-dc24-425b-9be8-6b86719f2865,2018.11.15 10:12,UNKNOWN,0,100,0,HDAC,WITHDRAWAL,,,,0,COMPLETED,0,sum-user-id,1524460.065,airdrop-20181115-hdac-sum-user-id-withdrawal,accac570-de75-11e8-bd11-2f9252c4dc2f,AIRDROP,0
airdrop-20181115-hdac-c1858e78-c247-4d45-a0fe-fa9d715ee3d0-withdrawal-exchange,2018.11.15 10:12,UNKNOWN,,UNKNOWN-55c0f2b7-dc24-425b-9be8-6b86719f2865,2018.11.15 10:12,UNKNOWN,0,100,0,HDAC,WITHDRAWAL,,,,0,COMPLETED,0,sum-user-id,1524360.065,airdrop-20181115-hdac-sum-user-id-withdrawal,accac570-de75-11e8-bd11-2f9252c4dc2f,AIRDROP,0
airdrop-20181115-hdac-c1b73241-ffb9-4bea-9adc-44e7e3b0594a-withdrawal-exchange,2018.11.15 10:12,UNKNOWN,,UNKNOWN-55c0f2b7-dc24-425b-9be8-6b86719f2865,2018.11.15 10:12,UNKNOWN,0,100,0,HDAC,WITHDRAWAL,,,,0,COMPLETED,0,sum-user-id,1524260.065,airdrop-20181115-hdac-sum-user-id-withdrawal,accac570-de75-11e8-bd11-2f9252c4dc2f,AIRDROP,0
airdrop-20181115-hdac-c1c6be94-79a5-4f49-81be-7761cc16a4bb-withdrawal-exchange,2018.11.15 10:12,UNKNOWN,,UNKNOWN-55c0f2b7-dc24-425b-9be8-6b86719f2865,2018.11.15 10:12,UNKNOWN,0,100,0,HDAC,WITHDRAWAL,,,,0,COMPLETED,0,sum-user-id,1524160.065,airdrop-20181115-hdac-sum-user-id-withdrawal,accac570-de75-11e8-bd11-2f9252c4dc2f,AIRDROP,0
airdrop-20181115-hdac-c1cc8690-7f19-4670-8088-310d57d73b7f-withdrawal-exchange,2018.11.15 10:12,UNKNOWN,,UNKNOWN-55c0f2b7-dc24-425b-9be8-6b86719f2865,2018.11.15 10:12,UNKNOWN,0,100,0,HDAC,WITHDRAWAL,,,,0,COMPLETED,0,sum-user-id,1524060.065,airdrop-20181115-hdac-sum-user-id-withdrawal,accac570-de75-11e8-bd11-2f9252c4dc2f,AIRDROP,0
airdrop-20181115-hdac-c1d0e7a9-44aa-483e-958b-1f30e1d7baec-withdrawal-exchange,2018.11.15 10:12,UNKNOWN,,UNKNOWN-55c0f2b7-dc24-425b-9be8-6b86719f2865,2018.11.15 10:12,UNKNOWN,0,100,0,HDAC,WITHDRAWAL,,,,0,COMPLETED,0,sum-user-id,1523960.065,airdrop-20181115-hdac-sum-user-id-withdrawal,accac570-de75-11e8-bd11-2f9252c4dc2f,AIRDROP,0
airdrop-20181115-hdac-c1db5756-79f4-4812-b1c9-834771f6e93a-withdrawal-exchange,2018.11.15 10:12,UNKNOWN,,UNKNOWN-55c0f2b7-dc24-425b-9be8-6b86719f2865,2018.11.15 10:12,UNKNOWN,0,100,0,HDAC,WITHDRAWAL,,,,0,COMPLETED,0,sum-user-id,1523860.065,airdrop-20181115-hdac-sum-user-id-withdrawal,accac570-de75-11e8-bd11-2f9252c4dc2f,AIRDROP,0
airdrop-20181115-hdac-c1e49abb-b6f2-4e6c-989e-9ce19c6136a3-withdrawal-exchange,2018.11.15 10:12,UNKNOWN,,UNKNOWN-55c0f2b7-dc24-425b-9be8-6b86719f2865,2018.11.15 10:12,UNKNOWN,0,100,0,HDAC,WITHDRAWAL,,,,0,COMPLETED,0,sum-user-id,1523760.065,airdrop-20181115-hdac-sum-user-id-withdrawal,accac570-de75-11e8-bd11-2f9252c4dc2f,AIRDROP,0
airdrop-20181115-hdac-c1effa46-056d-4f56-9486-a0fba99ec8c9-withdrawal-exchange,2018.11.15 10:12,UNKNOWN,,UNKNOWN-55c0f2b7-dc24-425b-9be8-6b86719f2865,2018.11.15 10:12,UNKNOWN,0,100,0,HDAC,WITHDRAWAL,,,,0,COMPLETED,0,sum-user-id,1523660.065,airdrop-20181115-hdac-sum-user-id-withdrawal,accac570-de75-11e8-bd11-2f9252c4dc2f,AIRDROP,0
airdrop-20181115-hdac-c1f7d0c7-4ecb-4f1f-a508-8de7d3a67242-withdrawal-exchange,2018.11.15 10:12,UNKNOWN,,UNKNOWN-55c0f2b7-dc24-425b-9be8-6b86719f2865,2018.11.15 10:12,UNKNOWN,0,100,0,HDAC,WITHDRAWAL,,,,0,COMPLETED,0,sum-user-id,1523560.065,airdrop-20181115-hdac-sum-user-id-withdrawal,accac570-de75-11e8-bd11-2f9252c4dc2f,AIRDROP,0
airdrop-20181115-hdac-c200d539-2de5-44a9-b169-de8cc78084ed-withdrawal-exchange,2018.11.15 10:12,UNKNOWN,,UNKNOWN-55c0f2b7-dc24-425b-9be8-6b86719f2865,2018.11.15 10:12,UNKNOWN,0,100,0,HDAC,WITHDRAWAL,,,,0,COMPLETED,0,sum-user-id,1523460.065,airdrop-20181115-hdac-sum-user-id-withdrawal,accac570-de75-11e8-bd11-2f9252c4dc2f,AIRDROP,0
airdrop-20181115-hdac-c20761bf-d8c9-42e5-9580-49f2b4960d02-withdrawal-exchange,2018.11.15 10:12,UNKNOWN,,UNKNOWN-55c0f2b7-dc24-425b-9be8-6b86719f2865,2018.11.15 10:12,UNKNOWN,0,100,0,HDAC,WITHDRAWAL,,,,0,COMPLETED,0,sum-user-id,1523360.065,airdrop-20181115-hdac-sum-user-id-withdrawal,accac570-de75-11e8-bd11-2f9252c4dc2f,AIRDROP,0
airdrop-20181115-hdac-c20d2a1c-6d5a-4fd2-9df6-e6aafc5dff84-withdrawal-exchange,2018.11.15 10:12,UNKNOWN,,UNKNOWN-55c0f2b7-dc24-425b-9be8-6b86719f2865,2018.11.15 10:12,UNKNOWN,0,100,0,HDAC,WITHDRAWAL,,,,0,COMPLETED,0,sum-user-id,1523260.065,airdrop-20181115-hdac-sum-user-id-withdrawal,accac570-de75-11e8-bd11-2f9252c4dc2f,AIRDROP,0
airdrop-20181115-hdac-c2169bf2-f92e-44db-9c0c-60a1b2dae84b-withdrawal-exchange,2018.11.15 10:12,UNKNOWN,,UNKNOWN-55c0f2b7-dc24-425b-9be8-6b86719f2865,2018.11.15 10:12,UNKNOWN,0,100,0,HDAC,WITHDRAWAL,,,,0,COMPLETED,0,sum-user-id,1523160.065,airdrop-20181115-hdac-sum-user-id-withdrawal,accac570-de75-11e8-bd11-2f9252c4dc2f,AIRDROP,0
airdrop-20181115-hdac-c2186498-6e83-4b55-9c00-c167f2951d11-withdrawal-exchange,2018.11.15 10:12,UNKNOWN,,UNKNOWN-55c0f2b7-dc24-425b-9be8-6b86719f2865,2018.11.15 10:12,UNKNOWN,0,100,0,HDAC,WITHDRAWAL,,,,0,COMPLETED,0,sum-user-id,1523060.065,airdrop-20181115-hdac-sum-user-id-withdrawal,accac570-de75-11e8-bd11-2f9252c4dc2f,AIRDROP,0
airdrop-20181115-hdac-c240995c-bf24-4096-8d29-6c9badc8923a-withdrawal-exchange,2018.11.15 10:12,UNKNOWN,,UNKNOWN-55c0f2b7-dc24-425b-9be8-6b86719f2865,2018.11.15 10:12,UNKNOWN,0,100,0,HDAC,WITHDRAWAL,,,,0,COMPLETED,0,sum-user-id,1522960.065,airdrop-20181115-hdac-sum-user-id-withdrawal,accac570-de75-11e8-bd11-2f9252c4dc2f,AIRDROP,0
airdrop-20181115-hdac-c2b452e9-98d2-43d0-81e2-580b32eecd1d-withdrawal-exchange,2018.11.15 10:12,UNKNOWN,,UNKNOWN-55c0f2b7-dc24-425b-9be8-6b86719f2865,2018.11.15 10:12,UNKNOWN,0,100,0,HDAC,WITHDRAWAL,,,,0,COMPLETED,0,sum-user-id,1522860.065,airdrop-20181115-hdac-sum-user-id-withdrawal,accac570-de75-11e8-bd11-2f9252c4dc2f,AIRDROP,0
airdrop-20181115-hdac-c2ba7a68-8ea0-4c47-b0e6-ea3070f2403f-withdrawal-exchange,2018.11.15 10:12,UNKNOWN,,UNKNOWN-55c0f2b7-dc24-425b-9be8-6b86719f2865,2018.11.15 10:12,UNKNOWN,0,100,0,HDAC,WITHDRAWAL,,,,0,COMPLETED,0,sum-user-id,1522760.065,airdrop-20181115-hdac-sum-user-id-withdrawal,accac570-de75-11e8-bd11-2f9252c4dc2f,AIRDROP,0
airdrop-20181115-hdac-c2dcef59-de2e-440f-83ca-8de4180a28c3-withdrawal-exchange,2018.11.15 10:12,UNKNOWN,,UNKNOWN-55c0f2b7-dc24-425b-9be8-6b86719f2865,2018.11.15 10:12,UNKNOWN,0,100,0,HDAC,WITHDRAWAL,,,,0,COMPLETED,0,sum-user-id,1522660.065,airdrop-20181115-hdac-sum-user-id-withdrawal,accac570-de75-11e8-bd11-2f9252c4dc2f,AIRDROP,0
airdrop-20181115-hdac-c2f725e9-ea21-4dc4-b4c6-acb71a169fb3-withdrawal-exchange,2018.11.15 10:12,UNKNOWN,,UNKNOWN-55c0f2b7-dc24-425b-9be8-6b86719f2865,2018.11.15 10:12,UNKNOWN,0,100,0,HDAC,WITHDRAWAL,,,,0,COMPLETED,0,sum-user-id,1522560.065,airdrop-20181115-hdac-sum-user-id-withdrawal,accac570-de75-11e8-bd11-2f9252c4dc2f,AIRDROP,0
airdrop-20181115-hdac-c2fb2ca3-102b-4973-b390-03f53b1e9c32-withdrawal-exchange,2018.11.15 10:12,UNKNOWN,,UNKNOWN-55c0f2b7-dc24-425b-9be8-6b86719f2865,2018.11.15 10:12,UNKNOWN,0,100,0,HDAC,WITHDRAWAL,,,,0,COMPLETED,0,sum-user-id,1522460.065,airdrop-20181115-hdac-sum-user-id-withdrawal,accac570-de75-11e8-bd11-2f9252c4dc2f,AIRDROP,0
airdrop-20181115-hdac-c3313ef9-39b7-474d-bb94-e83f3a4650cd-withdrawal-exchange,2018.11.15 10:12,UNKNOWN,,UNKNOWN-55c0f2b7-dc24-425b-9be8-6b86719f2865,2018.11.15 10:12,UNKNOWN,0,100,0,HDAC,WITHDRAWAL,,,,0,COMPLETED,0,sum-user-id,1522360.065,airdrop-20181115-hdac-sum-user-id-withdrawal,accac570-de75-11e8-bd11-2f9252c4dc2f,AIRDROP,0
airdrop-20181115-hdac-c33e92ed-98e6-4fa5-b2ac-1e632482a772-withdrawal-exchange,2018-11-15 10:12:08.028,UNKNOWN,,UNKNOWN-55c0f2b7-dc24-425b-9be8-6b86719f2865,2018-11-15 10:12:08.028,UNKNOWN,0,100,0,HDAC,WITHDRAWAL,,,,0,COMPLETED,0,sum-user-id,1522260.065,airdrop-20181115-hdac-sum-user-id-withdrawal,accac570-de75-11e8-bd11-2f9252c4dc2f,AIRDROP,0
airdrop-20181115-hdac-c34d3e3b-0bfd-42a1-9512-c7390d1cea57-withdrawal-exchange,2018-11-15 10:12:08.061,UNKNOWN,,UNKNOWN-55c0f2b7-dc24-425b-9be8-6b86719f2865,2018-11-15 10:12:08.061,UNKNOWN,0,100,0,HDAC,WITHDRAWAL,,,,0,COMPLETED,0,sum-user-id,1522160.065,airdrop-20181115-hdac-sum-user-id-withdrawal,accac570-de75-11e8-bd11-2f9252c4dc2f,AIRDROP,0
airdrop-20181115-hdac-c38485ef-9ba8-4902-9639-b487f6bc30a9-withdrawal-exchange,2018-11-15 10:12:08.093,UNKNOWN,,UNKNOWN-55c0f2b7-dc24-425b-9be8-6b86719f2865,2018-11-15 10:12:08.093,UNKNOWN,0,100,0,HDAC,WITHDRAWAL,,,,0,COMPLETED,0,sum-user-id,1522060.065,airdrop-20181115-hdac-sum-user-id-withdrawal,accac570-de75-11e8-bd11-2f9252c4dc2f,AIRDROP,0
airdrop-20181115-hdac-c3a2c009-4d71-4200-8bc7-0f386bd5de88-withdrawal-exchange,2018.11.15 10:12,UNKNOWN,,UNKNOWN-55c0f2b7-dc24-425b-9be8-6b86719f2865,2018.11.15 10:12,UNKNOWN,0,100,0,HDAC,WITHDRAWAL,,,,0,COMPLETED,0,sum-user-id,1521960.065,airdrop-20181115-hdac-sum-user-id-withdrawal,accac570-de75-11e8-bd11-2f9252c4dc2f,AIRDROP,0
airdrop-20181115-hdac-c3af97b3-e14b-4da7-89b1-7cf7333cec61-withdrawal-exchange,2018.11.15 10:12,UNKNOWN,,UNKNOWN-55c0f2b7-dc24-425b-9be8-6b86719f2865,2018.11.15 10:12,UNKNOWN,0,100,0,HDAC,WITHDRAWAL,,,,0,COMPLETED,0,sum-user-id,1521860.065,airdrop-20181115-hdac-sum-user-id-withdrawal,accac570-de75-11e8-bd11-2f9252c4dc2f,AIRDROP,0
airdrop-20181115-hdac-c3bbbd2f-9bf5-48b1-a965-aa0472850cc9-withdrawal-exchange,2018.11.15 10:12,UNKNOWN,,UNKNOWN-55c0f2b7-dc24-425b-9be8-6b86719f2865,2018.11.15 10:12,UNKNOWN,0,100,0,HDAC,WITHDRAWAL,,,,0,COMPLETED,0,sum-user-id,1521760.065,airdrop-20181115-hdac-sum-user-id-withdrawal,accac570-de75-11e8-bd11-2f9252c4dc2f,AIRDROP,0
airdrop-20181115-hdac-c3c75696-2241-4daf-8f18-a544d931eb57-withdrawal-exchange,2018.11.15 10:12,UNKNOWN,,UNKNOWN-55c0f2b7-dc24-425b-9be8-6b86719f2865,2018.11.15 10:12,UNKNOWN,0,100,0,HDAC,WITHDRAWAL,,,,0,COMPLETED,0,sum-user-id,1521660.065,airdrop-20181115-hdac-sum-user-id-withdrawal,accac570-de75-11e8-bd11-2f9252c4dc2f,AIRDROP,0
airdrop-20181115-hdac-c3f14fe7-8385-4e57-8d0a-d4e476bac523-withdrawal-exchange,2018.11.15 10:12,UNKNOWN,,UNKNOWN-55c0f2b7-dc24-425b-9be8-6b86719f2865,2018.11.15 10:12,UNKNOWN,0,100,0,HDAC,WITHDRAWAL,,,,0,COMPLETED,0,sum-user-id,1521560.065,airdrop-20181115-hdac-sum-user-id-withdrawal,accac570-de75-11e8-bd11-2f9252c4dc2f,AIRDROP,0
airdrop-20181115-hdac-c3f9ad15-5fd0-488b-a857-7e3b8a056db7-withdrawal-exchange,2018.11.15 10:12,UNKNOWN,,UNKNOWN-55c0f2b7-dc24-425b-9be8-6b86719f2865,2018.11.15 10:12,UNKNOWN,0,100,0,HDAC,WITHDRAWAL,,,,0,COMPLETED,0,sum-user-id,1521460.065,airdrop-20181115-hdac-sum-user-id-withdrawal,accac570-de75-11e8-bd11-2f9252c4dc2f,AIRDROP,0
airdrop-20181115-hdac-c3ffb613-6594-44d0-86c6-a06dd467b2bc-withdrawal-exchange,2018.11.15 10:12,UNKNOWN,,UNKNOWN-55c0f2b7-dc24-425b-9be8-6b86719f2865,2018.11.15 10:12,UNKNOWN,0,100,0,HDAC,WITHDRAWAL,,,,0,COMPLETED,0,sum-user-id,1521360.065,airdrop-20181115-hdac-sum-user-id-withdrawal,accac570-de75-11e8-bd11-2f9252c4dc2f,AIRDROP,0
airdrop-20181115-hdac-c41745e8-555b-499c-8812-72ad0b4e67ba-withdrawal-exchange,2018.11.15 10:12,UNKNOWN,,UNKNOWN-55c0f2b7-dc24-425b-9be8-6b86719f2865,2018.11.15 10:12,UNKNOWN,0,100,0,HDAC,WITHDRAWAL,,,,0,COMPLETED,0,sum-user-id,1521260.065,airdrop-20181115-hdac-sum-user-id-withdrawal,accac570-de75-11e8-bd11-2f9252c4dc2f,AIRDROP,0
airdrop-20181115-hdac-c41769d2-4a32-4144-9099-b54c19b7f005-withdrawal-exchange,2018.11.15 10:12,UNKNOWN,,UNKNOWN-55c0f2b7-dc24-425b-9be8-6b86719f2865,2018.11.15 10:12,UNKNOWN,0,100,0,HDAC,WITHDRAWAL,,,,0,COMPLETED,0,sum-user-id,1521160.065,airdrop-20181115-hdac-sum-user-id-withdrawal,accac570-de75-11e8-bd11-2f9252c4dc2f,AIRDROP,0
airdrop-20181115-hdac-c41909f2-bce0-4b73-a02d-b9c036425cf5-withdrawal-exchange,2018.11.15 10:12,UNKNOWN,,UNKNOWN-55c0f2b7-dc24-425b-9be8-6b86719f2865,2018.11.15 10:12,UNKNOWN,0,100,0,HDAC,WITHDRAWAL,,,,0,COMPLETED,0,sum-user-id,1521060.065,airdrop-20181115-hdac-sum-user-id-withdrawal,accac570-de75-11e8-bd11-2f9252c4dc2f,AIRDROP,0
airdrop-20181115-hdac-c4511b8f-13c5-4e82-8b58-afb1c9e9d611-withdrawal-exchange,2018.11.15 10:12,UNKNOWN,,UNKNOWN-55c0f2b7-dc24-425b-9be8-6b86719f2865,2018.11.15 10:12,UNKNOWN,0,100,0,HDAC,WITHDRAWAL,,,,0,COMPLETED,0,sum-user-id,1520960.065,airdrop-20181115-hdac-sum-user-id-withdrawal,accac570-de75-11e8-bd11-2f9252c4dc2f,AIRDROP,0
airdrop-20181115-hdac-c4573ca5-c7a9-44d3-90ee-34d2aab1a1d7-withdrawal-exchange,2018.11.15 10:12,UNKNOWN,,UNKNOWN-55c0f2b7-dc24-425b-9be8-6b86719f2865,2018.11.15 10:12,UNKNOWN,0,100,0,HDAC,WITHDRAWAL,,,,0,COMPLETED,0,sum-user-id,1520860.065,airdrop-20181115-hdac-sum-user-id-withdrawal,accac570-de75-11e8-bd11-2f9252c4dc2f,AIRDROP,0
airdrop-20181115-hdac-c46e1940-6c0d-4699-8070-b6e71887ce3c-withdrawal-exchange,2018.11.15 10:12,UNKNOWN,,UNKNOWN-55c0f2b7-dc24-425b-9be8-6b86719f2865,2018.11.15 10:12,UNKNOWN,0,100,0,HDAC,WITHDRAWAL,,,,0,COMPLETED,0,sum-user-id,1520760.065,airdrop-20181115-hdac-sum-user-id-withdrawal,accac570-de75-11e8-bd11-2f9252c4dc2f,AIRDROP,0
airdrop-20181115-hdac-c4842239-3ef1-4c39-8ed2-36f23df5147a-withdrawal-exchange,2018.11.15 10:12,UNKNOWN,,UNKNOWN-55c0f2b7-dc24-425b-9be8-6b86719f2865,2018.11.15 10:12,UNKNOWN,0,100,0,HDAC,WITHDRAWAL,,,,0,COMPLETED,0,sum-user-id,1520660.065,airdrop-20181115-hdac-sum-user-id-withdrawal,accac570-de75-11e8-bd11-2f9252c4dc2f,AIRDROP,0
airdrop-20181115-hdac-c48b017e-2c0c-499d-a06b-5add23c22968-withdrawal-exchange,2018.11.15 10:12,UNKNOWN,,UNKNOWN-55c0f2b7-dc24-425b-9be8-6b86719f2865,2018.11.15 10:12,UNKNOWN,0,100,0,HDAC,WITHDRAWAL,,,,0,COMPLETED,0,sum-user-id,1520560.065,airdrop-20181115-hdac-sum-user-id-withdrawal,accac570-de75-11e8-bd11-2f9252c4dc2f,AIRDROP,0
airdrop-20181115-hdac-c4b80636-e6b6-426e-bd0f-28fbd2a459b7-withdrawal-exchange,2018.11.15 10:12,UNKNOWN,,UNKNOWN-55c0f2b7-dc24-425b-9be8-6b86719f2865,2018.11.15 10:12,UNKNOWN,0,100,0,HDAC,WITHDRAWAL,,,,0,COMPLETED,0,sum-user-id,1520460.065,airdrop-20181115-hdac-sum-user-id-withdrawal,accac570-de75-11e8-bd11-2f9252c4dc2f,AIRDROP,0
airdrop-20181115-hdac-c4b84a1f-0a43-4489-b143-def2839954c3-withdrawal-exchange,2018.11.15 10:12,UNKNOWN,,UNKNOWN-55c0f2b7-dc24-425b-9be8-6b86719f2865,2018.11.15 10:12,UNKNOWN,0,100,0,HDAC,WITHDRAWAL,,,,0,COMPLETED,0,sum-user-id,1520360.065,airdrop-20181115-hdac-sum-user-id-withdrawal,accac570-de75-11e8-bd11-2f9252c4dc2f,AIRDROP,0
airdrop-20181115-hdac-c4c103c4-d078-4f41-8494-58b036205611-withdrawal-exchange,2018.11.15 10:12,UNKNOWN,,UNKNOWN-55c0f2b7-dc24-425b-9be8-6b86719f2865,2018.11.15 10:12,UNKNOWN,0,100,0,HDAC,WITHDRAWAL,,,,0,COMPLETED,0,sum-user-id,1520260.065,airdrop-20181115-hdac-sum-user-id-withdrawal,accac570-de75-11e8-bd11-2f9252c4dc2f,AIRDROP,0
airdrop-20181115-hdac-c4c59af1-6dcc-4d25-a844-17dc99a14452-withdrawal-exchange,2018.11.15 10:12,UNKNOWN,,UNKNOWN-55c0f2b7-dc24-425b-9be8-6b86719f2865,2018.11.15 10:12,UNKNOWN,0,100,0,HDAC,WITHDRAWAL,,,,0,COMPLETED,0,sum-user-id,1520160.065,airdrop-20181115-hdac-sum-user-id-withdrawal,accac570-de75-11e8-bd11-2f9252c4dc2f,AIRDROP,0
airdrop-20181115-hdac-c4d57347-640c-477f-8ee2-3d831fd322cb-withdrawal-exchange,2018.11.15 10:12,UNKNOWN,,UNKNOWN-55c0f2b7-dc24-425b-9be8-6b86719f2865,2018.11.15 10:12,UNKNOWN,0,100,0,HDAC,WITHDRAWAL,,,,0,COMPLETED,0,sum-user-id,1520060.065,airdrop-20181115-hdac-sum-user-id-withdrawal,accac570-de75-11e8-bd11-2f9252c4dc2f,AIRDROP,0
airdrop-20181115-hdac-c51e4164-8ce6-4c40-af5e-fd4b4859c6d4-withdrawal-exchange,2018.11.15 10:12,UNKNOWN,,UNKNOWN-55c0f2b7-dc24-425b-9be8-6b86719f2865,2018.11.15 10:12,UNKNOWN,0,100,0,HDAC,WITHDRAWAL,,,,0,COMPLETED,0,sum-user-id,1519960.065,airdrop-20181115-hdac-sum-user-id-withdrawal,accac570-de75-11e8-bd11-2f9252c4dc2f,AIRDROP,0
airdrop-20181115-hdac-c54cca2b-7bf5-44c0-9047-e7d90be705c1-withdrawal-exchange,2018.11.15 10:12,UNKNOWN,,UNKNOWN-55c0f2b7-dc24-425b-9be8-6b86719f2865,2018.11.15 10:12,UNKNOWN,0,100,0,HDAC,WITHDRAWAL,,,,0,COMPLETED,0,sum-user-id,1519860.065,airdrop-20181115-hdac-sum-user-id-withdrawal,accac570-de75-11e8-bd11-2f9252c4dc2f,AIRDROP,0
airdrop-20181115-hdac-c55eedbd-c859-4cda-9836-8fd84d6285bb-withdrawal-exchange,2018.11.15 10:12,UNKNOWN,,UNKNOWN-55c0f2b7-dc24-425b-9be8-6b86719f2865,2018.11.15 10:12,UNKNOWN,0,100,0,HDAC,WITHDRAWAL,,,,0,COMPLETED,0,sum-user-id,1519760.065,airdrop-20181115-hdac-sum-user-id-withdrawal,accac570-de75-11e8-bd11-2f9252c4dc2f,AIRDROP,0
airdrop-20181115-hdac-c565d2de-bf1d-457e-9e4d-8cf5a9eb6ace-withdrawal-exchange,2018.11.15 10:12,UNKNOWN,,UNKNOWN-55c0f2b7-dc24-425b-9be8-6b86719f2865,2018.11.15 10:12,UNKNOWN,0,100,0,HDAC,WITHDRAWAL,,,,0,COMPLETED,0,sum-user-id,1519660.065,airdrop-20181115-hdac-sum-user-id-withdrawal,accac570-de75-11e8-bd11-2f9252c4dc2f,AIRDROP,0
airdrop-20181115-hdac-c5743cae-3bd9-4e26-8dec-c4434fadc7e4-withdrawal-exchange,2018.11.15 10:12,UNKNOWN,,UNKNOWN-55c0f2b7-dc24-425b-9be8-6b86719f2865,2018.11.15 10:12,UNKNOWN,0,100,0,HDAC,WITHDRAWAL,,,,0,COMPLETED,0,sum-user-id,1519560.065,airdrop-20181115-hdac-sum-user-id-withdrawal,accac570-de75-11e8-bd11-2f9252c4dc2f,AIRDROP,0
airdrop-20181115-hdac-c599291b-69ee-45c8-8dd3-a8d389b2f43a-withdrawal-exchange,2018.11.15 10:12,UNKNOWN,,UNKNOWN-55c0f2b7-dc24-425b-9be8-6b86719f2865,2018.11.15 10:12,UNKNOWN,0,100,0,HDAC,WITHDRAWAL,,,,0,COMPLETED,0,sum-user-id,1519460.065,airdrop-20181115-hdac-sum-user-id-withdrawal,accac570-de75-11e8-bd11-2f9252c4dc2f,AIRDROP,0
airdrop-20181115-hdac-c5a98572-b467-43ff-90e4-1c6d54b5a503-withdrawal-exchange,2018.11.15 10:12,UNKNOWN,,UNKNOWN-55c0f2b7-dc24-425b-9be8-6b86719f2865,2018.11.15 10:12,UNKNOWN,0,100,0,HDAC,WITHDRAWAL,,,,0,COMPLETED,0,sum-user-id,1519360.065,airdrop-20181115-hdac-sum-user-id-withdrawal,accac570-de75-11e8-bd11-2f9252c4dc2f,AIRDROP,0
airdrop-20181115-hdac-c5ba0545-661d-493e-bd6b-e2f641ff15ca-withdrawal-exchange,2018.11.15 10:12,UNKNOWN,,UNKNOWN-55c0f2b7-dc24-425b-9be8-6b86719f2865,2018.11.15 10:12,UNKNOWN,0,100,0,HDAC,WITHDRAWAL,,,,0,COMPLETED,0,sum-user-id,1519260.065,airdrop-20181115-hdac-sum-user-id-withdrawal,accac570-de75-11e8-bd11-2f9252c4dc2f,AIRDROP,0
airdrop-20181115-hdac-c5c3d5ae-4802-4cab-a466-0f6f7f46d049-withdrawal-exchange,2018-11-15 10:12:09.001,UNKNOWN,,UNKNOWN-55c0f2b7-dc24-425b-9be8-6b86719f2865,2018-11-15 10:12:09.001,UNKNOWN,0,100,0,HDAC,WITHDRAWAL,,,,0,COMPLETED,0,sum-user-id,1519160.065,airdrop-20181115-hdac-sum-user-id-withdrawal,accac570-de75-11e8-bd11-2f9252c4dc2f,AIRDROP,0
airdrop-20181115-hdac-c5d27bda-11f0-40db-a2f2-62ebb93407c5-withdrawal-exchange,2018-11-15 10:12:09.033,UNKNOWN,,UNKNOWN-55c0f2b7-dc24-425b-9be8-6b86719f2865,2018-11-15 10:12:09.033,UNKNOWN,0,100,0,HDAC,WITHDRAWAL,,,,0,COMPLETED,0,sum-user-id,1519060.065,airdrop-20181115-hdac-sum-user-id-withdrawal,accac570-de75-11e8-bd11-2f9252c4dc2f,AIRDROP,0
airdrop-20181115-hdac-c5def5ae-9374-4e8b-bbcd-95427552398c-withdrawal-exchange,2018-11-15 10:12:09.062,UNKNOWN,,UNKNOWN-55c0f2b7-dc24-425b-9be8-6b86719f2865,2018-11-15 10:12:09.062,UNKNOWN,0,100,0,HDAC,WITHDRAWAL,,,,0,COMPLETED,0,sum-user-id,1518960.065,airdrop-20181115-hdac-sum-user-id-withdrawal,accac570-de75-11e8-bd11-2f9252c4dc2f,AIRDROP,0
airdrop-20181115-hdac-c5fa0c1a-a211-4024-b767-564b79f3a831-withdrawal-exchange,2018-11-15 10:12:09.094,UNKNOWN,,UNKNOWN-55c0f2b7-dc24-425b-9be8-6b86719f2865,2018-11-15 10:12:09.094,UNKNOWN,0,100,0,HDAC,WITHDRAWAL,,,,0,COMPLETED,0,sum-user-id,1518860.065,airdrop-20181115-hdac-sum-user-id-withdrawal,accac570-de75-11e8-bd11-2f9252c4dc2f,AIRDROP,0
airdrop-20181115-hdac-c609896a-442b-4548-a177-7fa77e3ba6dd-withdrawal-exchange,2018.11.15 10:12,UNKNOWN,,UNKNOWN-55c0f2b7-dc24-425b-9be8-6b86719f2865,2018.11.15 10:12,UNKNOWN,0,100,0,HDAC,WITHDRAWAL,,,,0,COMPLETED,0,sum-user-id,1518760.065,airdrop-20181115-hdac-sum-user-id-withdrawal,accac570-de75-11e8-bd11-2f9252c4dc2f,AIRDROP,0
airdrop-20181115-hdac-c68102fe-3f6d-4a9e-8c01-d382e5c691ed-withdrawal-exchange,2018.11.15 10:12,UNKNOWN,,UNKNOWN-55c0f2b7-dc24-425b-9be8-6b86719f2865,2018.11.15 10:12,UNKNOWN,0,100,0,HDAC,WITHDRAWAL,,,,0,COMPLETED,0,sum-user-id,1518660.065,airdrop-20181115-hdac-sum-user-id-withdrawal,accac570-de75-11e8-bd11-2f9252c4dc2f,AIRDROP,0
airdrop-20181115-hdac-c6aef203-1154-4819-878b-5bf515fddc5f-withdrawal-exchange,2018.11.15 10:12,UNKNOWN,,UNKNOWN-55c0f2b7-dc24-425b-9be8-6b86719f2865,2018.11.15 10:12,UNKNOWN,0,100,0,HDAC,WITHDRAWAL,,,,0,COMPLETED,0,sum-user-id,1518560.065,airdrop-20181115-hdac-sum-user-id-withdrawal,accac570-de75-11e8-bd11-2f9252c4dc2f,AIRDROP,0
airdrop-20181115-hdac-c6bc654d-798a-425d-bf0c-8f7a1a1dc2df-withdrawal-exchange,2018.11.15 10:12,UNKNOWN,,UNKNOWN-55c0f2b7-dc24-425b-9be8-6b86719f2865,2018.11.15 10:12,UNKNOWN,0,100,0,HDAC,WITHDRAWAL,,,,0,COMPLETED,0,sum-user-id,1518460.065,airdrop-20181115-hdac-sum-user-id-withdrawal,accac570-de75-11e8-bd11-2f9252c4dc2f,AIRDROP,0
airdrop-20181115-hdac-c6cad252-34b7-4cca-8304-f11f95975160-withdrawal-exchange,2018.11.15 10:12,UNKNOWN,,UNKNOWN-55c0f2b7-dc24-425b-9be8-6b86719f2865,2018.11.15 10:12,UNKNOWN,0,100,0,HDAC,WITHDRAWAL,,,,0,COMPLETED,0,sum-user-id,1518360.065,airdrop-20181115-hdac-sum-user-id-withdrawal,accac570-de75-11e8-bd11-2f9252c4dc2f,AIRDROP,0
airdrop-20181115-hdac-c6d798f3-6605-4d81-9d9f-1ad886934d75-withdrawal-exchange,2018.11.15 10:12,UNKNOWN,,UNKNOWN-55c0f2b7-dc24-425b-9be8-6b86719f2865,2018.11.15 10:12,UNKNOWN,0,100,0,HDAC,WITHDRAWAL,,,,0,COMPLETED,0,sum-user-id,1518260.065,airdrop-20181115-hdac-sum-user-id-withdrawal,accac570-de75-11e8-bd11-2f9252c4dc2f,AIRDROP,0
airdrop-20181115-hdac-c6de5648-22e5-480e-92f0-22cd90bdc6d9-withdrawal-exchange,2018.11.15 10:12,UNKNOWN,,UNKNOWN-55c0f2b7-dc24-425b-9be8-6b86719f2865,2018.11.15 10:12,UNKNOWN,0,100,0,HDAC,WITHDRAWAL,,,,0,COMPLETED,0,sum-user-id,1518160.065,airdrop-20181115-hdac-sum-user-id-withdrawal,accac570-de75-11e8-bd11-2f9252c4dc2f,AIRDROP,0
airdrop-20181115-hdac-c6e64efc-57ca-4f70-885a-bae742138679-withdrawal-exchange,2018.11.15 10:12,UNKNOWN,,UNKNOWN-55c0f2b7-dc24-425b-9be8-6b86719f2865,2018.11.15 10:12,UNKNOWN,0,100,0,HDAC,WITHDRAWAL,,,,0,COMPLETED,0,sum-user-id,1518060.065,airdrop-20181115-hdac-sum-user-id-withdrawal,accac570-de75-11e8-bd11-2f9252c4dc2f,AIRDROP,0
airdrop-20181115-hdac-c6eb3999-4292-4c86-8fb3-6e03e6a2478c-withdrawal-exchange,2018.11.15 10:12,UNKNOWN,,UNKNOWN-55c0f2b7-dc24-425b-9be8-6b86719f2865,2018.11.15 10:12,UNKNOWN,0,100,0,HDAC,WITHDRAWAL,,,,0,COMPLETED,0,sum-user-id,1517960.065,airdrop-20181115-hdac-sum-user-id-withdrawal,accac570-de75-11e8-bd11-2f9252c4dc2f,AIRDROP,0
airdrop-20181115-hdac-c700f6d9-0782-4e5d-a940-b2b47fbc3f18-withdrawal-exchange,2018.11.15 10:12,UNKNOWN,,UNKNOWN-55c0f2b7-dc24-425b-9be8-6b86719f2865,2018.11.15 10:12,UNKNOWN,0,100,0,HDAC,WITHDRAWAL,,,,0,COMPLETED,0,sum-user-id,1517860.065,airdrop-20181115-hdac-sum-user-id-withdrawal,accac570-de75-11e8-bd11-2f9252c4dc2f,AIRDROP,0
airdrop-20181115-hdac-c71f9aad-2292-47bb-b9c6-2b7124809bd4-withdrawal-exchange,2018.11.15 10:12,UNKNOWN,,UNKNOWN-55c0f2b7-dc24-425b-9be8-6b86719f2865,2018.11.15 10:12,UNKNOWN,0,100,0,HDAC,WITHDRAWAL,,,,0,COMPLETED,0,sum-user-id,1517760.065,airdrop-20181115-hdac-sum-user-id-withdrawal,accac570-de75-11e8-bd11-2f9252c4dc2f,AIRDROP,0
airdrop-20181115-hdac-c722157d-4c9c-4f9b-8c15-0e2b3e94c3da-withdrawal-exchange,2018.11.15 10:12,UNKNOWN,,UNKNOWN-55c0f2b7-dc24-425b-9be8-6b86719f2865,2018.11.15 10:12,UNKNOWN,0,100,0,HDAC,WITHDRAWAL,,,,0,COMPLETED,0,sum-user-id,1517660.065,airdrop-20181115-hdac-sum-user-id-withdrawal,accac570-de75-11e8-bd11-2f9252c4dc2f,AIRDROP,0
airdrop-20181115-hdac-c73bd4a0-03ac-4f2b-87dc-19ee8af02d2f-withdrawal-exchange,2018.11.15 10:12,UNKNOWN,,UNKNOWN-55c0f2b7-dc24-425b-9be8-6b86719f2865,2018.11.15 10:12,UNKNOWN,0,100,0,HDAC,WITHDRAWAL,,,,0,COMPLETED,0,sum-user-id,1517560.065,airdrop-20181115-hdac-sum-user-id-withdrawal,accac570-de75-11e8-bd11-2f9252c4dc2f,AIRDROP,0
airdrop-20181115-hdac-c75c6c58-7253-494a-8cc0-58ae800e1ef2-withdrawal-exchange,2018.11.15 10:12,UNKNOWN,,UNKNOWN-55c0f2b7-dc24-425b-9be8-6b86719f2865,2018.11.15 10:12,UNKNOWN,0,100,0,HDAC,WITHDRAWAL,,,,0,COMPLETED,0,sum-user-id,1517460.065,airdrop-20181115-hdac-sum-user-id-withdrawal,accac570-de75-11e8-bd11-2f9252c4dc2f,AIRDROP,0
airdrop-20181115-hdac-c790db1a-0f05-48d2-a62a-14dacc28fb4d-withdrawal-exchange,2018.11.15 10:12,UNKNOWN,,UNKNOWN-55c0f2b7-dc24-425b-9be8-6b86719f2865,2018.11.15 10:12,UNKNOWN,0,100,0,HDAC,WITHDRAWAL,,,,0,COMPLETED,0,sum-user-id,1517360.065,airdrop-20181115-hdac-sum-user-id-withdrawal,accac570-de75-11e8-bd11-2f9252c4dc2f,AIRDROP,0
airdrop-20181115-hdac-c7c4d43d-eadb-4fec-ac7a-72c080757258-withdrawal-exchange,2018.11.15 10:12,UNKNOWN,,UNKNOWN-55c0f2b7-dc24-425b-9be8-6b86719f2865,2018.11.15 10:12,UNKNOWN,0,39145.60183,0,HDAC,WITHDRAWAL,,,,0,COMPLETED,0,sum-user-id,1478214.464,airdrop-20181115-hdac-sum-user-id-withdrawal,accac570-de75-11e8-bd11-2f9252c4dc2f,AIRDROP,0
airdrop-20181115-hdac-c7c8c015-8ff0-45b6-8115-420d938e2032-withdrawal-exchange,2018.11.15 10:12,UNKNOWN,,UNKNOWN-55c0f2b7-dc24-425b-9be8-6b86719f2865,2018.11.15 10:12,UNKNOWN,0,100,0,HDAC,WITHDRAWAL,,,,0,COMPLETED,0,sum-user-id,1478114.464,airdrop-20181115-hdac-sum-user-id-withdrawal,accac570-de75-11e8-bd11-2f9252c4dc2f,AIRDROP,0
airdrop-20181115-hdac-c7c940a2-43b8-411d-8dde-01183e87f20b-withdrawal-exchange,2018.11.15 10:12,UNKNOWN,,UNKNOWN-55c0f2b7-dc24-425b-9be8-6b86719f2865,2018.11.15 10:12,UNKNOWN,0,100,0,HDAC,WITHDRAWAL,,,,0,COMPLETED,0,sum-user-id,1478014.464,airdrop-20181115-hdac-sum-user-id-withdrawal,accac570-de75-11e8-bd11-2f9252c4dc2f,AIRDROP,0
airdrop-20181115-hdac-c7cc79d9-e1fa-4272-9fc9-d093d3a945cf-withdrawal-exchange,2018.11.15 10:12,UNKNOWN,,UNKNOWN-55c0f2b7-dc24-425b-9be8-6b86719f2865,2018.11.15 10:12,UNKNOWN,0,100,0,HDAC,WITHDRAWAL,,,,0,COMPLETED,0,sum-user-id,1477914.464,airdrop-20181115-hdac-sum-user-id-withdrawal,accac570-de75-11e8-bd11-2f9252c4dc2f,AIRDROP,0
airdrop-20181115-hdac-c7f984e2-3875-456b-96a7-4aa31f1a0723-withdrawal-exchange,2018.11.15 10:12,UNKNOWN,,UNKNOWN-55c0f2b7-dc24-425b-9be8-6b86719f2865,2018.11.15 10:12,UNKNOWN,0,100,0,HDAC,WITHDRAWAL,,,,0,COMPLETED,0,sum-user-id,1477814.464,airdrop-20181115-hdac-sum-user-id-withdrawal,accac570-de75-11e8-bd11-2f9252c4dc2f,AIRDROP,0
airdrop-20181115-hdac-c83598cd-c155-4b2e-9fe9-af7761ce8a7b-withdrawal-exchange,2018.11.15 10:12,UNKNOWN,,UNKNOWN-55c0f2b7-dc24-425b-9be8-6b86719f2865,2018.11.15 10:12,UNKNOWN,0,100,0,HDAC,WITHDRAWAL,,,,0,COMPLETED,0,sum-user-id,1477714.464,airdrop-20181115-hdac-sum-user-id-withdrawal,accac570-de75-11e8-bd11-2f9252c4dc2f,AIRDROP,0
airdrop-20181115-hdac-c83cccb0-d082-4c7b-b0ed-95a592978ffa-withdrawal-exchange,2018.11.15 10:12,UNKNOWN,,UNKNOWN-55c0f2b7-dc24-425b-9be8-6b86719f2865,2018.11.15 10:12,UNKNOWN,0,100,0,HDAC,WITHDRAWAL,,,,0,COMPLETED,0,sum-user-id,1477614.464,airdrop-20181115-hdac-sum-user-id-withdrawal,accac570-de75-11e8-bd11-2f9252c4dc2f,AIRDROP,0
airdrop-20181115-hdac-c848d285-e80b-42c8-b3f7-a7c256681ca7-withdrawal-exchange,2018.11.15 10:12,UNKNOWN,,UNKNOWN-55c0f2b7-dc24-425b-9be8-6b86719f2865,2018.11.15 10:12,UNKNOWN,0,100,0,HDAC,WITHDRAWAL,,,,0,COMPLETED,0,sum-user-id,1477514.464,airdrop-20181115-hdac-sum-user-id-withdrawal,accac570-de75-11e8-bd11-2f9252c4dc2f,AIRDROP,0
airdrop-20181115-hdac-c85dc041-8134-49c8-902b-171e61ba4585-withdrawal-exchange,2018.11.15 10:12,UNKNOWN,,UNKNOWN-55c0f2b7-dc24-425b-9be8-6b86719f2865,2018.11.15 10:12,UNKNOWN,0,100,0,HDAC,WITHDRAWAL,,,,0,COMPLETED,0,sum-user-id,1477414.464,airdrop-20181115-hdac-sum-user-id-withdrawal,accac570-de75-11e8-bd11-2f9252c4dc2f,AIRDROP,0
airdrop-20181115-hdac-c889d45c-194f-4ea3-bd63-9c0e3fa1d9fb-withdrawal-exchange,2018.11.15 10:12,UNKNOWN,,UNKNOWN-55c0f2b7-dc24-425b-9be8-6b86719f2865,2018.11.15 10:12,UNKNOWN,0,1062.21,0,HDAC,WITHDRAWAL,,,,0,COMPLETED,0,sum-user-id,1192505.108,airdrop-20181115-hdac-sum-user-id-withdrawal,accac570-de75-11e8-bd11-2f9252c4dc2f,AIRDROP,0
airdrop-20181115-hdac-c8a04de1-8438-41a1-9072-55555edfcc90-withdrawal-exchange,2018.11.15 10:12,UNKNOWN,,UNKNOWN-55c0f2b7-dc24-425b-9be8-6b86719f2865,2018.11.15 10:12,UNKNOWN,0,100,0,HDAC,WITHDRAWAL,,,,0,COMPLETED,0,sum-user-id,1477314.464,airdrop-20181115-hdac-sum-user-id-withdrawal,accac570-de75-11e8-bd11-2f9252c4dc2f,AIRDROP,0
airdrop-20181115-hdac-c8b937e5-e743-4062-b3a6-831545328bd2-withdrawal-exchange,2018.11.15 10:12,UNKNOWN,,UNKNOWN-55c0f2b7-dc24-425b-9be8-6b86719f2865,2018.11.15 10:12,UNKNOWN,0,100,0,HDAC,WITHDRAWAL,,,,0,COMPLETED,0,sum-user-id,1477214.464,airdrop-20181115-hdac-sum-user-id-withdrawal,accac570-de75-11e8-bd11-2f9252c4dc2f,AIRDROP,0
airdrop-20181115-hdac-c8c4fa73-0c1a-4929-8182-9a5126fcd133-withdrawal-exchange,2018.11.15 10:12,UNKNOWN,,UNKNOWN-55c0f2b7-dc24-425b-9be8-6b86719f2865,2018.11.15 10:12,UNKNOWN,0,100,0,HDAC,WITHDRAWAL,,,,0,COMPLETED,0,sum-user-id,1477114.464,airdrop-20181115-hdac-sum-user-id-withdrawal,accac570-de75-11e8-bd11-2f9252c4dc2f,AIRDROP,0
airdrop-20181115-hdac-c90ee85e-bc67-4985-8171-7e18b7dc4ad9-withdrawal-exchange,2018.11.15 10:12,UNKNOWN,,UNKNOWN-55c0f2b7-dc24-425b-9be8-6b86719f2865,2018.11.15 10:12,UNKNOWN,0,100,0,HDAC,WITHDRAWAL,,,,0,COMPLETED,0,sum-user-id,1477014.464,airdrop-20181115-hdac-sum-user-id-withdrawal,accac570-de75-11e8-bd11-2f9252c4dc2f,AIRDROP,0
airdrop-20181115-hdac-c913af28-9740-494d-ae68-4af991310b7c-withdrawal-exchange,2018-11-15 10:12:10.014,UNKNOWN,,UNKNOWN-55c0f2b7-dc24-425b-9be8-6b86719f2865,2018-11-15 10:12:10.014,UNKNOWN,0,100,0,HDAC,WITHDRAWAL,,,,0,COMPLETED,0,sum-user-id,1476914.464,airdrop-20181115-hdac-sum-user-id-withdrawal,accac570-de75-11e8-bd11-2f9252c4dc2f,AIRDROP,0
airdrop-20181115-hdac-c94a7c0c-a56c-4676-895e-c5ba9dc29c7d-withdrawal-exchange,2018-11-15 10:12:10.050,UNKNOWN,,UNKNOWN-55c0f2b7-dc24-425b-9be8-6b86719f2865,2018-11-15 10:12:10.050,UNKNOWN,0,100,0,HDAC,WITHDRAWAL,,,,0,COMPLETED,0,sum-user-id,1476814.464,airdrop-20181115-hdac-sum-user-id-withdrawal,accac570-de75-11e8-bd11-2f9252c4dc2f,AIRDROP,0
airdrop-20181115-hdac-c94d5744-d231-4dae-8b83-4c8f1ee66c3f-withdrawal-exchange,2018-11-15 10:12:10.083,UNKNOWN,,UNKNOWN-55c0f2b7-dc24-425b-9be8-6b86719f2865,2018-11-15 10:12:10.083,UNKNOWN,0,100,0,HDAC,WITHDRAWAL,,,,0,COMPLETED,0,sum-user-id,1476714.464,airdrop-20181115-hdac-sum-user-id-withdrawal,accac570-de75-11e8-bd11-2f9252c4dc2f,AIRDROP,0
airdrop-20181115-hdac-c99742b9-c55a-4cf6-a946-7c1f69a16b43-withdrawal-exchange,2018.11.15 10:12,UNKNOWN,,UNKNOWN-55c0f2b7-dc24-425b-9be8-6b86719f2865,2018.11.15 10:12,UNKNOWN,0,100,0,HDAC,WITHDRAWAL,,,,0,COMPLETED,0,sum-user-id,1476614.464,airdrop-20181115-hdac-sum-user-id-withdrawal,accac570-de75-11e8-bd11-2f9252c4dc2f,AIRDROP,0
airdrop-20181115-hdac-c99f10c8-1384-40c4-a9c5-03cbe7da7b69-withdrawal-exchange,2018.11.15 10:12,UNKNOWN,,UNKNOWN-55c0f2b7-dc24-425b-9be8-6b86719f2865,2018.11.15 10:12,UNKNOWN,0,100,0,HDAC,WITHDRAWAL,,,,0,COMPLETED,0,sum-user-id,1476514.464,airdrop-20181115-hdac-sum-user-id-withdrawal,accac570-de75-11e8-bd11-2f9252c4dc2f,AIRDROP,0
airdrop-20181115-hdac-c99fd0d6-9665-47e2-8738-6dd471f7693d-withdrawal-exchange,2018.11.15 10:12,UNKNOWN,,UNKNOWN-55c0f2b7-dc24-425b-9be8-6b86719f2865,2018.11.15 10:12,UNKNOWN,0,100,0,HDAC,WITHDRAWAL,,,,0,COMPLETED,0,sum-user-id,1476414.464,airdrop-20181115-hdac-sum-user-id-withdrawal,accac570-de75-11e8-bd11-2f9252c4dc2f,AIRDROP,0
airdrop-20181115-hdac-ca08a2ef-f03f-4ab1-830a-15174ff50539-withdrawal-exchange,2018.11.15 10:12,UNKNOWN,,UNKNOWN-55c0f2b7-dc24-425b-9be8-6b86719f2865,2018.11.15 10:12,UNKNOWN,0,100,0,HDAC,WITHDRAWAL,,,,0,COMPLETED,0,sum-user-id,1476314.464,airdrop-20181115-hdac-sum-user-id-withdrawal,accac570-de75-11e8-bd11-2f9252c4dc2f,AIRDROP,0
airdrop-20181115-hdac-ca136099-be47-496d-9b01-edcda12c9da9-withdrawal-exchange,2018.11.15 10:12,UNKNOWN,,UNKNOWN-55c0f2b7-dc24-425b-9be8-6b86719f2865,2018.11.15 10:12,UNKNOWN,0,100,0,HDAC,WITHDRAWAL,,,,0,COMPLETED,0,sum-user-id,1476214.464,airdrop-20181115-hdac-sum-user-id-withdrawal,accac570-de75-11e8-bd11-2f9252c4dc2f,AIRDROP,0
airdrop-20181115-hdac-ca361a3c-8c61-4a7d-a31b-2fbea6c78e64-withdrawal-exchange,2018.11.15 10:12,UNKNOWN,,UNKNOWN-55c0f2b7-dc24-425b-9be8-6b86719f2865,2018.11.15 10:12,UNKNOWN,0,100,0,HDAC,WITHDRAWAL,,,,0,COMPLETED,0,sum-user-id,1476114.464,airdrop-20181115-hdac-sum-user-id-withdrawal,accac570-de75-11e8-bd11-2f9252c4dc2f,AIRDROP,0
airdrop-20181115-hdac-ca392236-54c2-4515-9653-08bbb06053b6-withdrawal-exchange,2018.11.15 10:12,UNKNOWN,,UNKNOWN-55c0f2b7-dc24-425b-9be8-6b86719f2865,2018.11.15 10:12,UNKNOWN,0,100,0,HDAC,WITHDRAWAL,,,,0,COMPLETED,0,sum-user-id,1476014.464,airdrop-20181115-hdac-sum-user-id-withdrawal,accac570-de75-11e8-bd11-2f9252c4dc2f,AIRDROP,0
airdrop-20181115-hdac-ca5a9fec-0269-4ccf-ac1a-ffe8bc2a41ea-withdrawal-exchange,2018.11.15 10:12,UNKNOWN,,UNKNOWN-55c0f2b7-dc24-425b-9be8-6b86719f2865,2018.11.15 10:12,UNKNOWN,0,100,0,HDAC,WITHDRAWAL,,,,0,COMPLETED,0,sum-user-id,1475914.464,airdrop-20181115-hdac-sum-user-id-withdrawal,accac570-de75-11e8-bd11-2f9252c4dc2f,AIRDROP,0
airdrop-20181115-hdac-ca637126-7cf2-4493-9c6a-9746445175a5-withdrawal-exchange,2018.11.15 10:12,UNKNOWN,,UNKNOWN-55c0f2b7-dc24-425b-9be8-6b86719f2865,2018.11.15 10:12,UNKNOWN,0,100,0,HDAC,WITHDRAWAL,,,,0,COMPLETED,0,sum-user-id,1475814.464,airdrop-20181115-hdac-sum-user-id-withdrawal,accac570-de75-11e8-bd11-2f9252c4dc2f,AIRDROP,0
airdrop-20181115-hdac-ca660d05-1f88-4a7f-833d-dc6a446a2d57-withdrawal-exchange,2018.11.15 10:12,UNKNOWN,,UNKNOWN-55c0f2b7-dc24-425b-9be8-6b86719f2865,2018.11.15 10:12,UNKNOWN,0,100,0,HDAC,WITHDRAWAL,,,,0,COMPLETED,0,sum-user-id,1475714.464,airdrop-20181115-hdac-sum-user-id-withdrawal,accac570-de75-11e8-bd11-2f9252c4dc2f,AIRDROP,0
airdrop-20181115-hdac-ca7e2123-71dd-4b1c-a55e-552beb08f79e-withdrawal-exchange,2018.11.15 10:12,UNKNOWN,,UNKNOWN-55c0f2b7-dc24-425b-9be8-6b86719f2865,2018.11.15 10:12,UNKNOWN,0,100,0,HDAC,WITHDRAWAL,,,,0,COMPLETED,0,sum-user-id,1475614.464,airdrop-20181115-hdac-sum-user-id-withdrawal,accac570-de75-11e8-bd11-2f9252c4dc2f,AIRDROP,0
airdrop-20181115-hdac-caaad0b3-53af-4761-9443-61dc2d579b1f-withdrawal-exchange,2018.11.15 10:12,UNKNOWN,,UNKNOWN-55c0f2b7-dc24-425b-9be8-6b86719f2865,2018.11.15 10:12,UNKNOWN,0,100,0,HDAC,WITHDRAWAL,,,,0,COMPLETED,0,sum-user-id,1475514.464,airdrop-20181115-hdac-sum-user-id-withdrawal,accac570-de75-11e8-bd11-2f9252c4dc2f,AIRDROP,0
airdrop-20181115-hdac-cabb6686-f870-47a6-aa74-249c98604a85-withdrawal-exchange,2018.11.15 10:12,UNKNOWN,,UNKNOWN-55c0f2b7-dc24-425b-9be8-6b86719f2865,2018.11.15 10:12,UNKNOWN,0,100,0,HDAC,WITHDRAWAL,,,,0,COMPLETED,0,sum-user-id,1475414.464,airdrop-20181115-hdac-sum-user-id-withdrawal,accac570-de75-11e8-bd11-2f9252c4dc2f,AIRDROP,0
airdrop-20181115-hdac-cae5a2fe-4bb7-4c88-bb35-68b06ae43220-withdrawal-exchange,2018.11.15 10:12,UNKNOWN,,UNKNOWN-55c0f2b7-dc24-425b-9be8-6b86719f2865,2018.11.15 10:12,UNKNOWN,0,100,0,HDAC,WITHDRAWAL,,,,0,COMPLETED,0,sum-user-id,1475314.464,airdrop-20181115-hdac-sum-user-id-withdrawal,accac570-de75-11e8-bd11-2f9252c4dc2f,AIRDROP,0
airdrop-20181115-hdac-cae745fa-8fc1-4fc5-9950-a73aaa29d251-withdrawal-exchange,2018.11.15 10:12,UNKNOWN,,UNKNOWN-55c0f2b7-dc24-425b-9be8-6b86719f2865,2018.11.15 10:12,UNKNOWN,0,100,0,HDAC,WITHDRAWAL,,,,0,COMPLETED,0,sum-user-id,1475214.464,airdrop-20181115-hdac-sum-user-id-withdrawal,accac570-de75-11e8-bd11-2f9252c4dc2f,AIRDROP,0
airdrop-20181115-hdac-cb030b55-c349-4b7f-aa53-905c5b55d563-withdrawal-exchange,2018.11.15 10:12,UNKNOWN,,UNKNOWN-55c0f2b7-dc24-425b-9be8-6b86719f2865,2018.11.15 10:12,UNKNOWN,0,100,0,HDAC,WITHDRAWAL,,,,0,COMPLETED,0,sum-user-id,1475114.464,airdrop-20181115-hdac-sum-user-id-withdrawal,accac570-de75-11e8-bd11-2f9252c4dc2f,AIRDROP,0
airdrop-20181115-hdac-cb0f24f3-9b7f-4cef-8552-2aaf8b3e5156-withdrawal-exchange,2018.11.15 10:12,UNKNOWN,,UNKNOWN-55c0f2b7-dc24-425b-9be8-6b86719f2865,2018.11.15 10:12,UNKNOWN,0,100,0,HDAC,WITHDRAWAL,,,,0,COMPLETED,0,sum-user-id,1475014.464,airdrop-20181115-hdac-sum-user-id-withdrawal,accac570-de75-11e8-bd11-2f9252c4dc2f,AIRDROP,0
airdrop-20181115-hdac-cb1df69e-a29c-499b-88f4-2bf86276e4d4-withdrawal-exchange,2018.11.15 10:12,UNKNOWN,,UNKNOWN-55c0f2b7-dc24-425b-9be8-6b86719f2865,2018.11.15 10:12,UNKNOWN,0,100,0,HDAC,WITHDRAWAL,,,,0,COMPLETED,0,sum-user-id,1474914.464,airdrop-20181115-hdac-sum-user-id-withdrawal,accac570-de75-11e8-bd11-2f9252c4dc2f,AIRDROP,0
airdrop-20181115-hdac-cb2c44d6-7635-4865-93f8-2cd2f304d1da-withdrawal-exchange,2018.11.15 10:12,UNKNOWN,,UNKNOWN-55c0f2b7-dc24-425b-9be8-6b86719f2865,2018.11.15 10:12,UNKNOWN,0,100,0,HDAC,WITHDRAWAL,,,,0,COMPLETED,0,sum-user-id,1474814.464,airdrop-20181115-hdac-sum-user-id-withdrawal,accac570-de75-11e8-bd11-2f9252c4dc2f,AIRDROP,0
airdrop-20181115-hdac-cb34ef6f-86b8-4142-850a-f4f26aa61794-withdrawal-exchange,2018.11.15 10:12,UNKNOWN,,UNKNOWN-55c0f2b7-dc24-425b-9be8-6b86719f2865,2018.11.15 10:12,UNKNOWN,0,100,0,HDAC,WITHDRAWAL,,,,0,COMPLETED,0,sum-user-id,1474714.464,airdrop-20181115-hdac-sum-user-id-withdrawal,accac570-de75-11e8-bd11-2f9252c4dc2f,AIRDROP,0
airdrop-20181115-hdac-cb84a7ba-e0ce-4b79-8e69-06a05ab656af-withdrawal-exchange,2018.11.15 10:12,UNKNOWN,,UNKNOWN-55c0f2b7-dc24-425b-9be8-6b86719f2865,2018.11.15 10:12,UNKNOWN,0,100,0,HDAC,WITHDRAWAL,,,,0,COMPLETED,0,sum-user-id,1474614.464,airdrop-20181115-hdac-sum-user-id-withdrawal,accac570-de75-11e8-bd11-2f9252c4dc2f,AIRDROP,0
airdrop-20181115-hdac-cbc4e323-8178-421a-ac1c-446c34bce583-withdrawal-exchange,2018.11.15 10:12,UNKNOWN,,UNKNOWN-55c0f2b7-dc24-425b-9be8-6b86719f2865,2018.11.15 10:12,UNKNOWN,0,100,0,HDAC,WITHDRAWAL,,,,0,COMPLETED,0,sum-user-id,1474514.464,airdrop-20181115-hdac-sum-user-id-withdrawal,accac570-de75-11e8-bd11-2f9252c4dc2f,AIRDROP,0
airdrop-20181115-hdac-cc075984-f66f-4acb-a2e1-6753539a405d-withdrawal-exchange,2018.11.15 10:12,UNKNOWN,,UNKNOWN-55c0f2b7-dc24-425b-9be8-6b86719f2865,2018.11.15 10:12,UNKNOWN,0,100,0,HDAC,WITHDRAWAL,,,,0,COMPLETED,0,sum-user-id,1474414.464,airdrop-20181115-hdac-sum-user-id-withdrawal,accac570-de75-11e8-bd11-2f9252c4dc2f,AIRDROP,0
airdrop-20181115-hdac-cc0c39f8-41c3-4fa9-a374-88dce1291d31-withdrawal-exchange,2018.11.15 10:12,UNKNOWN,,UNKNOWN-55c0f2b7-dc24-425b-9be8-6b86719f2865,2018.11.15 10:12,UNKNOWN,0,100,0,HDAC,WITHDRAWAL,,,,0,COMPLETED,0,sum-user-id,1474314.464,airdrop-20181115-hdac-sum-user-id-withdrawal,accac570-de75-11e8-bd11-2f9252c4dc2f,AIRDROP,0
airdrop-20181115-hdac-cc1db5d8-86f5-448c-87c1-4d2e80979a5f-withdrawal-exchange,2018.11.15 10:12,UNKNOWN,,UNKNOWN-55c0f2b7-dc24-425b-9be8-6b86719f2865,2018.11.15 10:12,UNKNOWN,0,100,0,HDAC,WITHDRAWAL,,,,0,COMPLETED,0,sum-user-id,1474214.464,airdrop-20181115-hdac-sum-user-id-withdrawal,accac570-de75-11e8-bd11-2f9252c4dc2f,AIRDROP,0
airdrop-20181115-hdac-cc2baefc-f743-4a62-86c6-656a7fa4027f-withdrawal-exchange,2018.11.15 10:12,UNKNOWN,,UNKNOWN-55c0f2b7-dc24-425b-9be8-6b86719f2865,2018.11.15 10:12,UNKNOWN,0,100,0,HDAC,WITHDRAWAL,,,,0,COMPLETED,0,sum-user-id,1474114.464,airdrop-20181115-hdac-sum-user-id-withdrawal,accac570-de75-11e8-bd11-2f9252c4dc2f,AIRDROP,0
airdrop-20181115-hdac-cc349478-ef46-44d0-895e-5954912228b5-withdrawal-exchange,2018.11.15 10:12,UNKNOWN,,UNKNOWN-55c0f2b7-dc24-425b-9be8-6b86719f2865,2018.11.15 10:12,UNKNOWN,0,100,0,HDAC,WITHDRAWAL,,,,0,COMPLETED,0,sum-user-id,1474014.464,airdrop-20181115-hdac-sum-user-id-withdrawal,accac570-de75-11e8-bd11-2f9252c4dc2f,AIRDROP,0
airdrop-20181115-hdac-ccb847b9-7b8f-4c34-a39b-301137b9169d-withdrawal-exchange,2018.11.15 10:12,UNKNOWN,,UNKNOWN-55c0f2b7-dc24-425b-9be8-6b86719f2865,2018.11.15 10:12,UNKNOWN,0,100,0,HDAC,WITHDRAWAL,,,,0,COMPLETED,0,sum-user-id,1473914.464,airdrop-20181115-hdac-sum-user-id-withdrawal,accac570-de75-11e8-bd11-2f9252c4dc2f,AIRDROP,0
airdrop-20181115-hdac-cce194b5-f0c8-43ad-a8db-54eb9d150a6d-withdrawal-exchange,2018-11-15 10:12:11.022,UNKNOWN,,UNKNOWN-55c0f2b7-dc24-425b-9be8-6b86719f2865,2018-11-15 10:12:11.022,UNKNOWN,0,100,0,HDAC,WITHDRAWAL,,,,0,COMPLETED,0,sum-user-id,1473814.464,airdrop-20181115-hdac-sum-user-id-withdrawal,accac570-de75-11e8-bd11-2f9252c4dc2f,AIRDROP,0
airdrop-20181115-hdac-ccf91da0-4b42-4056-98f4-b0377ff189d1-withdrawal-exchange,2018-11-15 10:12:11.055,UNKNOWN,,UNKNOWN-55c0f2b7-dc24-425b-9be8-6b86719f2865,2018-11-15 10:12:11.055,UNKNOWN,0,100,0,HDAC,WITHDRAWAL,,,,0,COMPLETED,0,sum-user-id,1473714.464,airdrop-20181115-hdac-sum-user-id-withdrawal,accac570-de75-11e8-bd11-2f9252c4dc2f,AIRDROP,0
airdrop-20181115-hdac-cd1dd8a2-c4a2-4dd3-87b6-1648ad6ddc01-withdrawal-exchange,2018-11-15 10:12:11.084,UNKNOWN,,UNKNOWN-55c0f2b7-dc24-425b-9be8-6b86719f2865,2018-11-15 10:12:11.084,UNKNOWN,0,100,0,HDAC,WITHDRAWAL,,,,0,COMPLETED,0,sum-user-id,1473614.464,airdrop-20181115-hdac-sum-user-id-withdrawal,accac570-de75-11e8-bd11-2f9252c4dc2f,AIRDROP,0
airdrop-20181115-hdac-cd2c073b-fe2f-4f6f-9cf6-f33875d3e823-withdrawal-exchange,2018.11.15 10:12,UNKNOWN,,UNKNOWN-55c0f2b7-dc24-425b-9be8-6b86719f2865,2018.11.15 10:12,UNKNOWN,0,100,0,HDAC,WITHDRAWAL,,,,0,COMPLETED,0,sum-user-id,1473514.464,airdrop-20181115-hdac-sum-user-id-withdrawal,accac570-de75-11e8-bd11-2f9252c4dc2f,AIRDROP,0
airdrop-20181115-hdac-cd331e00-380d-4106-9152-c8f10af5f7cc-withdrawal-exchange,2018.11.15 10:12,UNKNOWN,,UNKNOWN-55c0f2b7-dc24-425b-9be8-6b86719f2865,2018.11.15 10:12,UNKNOWN,0,100,0,HDAC,WITHDRAWAL,,,,0,COMPLETED,0,sum-user-id,1473414.464,airdrop-20181115-hdac-sum-user-id-withdrawal,accac570-de75-11e8-bd11-2f9252c4dc2f,AIRDROP,0
airdrop-20181115-hdac-cd495c67-e29c-44cd-a8ea-c4c1f0a98cdd-withdrawal-exchange,2018.11.15 10:12,UNKNOWN,,UNKNOWN-55c0f2b7-dc24-425b-9be8-6b86719f2865,2018.11.15 10:12,UNKNOWN,0,100,0,HDAC,WITHDRAWAL,,,,0,COMPLETED,0,sum-user-id,1473314.464,airdrop-20181115-hdac-sum-user-id-withdrawal,accac570-de75-11e8-bd11-2f9252c4dc2f,AIRDROP,0
airdrop-20181115-hdac-cd6f1066-a94c-433f-aca5-9fb8f0f35a62-withdrawal-exchange,2018.11.15 10:12,UNKNOWN,,UNKNOWN-55c0f2b7-dc24-425b-9be8-6b86719f2865,2018.11.15 10:12,UNKNOWN,0,100,0,HDAC,WITHDRAWAL,,,,0,COMPLETED,0,sum-user-id,1473214.464,airdrop-20181115-hdac-sum-user-id-withdrawal,accac570-de75-11e8-bd11-2f9252c4dc2f,AIRDROP,0
airdrop-20181115-hdac-cd88cd7f-c43f-4e90-914f-1c8a48efb5fd-withdrawal-exchange,2018.11.15 10:12,UNKNOWN,,UNKNOWN-55c0f2b7-dc24-425b-9be8-6b86719f2865,2018.11.15 10:12,UNKNOWN,0,100,0,HDAC,WITHDRAWAL,,,,0,COMPLETED,0,sum-user-id,1473114.464,airdrop-20181115-hdac-sum-user-id-withdrawal,accac570-de75-11e8-bd11-2f9252c4dc2f,AIRDROP,0
airdrop-20181115-hdac-cdad2578-9f85-4fd3-ba19-8bf246b0b1db-withdrawal-exchange,2018.11.15 10:12,UNKNOWN,,UNKNOWN-55c0f2b7-dc24-425b-9be8-6b86719f2865,2018.11.15 10:12,UNKNOWN,0,100,0,HDAC,WITHDRAWAL,,,,0,COMPLETED,0,sum-user-id,1473014.464,airdrop-20181115-hdac-sum-user-id-withdrawal,accac570-de75-11e8-bd11-2f9252c4dc2f,AIRDROP,0
airdrop-20181115-hdac-cdcdd835-bd8f-4e37-b4c1-a79e4e561f0a-withdrawal-exchange,2018.11.15 10:12,UNKNOWN,,UNKNOWN-55c0f2b7-dc24-425b-9be8-6b86719f2865,2018.11.15 10:12,UNKNOWN,0,100,0,HDAC,WITHDRAWAL,,,,0,COMPLETED,0,sum-user-id,1472914.464,airdrop-20181115-hdac-sum-user-id-withdrawal,accac570-de75-11e8-bd11-2f9252c4dc2f,AIRDROP,0
airdrop-20181115-hdac-cdd714f1-d95a-4acb-acfb-f67cabf0b646-withdrawal-exchange,2018.11.15 10:12,UNKNOWN,,UNKNOWN-55c0f2b7-dc24-425b-9be8-6b86719f2865,2018.11.15 10:12,UNKNOWN,0,100,0,HDAC,WITHDRAWAL,,,,0,COMPLETED,0,sum-user-id,1472814.464,airdrop-20181115-hdac-sum-user-id-withdrawal,accac570-de75-11e8-bd11-2f9252c4dc2f,AIRDROP,0
airdrop-20181115-hdac-ce087bd2-bcd8-4ab1-966f-5b2b335b3a24-withdrawal-exchange,2018.11.15 10:12,UNKNOWN,,UNKNOWN-55c0f2b7-dc24-425b-9be8-6b86719f2865,2018.11.15 10:12,UNKNOWN,0,100,0,HDAC,WITHDRAWAL,,,,0,COMPLETED,0,sum-user-id,1472714.464,airdrop-20181115-hdac-sum-user-id-withdrawal,accac570-de75-11e8-bd11-2f9252c4dc2f,AIRDROP,0
airdrop-20181115-hdac-ce3f2ccf-9f9a-49e5-9f16-9c688189907f-withdrawal-exchange,2018.11.15 10:12,UNKNOWN,,UNKNOWN-55c0f2b7-dc24-425b-9be8-6b86719f2865,2018.11.15 10:12,UNKNOWN,0,100,0,HDAC,WITHDRAWAL,,,,0,COMPLETED,0,sum-user-id,1472614.464,airdrop-20181115-hdac-sum-user-id-withdrawal,accac570-de75-11e8-bd11-2f9252c4dc2f,AIRDROP,0
airdrop-20181115-hdac-ce589203-bd88-4567-bfec-27b1e1e96a47-withdrawal-exchange,2018.11.15 10:12,UNKNOWN,,UNKNOWN-55c0f2b7-dc24-425b-9be8-6b86719f2865,2018.11.15 10:12,UNKNOWN,0,100,0,HDAC,WITHDRAWAL,,,,0,COMPLETED,0,sum-user-id,1472514.464,airdrop-20181115-hdac-sum-user-id-withdrawal,accac570-de75-11e8-bd11-2f9252c4dc2f,AIRDROP,0
airdrop-20181115-hdac-ce74b8b8-162a-409e-a968-91fe210e0060-withdrawal-exchange,2018.11.15 10:12,UNKNOWN,,UNKNOWN-55c0f2b7-dc24-425b-9be8-6b86719f2865,2018.11.15 10:12,UNKNOWN,0,100,0,HDAC,WITHDRAWAL,,,,0,COMPLETED,0,sum-user-id,1472414.464,airdrop-20181115-hdac-sum-user-id-withdrawal,accac570-de75-11e8-bd11-2f9252c4dc2f,AIRDROP,0
airdrop-20181115-hdac-ce757def-cb70-41fa-a459-f9b668651bd1-withdrawal-exchange,2018.11.15 10:12,UNKNOWN,,UNKNOWN-55c0f2b7-dc24-425b-9be8-6b86719f2865,2018.11.15 10:12,UNKNOWN,0,100,0,HDAC,WITHDRAWAL,,,,0,COMPLETED,0,sum-user-id,1472314.464,airdrop-20181115-hdac-sum-user-id-withdrawal,accac570-de75-11e8-bd11-2f9252c4dc2f,AIRDROP,0
airdrop-20181115-hdac-ce95e58b-f7f9-4587-82ff-f1d82eb5f608-withdrawal-exchange,2018.11.15 10:12,UNKNOWN,,UNKNOWN-55c0f2b7-dc24-425b-9be8-6b86719f2865,2018.11.15 10:12,UNKNOWN,0,100,0,HDAC,WITHDRAWAL,,,,0,COMPLETED,0,sum-user-id,1472214.464,airdrop-20181115-hdac-sum-user-id-withdrawal,accac570-de75-11e8-bd11-2f9252c4dc2f,AIRDROP,0
airdrop-20181115-hdac-ce9c6e44-2502-495e-8291-e79750648b67-withdrawal-exchange,2018.11.15 10:12,UNKNOWN,,UNKNOWN-55c0f2b7-dc24-425b-9be8-6b86719f2865,2018.11.15 10:12,UNKNOWN,0,100,0,HDAC,WITHDRAWAL,,,,0,COMPLETED,0,sum-user-id,1472114.464,airdrop-20181115-hdac-sum-user-id-withdrawal,accac570-de75-11e8-bd11-2f9252c4dc2f,AIRDROP,0
airdrop-20181115-hdac-cec4539d-b154-47e9-9806-5c09a2bff00c-withdrawal-exchange,2018.11.15 10:12,UNKNOWN,,UNKNOWN-55c0f2b7-dc24-425b-9be8-6b86719f2865,2018.11.15 10:12,UNKNOWN,0,87918.63851,0,HDAC,WITHDRAWAL,,,,0,COMPLETED,0,sum-user-id,1104586.47,airdrop-20181115-hdac-sum-user-id-withdrawal,accac570-de75-11e8-bd11-2f9252c4dc2f,AIRDROP,0
airdrop-20181115-hdac-ced6b226-4965-48d2-a2d9-d5814fdf111f-withdrawal-exchange,2018.11.15 10:12,UNKNOWN,,UNKNOWN-55c0f2b7-dc24-425b-9be8-6b86719f2865,2018.11.15 10:12,UNKNOWN,0,100,0,HDAC,WITHDRAWAL,,,,0,COMPLETED,0,sum-user-id,1472014.464,airdrop-20181115-hdac-sum-user-id-withdrawal,accac570-de75-11e8-bd11-2f9252c4dc2f,AIRDROP,0
airdrop-20181115-hdac-cef29a24-ff8a-40f7-b94d-47929efae7c8-withdrawal-exchange,2018.11.15 10:12,UNKNOWN,,UNKNOWN-55c0f2b7-dc24-425b-9be8-6b86719f2865,2018.11.15 10:12,UNKNOWN,0,100,0,HDAC,WITHDRAWAL,,,,0,COMPLETED,0,sum-user-id,1471914.464,airdrop-20181115-hdac-sum-user-id-withdrawal,accac570-de75-11e8-bd11-2f9252c4dc2f,AIRDROP,0
airdrop-20181115-hdac-cf0677c4-8283-4296-9cc6-823d390d34e7-withdrawal-exchange,2018.11.15 10:12,UNKNOWN,,UNKNOWN-55c0f2b7-dc24-425b-9be8-6b86719f2865,2018.11.15 10:12,UNKNOWN,0,100,0,HDAC,WITHDRAWAL,,,,0,COMPLETED,0,sum-user-id,1471814.464,airdrop-20181115-hdac-sum-user-id-withdrawal,accac570-de75-11e8-bd11-2f9252c4dc2f,AIRDROP,0
airdrop-20181115-hdac-cf15a10f-f2d7-4778-981a-b48c3605b500-withdrawal-exchange,2018.11.15 10:12,UNKNOWN,,UNKNOWN-55c0f2b7-dc24-425b-9be8-6b86719f2865,2018.11.15 10:12,UNKNOWN,0,100,0,HDAC,WITHDRAWAL,,,,0,COMPLETED,0,sum-user-id,1471714.464,airdrop-20181115-hdac-sum-user-id-withdrawal,accac570-de75-11e8-bd11-2f9252c4dc2f,AIRDROP,0
airdrop-20181115-hdac-cf214d17-102a-4691-ae83-587b1855b8ae-withdrawal-exchange,2018.11.15 10:12,UNKNOWN,,UNKNOWN-55c0f2b7-dc24-425b-9be8-6b86719f2865,2018.11.15 10:12,UNKNOWN,0,100,0,HDAC,WITHDRAWAL,,,,0,COMPLETED,0,sum-user-id,1471614.464,airdrop-20181115-hdac-sum-user-id-withdrawal,accac570-de75-11e8-bd11-2f9252c4dc2f,AIRDROP,0
airdrop-20181115-hdac-cf6d7eee-8f61-436c-9b84-cfab33a3f8b8-withdrawal-exchange,2018.11.15 10:12,UNKNOWN,,UNKNOWN-55c0f2b7-dc24-425b-9be8-6b86719f2865,2018.11.15 10:12,UNKNOWN,0,100,0,HDAC,WITHDRAWAL,,,,0,COMPLETED,0,sum-user-id,1471514.464,airdrop-20181115-hdac-sum-user-id-withdrawal,accac570-de75-11e8-bd11-2f9252c4dc2f,AIRDROP,0
airdrop-20181115-hdac-cf9d4d2e-4597-4c14-b460-c68df038f032-withdrawal-exchange,2018.11.15 10:12,UNKNOWN,,UNKNOWN-55c0f2b7-dc24-425b-9be8-6b86719f2865,2018.11.15 10:12,UNKNOWN,0,100,0,HDAC,WITHDRAWAL,,,,0,COMPLETED,0,sum-user-id,1471414.464,airdrop-20181115-hdac-sum-user-id-withdrawal,accac570-de75-11e8-bd11-2f9252c4dc2f,AIRDROP,0
airdrop-20181115-hdac-cfa080db-efa1-475f-b309-817b703a5d67-withdrawal-exchange,2018.11.15 10:12,UNKNOWN,,UNKNOWN-55c0f2b7-dc24-425b-9be8-6b86719f2865,2018.11.15 10:12,UNKNOWN,0,100,0,HDAC,WITHDRAWAL,,,,0,COMPLETED,0,sum-user-id,1471314.464,airdrop-20181115-hdac-sum-user-id-withdrawal,accac570-de75-11e8-bd11-2f9252c4dc2f,AIRDROP,0
airdrop-20181115-hdac-cfd8dff7-074b-4c0e-aa6e-9122a1955518-withdrawal-exchange,2018.11.15 10:12,UNKNOWN,,UNKNOWN-55c0f2b7-dc24-425b-9be8-6b86719f2865,2018.11.15 10:12,UNKNOWN,0,100,0,HDAC,WITHDRAWAL,,,,0,COMPLETED,0,sum-user-id,1471214.464,airdrop-20181115-hdac-sum-user-id-withdrawal,accac570-de75-11e8-bd11-2f9252c4dc2f,AIRDROP,0
airdrop-20181115-hdac-cfd8e2a5-2f4b-477e-83e5-ea670ebcb69f-withdrawal-exchange,2018.11.15 10:12,UNKNOWN,,UNKNOWN-55c0f2b7-dc24-425b-9be8-6b86719f2865,2018.11.15 10:12,UNKNOWN,0,100,0,HDAC,WITHDRAWAL,,,,0,COMPLETED,0,sum-user-id,1471114.464,airdrop-20181115-hdac-sum-user-id-withdrawal,accac570-de75-11e8-bd11-2f9252c4dc2f,AIRDROP,0
airdrop-20181115-hdac-cfe14502-b121-4351-8bc0-2cdcb2959607-withdrawal-exchange,2018.11.15 10:12,UNKNOWN,,UNKNOWN-55c0f2b7-dc24-425b-9be8-6b86719f2865,2018.11.15 10:12,UNKNOWN,0,100,0,HDAC,WITHDRAWAL,,,,0,COMPLETED,0,sum-user-id,1471014.464,airdrop-20181115-hdac-sum-user-id-withdrawal,accac570-de75-11e8-bd11-2f9252c4dc2f,AIRDROP,0
airdrop-20181115-hdac-d0036561-9685-4c16-b268-3686e3f98d3d-withdrawal-exchange,2018.11.15 10:12,UNKNOWN,,UNKNOWN-55c0f2b7-dc24-425b-9be8-6b86719f2865,2018.11.15 10:12,UNKNOWN,0,100,0,HDAC,WITHDRAWAL,,,,0,COMPLETED,0,sum-user-id,1470914.464,airdrop-20181115-hdac-sum-user-id-withdrawal,accac570-de75-11e8-bd11-2f9252c4dc2f,AIRDROP,0
airdrop-20181115-hdac-d0119f4b-ff95-4c55-be2b-1e8671e1ea5e-withdrawal-exchange,2018.11.15 10:12,UNKNOWN,,UNKNOWN-55c0f2b7-dc24-425b-9be8-6b86719f2865,2018.11.15 10:12,UNKNOWN,0,100,0,HDAC,WITHDRAWAL,,,,0,COMPLETED,0,sum-user-id,1470814.464,airdrop-20181115-hdac-sum-user-id-withdrawal,accac570-de75-11e8-bd11-2f9252c4dc2f,AIRDROP,0
airdrop-20181115-hdac-d04c5355-0547-4a35-b354-4a51737b96ed-withdrawal-exchange,2018.11.15 10:12,UNKNOWN,,UNKNOWN-55c0f2b7-dc24-425b-9be8-6b86719f2865,2018.11.15 10:12,UNKNOWN,0,100,0,HDAC,WITHDRAWAL,,,,0,COMPLETED,0,sum-user-id,1470714.464,airdrop-20181115-hdac-sum-user-id-withdrawal,accac570-de75-11e8-bd11-2f9252c4dc2f,AIRDROP,0
airdrop-20181115-hdac-d0574347-0767-4e3f-81be-104f87efb8d0-withdrawal-exchange,2018-11-15 10:12:12.017,UNKNOWN,,UNKNOWN-55c0f2b7-dc24-425b-9be8-6b86719f2865,2018-11-15 10:12:12.017,UNKNOWN,0,100,0,HDAC,WITHDRAWAL,,,,0,COMPLETED,0,sum-user-id,1470614.464,airdrop-20181115-hdac-sum-user-id-withdrawal,accac570-de75-11e8-bd11-2f9252c4dc2f,AIRDROP,0
airdrop-20181115-hdac-d0681b38-68f0-4cc4-9de3-2201c803009f-withdrawal-exchange,2018-11-15 10:12:12.047,UNKNOWN,,UNKNOWN-55c0f2b7-dc24-425b-9be8-6b86719f2865,2018-11-15 10:12:12.047,UNKNOWN,0,100,0,HDAC,WITHDRAWAL,,,,0,COMPLETED,0,sum-user-id,1470514.464,airdrop-20181115-hdac-sum-user-id-withdrawal,accac570-de75-11e8-bd11-2f9252c4dc2f,AIRDROP,0
airdrop-20181115-hdac-d07a3eab-036b-493b-9042-af3e1c60e2d9-withdrawal-exchange,2018-11-15 10:12:12.075,UNKNOWN,,UNKNOWN-55c0f2b7-dc24-425b-9be8-6b86719f2865,2018-11-15 10:12:12.075,UNKNOWN,0,100,0,HDAC,WITHDRAWAL,,,,0,COMPLETED,0,sum-user-id,1470414.464,airdrop-20181115-hdac-sum-user-id-withdrawal,accac570-de75-11e8-bd11-2f9252c4dc2f,AIRDROP,0
airdrop-20181115-hdac-d091f36d-74ca-4128-a1ec-a97bfdfc1d3d-withdrawal-exchange,2018.11.15 10:12,UNKNOWN,,UNKNOWN-55c0f2b7-dc24-425b-9be8-6b86719f2865,2018.11.15 10:12,UNKNOWN,0,100,0,HDAC,WITHDRAWAL,,,,0,COMPLETED,0,sum-user-id,1470314.464,airdrop-20181115-hdac-sum-user-id-withdrawal,accac570-de75-11e8-bd11-2f9252c4dc2f,AIRDROP,0
airdrop-20181115-hdac-d094dd23-96bf-4161-a925-4ea2ac69c265-withdrawal-exchange,2018.11.15 10:12,UNKNOWN,,UNKNOWN-55c0f2b7-dc24-425b-9be8-6b86719f2865,2018.11.15 10:12,UNKNOWN,0,100,0,HDAC,WITHDRAWAL,,,,0,COMPLETED,0,sum-user-id,1470214.464,airdrop-20181115-hdac-sum-user-id-withdrawal,accac570-de75-11e8-bd11-2f9252c4dc2f,AIRDROP,0
airdrop-20181115-hdac-d0951a3d-242b-4000-81a9-5510b08d4605-withdrawal-exchange,2018.11.15 10:12,UNKNOWN,,UNKNOWN-55c0f2b7-dc24-425b-9be8-6b86719f2865,2018.11.15 10:12,UNKNOWN,0,100,0,HDAC,WITHDRAWAL,,,,0,COMPLETED,0,sum-user-id,1470114.464,airdrop-20181115-hdac-sum-user-id-withdrawal,accac570-de75-11e8-bd11-2f9252c4dc2f,AIRDROP,0
airdrop-20181115-hdac-d0d3001c-10f7-403b-85d7-21cad2f71f5d-withdrawal-exchange,2018.11.15 10:12,UNKNOWN,,UNKNOWN-55c0f2b7-dc24-425b-9be8-6b86719f2865,2018.11.15 10:12,UNKNOWN,0,100,0,HDAC,WITHDRAWAL,,,,0,COMPLETED,0,sum-user-id,1470014.464,airdrop-20181115-hdac-sum-user-id-withdrawal,accac570-de75-11e8-bd11-2f9252c4dc2f,AIRDROP,0
airdrop-20181115-hdac-d0f7a294-1e7e-43e5-b4c4-104e7e82c0ab-withdrawal-exchange,2018.11.15 10:12,UNKNOWN,,UNKNOWN-55c0f2b7-dc24-425b-9be8-6b86719f2865,2018.11.15 10:12,UNKNOWN,0,100,0,HDAC,WITHDRAWAL,,,,0,COMPLETED,0,sum-user-id,1469914.464,airdrop-20181115-hdac-sum-user-id-withdrawal,accac570-de75-11e8-bd11-2f9252c4dc2f,AIRDROP,0
airdrop-20181115-hdac-d11d9524-e46e-418f-bce1-3ab5be869360-withdrawal-exchange,2018.11.15 10:12,UNKNOWN,,UNKNOWN-55c0f2b7-dc24-425b-9be8-6b86719f2865,2018.11.15 10:12,UNKNOWN,0,100,0,HDAC,WITHDRAWAL,,,,0,COMPLETED,0,sum-user-id,1469814.464,airdrop-20181115-hdac-sum-user-id-withdrawal,accac570-de75-11e8-bd11-2f9252c4dc2f,AIRDROP,0
airdrop-20181115-hdac-d16a4e74-a3b9-4ab6-bda0-bc114e2042ec-withdrawal-exchange,2018.11.15 10:12,UNKNOWN,,UNKNOWN-55c0f2b7-dc24-425b-9be8-6b86719f2865,2018.11.15 10:12,UNKNOWN,0,100,0,HDAC,WITHDRAWAL,,,,0,COMPLETED,0,sum-user-id,1469714.464,airdrop-20181115-hdac-sum-user-id-withdrawal,accac570-de75-11e8-bd11-2f9252c4dc2f,AIRDROP,0
airdrop-20181115-hdac-d1705066-447a-47b3-b45a-8949038fb7ba-withdrawal-exchange,2018.11.15 10:12,UNKNOWN,,UNKNOWN-55c0f2b7-dc24-425b-9be8-6b86719f2865,2018.11.15 10:12,UNKNOWN,0,100,0,HDAC,WITHDRAWAL,,,,0,COMPLETED,0,sum-user-id,1469614.464,airdrop-20181115-hdac-sum-user-id-withdrawal,accac570-de75-11e8-bd11-2f9252c4dc2f,AIRDROP,0
airdrop-20181115-hdac-d18964d6-c670-428a-81f3-90d3d3e52e37-withdrawal-exchange,2018.11.15 10:12,UNKNOWN,,UNKNOWN-55c0f2b7-dc24-425b-9be8-6b86719f2865,2018.11.15 10:12,UNKNOWN,0,100,0,HDAC,WITHDRAWAL,,,,0,COMPLETED,0,sum-user-id,1469514.464,airdrop-20181115-hdac-sum-user-id-withdrawal,accac570-de75-11e8-bd11-2f9252c4dc2f,AIRDROP,0
airdrop-20181115-hdac-d19355d6-ac3f-41af-8a16-61c9b10c3ea4-withdrawal-exchange,2018.11.15 10:12,UNKNOWN,,UNKNOWN-55c0f2b7-dc24-425b-9be8-6b86719f2865,2018.11.15 10:12,UNKNOWN,0,100,0,HDAC,WITHDRAWAL,,,,0,COMPLETED,0,sum-user-id,1469414.464,airdrop-20181115-hdac-sum-user-id-withdrawal,accac570-de75-11e8-bd11-2f9252c4dc2f,AIRDROP,0
airdrop-20181115-hdac-d1a1735b-1cdd-498c-bb73-faa4daa89510-withdrawal-exchange,2018.11.15 10:12,UNKNOWN,,UNKNOWN-55c0f2b7-dc24-425b-9be8-6b86719f2865,2018.11.15 10:12,UNKNOWN,0,100,0,HDAC,WITHDRAWAL,,,,0,COMPLETED,0,sum-user-id,1469314.464,airdrop-20181115-hdac-sum-user-id-withdrawal,accac570-de75-11e8-bd11-2f9252c4dc2f,AIRDROP,0
airdrop-20181115-hdac-d1b01d89-2081-4104-809b-81e9d3979dd7-withdrawal-exchange,2018.11.15 10:12,UNKNOWN,,UNKNOWN-55c0f2b7-dc24-425b-9be8-6b86719f2865,2018.11.15 10:12,UNKNOWN,0,100,0,HDAC,WITHDRAWAL,,,,0,COMPLETED,0,sum-user-id,1469214.464,airdrop-20181115-hdac-sum-user-id-withdrawal,accac570-de75-11e8-bd11-2f9252c4dc2f,AIRDROP,0
airdrop-20181115-hdac-d1d9c8f8-21ea-4fa4-94ce-bda48ed23fa3-withdrawal-exchange,2018.11.15 10:12,UNKNOWN,,UNKNOWN-55c0f2b7-dc24-425b-9be8-6b86719f2865,2018.11.15 10:12,UNKNOWN,0,100,0,HDAC,WITHDRAWAL,,,,0,COMPLETED,0,sum-user-id,1469114.464,airdrop-20181115-hdac-sum-user-id-withdrawal,accac570-de75-11e8-bd11-2f9252c4dc2f,AIRDROP,0
airdrop-20181115-hdac-d1db684d-6229-49ab-9358-fd5d0eec14b4-withdrawal-exchange,2018.11.15 10:12,UNKNOWN,,UNKNOWN-55c0f2b7-dc24-425b-9be8-6b86719f2865,2018.11.15 10:12,UNKNOWN,0,100,0,HDAC,WITHDRAWAL,,,,0,COMPLETED,0,sum-user-id,1469014.464,airdrop-20181115-hdac-sum-user-id-withdrawal,accac570-de75-11e8-bd11-2f9252c4dc2f,AIRDROP,0
airdrop-20181115-hdac-d2199b67-5698-4e20-8549-8bbd51e65518-withdrawal-exchange,2018.11.15 10:12,UNKNOWN,,UNKNOWN-55c0f2b7-dc24-425b-9be8-6b86719f2865,2018.11.15 10:12,UNKNOWN,0,100,0,HDAC,WITHDRAWAL,,,,0,COMPLETED,0,sum-user-id,1468914.464,airdrop-20181115-hdac-sum-user-id-withdrawal,accac570-de75-11e8-bd11-2f9252c4dc2f,AIRDROP,0
airdrop-20181115-hdac-d240d62c-d678-44f0-94bb-b590fa28f0ef-withdrawal-exchange,2018.11.15 10:12,UNKNOWN,,UNKNOWN-55c0f2b7-dc24-425b-9be8-6b86719f2865,2018.11.15 10:12,UNKNOWN,0,100,0,HDAC,WITHDRAWAL,,,,0,COMPLETED,0,sum-user-id,1468814.464,airdrop-20181115-hdac-sum-user-id-withdrawal,accac570-de75-11e8-bd11-2f9252c4dc2f,AIRDROP,0
airdrop-20181115-hdac-d267657d-fdd3-414a-b433-a718a3d60589-withdrawal-exchange,2018.11.15 10:12,UNKNOWN,,UNKNOWN-55c0f2b7-dc24-425b-9be8-6b86719f2865,2018.11.15 10:12,UNKNOWN,0,100,0,HDAC,WITHDRAWAL,,,,0,COMPLETED,0,sum-user-id,1468714.464,airdrop-20181115-hdac-sum-user-id-withdrawal,accac570-de75-11e8-bd11-2f9252c4dc2f,AIRDROP,0
airdrop-20181115-hdac-d26f016b-7757-4131-a116-78a9cda6974c-withdrawal-exchange,2018.11.15 10:12,UNKNOWN,,UNKNOWN-55c0f2b7-dc24-425b-9be8-6b86719f2865,2018.11.15 10:12,UNKNOWN,0,100,0,HDAC,WITHDRAWAL,,,,0,COMPLETED,0,sum-user-id,1468614.464,airdrop-20181115-hdac-sum-user-id-withdrawal,accac570-de75-11e8-bd11-2f9252c4dc2f,AIRDROP,0
airdrop-20181115-hdac-d273fa07-05c9-4759-bd24-1ce6d833eeba-withdrawal-exchange,2018.11.15 10:12,UNKNOWN,,UNKNOWN-55c0f2b7-dc24-425b-9be8-6b86719f2865,2018.11.15 10:12,UNKNOWN,0,100,0,HDAC,WITHDRAWAL,,,,0,COMPLETED,0,sum-user-id,1468514.464,airdrop-20181115-hdac-sum-user-id-withdrawal,accac570-de75-11e8-bd11-2f9252c4dc2f,AIRDROP,0
airdrop-20181115-hdac-d28761c9-8ef2-4d94-af51-c7872e7005a8-withdrawal-exchange,2018.11.15 10:12,UNKNOWN,,UNKNOWN-55c0f2b7-dc24-425b-9be8-6b86719f2865,2018.11.15 10:12,UNKNOWN,0,100,0,HDAC,WITHDRAWAL,,,,0,COMPLETED,0,sum-user-id,1468414.464,airdrop-20181115-hdac-sum-user-id-withdrawal,accac570-de75-11e8-bd11-2f9252c4dc2f,AIRDROP,0
airdrop-20181115-hdac-d28f3dc4-fb7b-43c3-b946-e286a22c5b2a-withdrawal-exchange,2018.11.15 10:12,UNKNOWN,,UNKNOWN-55c0f2b7-dc24-425b-9be8-6b86719f2865,2018.11.15 10:12,UNKNOWN,0,100,0,HDAC,WITHDRAWAL,,,,0,COMPLETED,0,sum-user-id,1468314.464,airdrop-20181115-hdac-sum-user-id-withdrawal,accac570-de75-11e8-bd11-2f9252c4dc2f,AIRDROP,0
airdrop-20181115-hdac-d2932a63-b8c1-4b9c-8496-3801a0cf54f7-withdrawal-exchange,2018.11.15 10:12,UNKNOWN,,UNKNOWN-55c0f2b7-dc24-425b-9be8-6b86719f2865,2018.11.15 10:12,UNKNOWN,0,100,0,HDAC,WITHDRAWAL,,,,0,COMPLETED,0,sum-user-id,1468214.464,airdrop-20181115-hdac-sum-user-id-withdrawal,accac570-de75-11e8-bd11-2f9252c4dc2f,AIRDROP,0
airdrop-20181115-hdac-d2beecfa-bd4e-4013-8491-7de2c5d98f40-withdrawal-exchange,2018.11.15 10:12,UNKNOWN,,UNKNOWN-55c0f2b7-dc24-425b-9be8-6b86719f2865,2018.11.15 10:12,UNKNOWN,0,100,0,HDAC,WITHDRAWAL,,,,0,COMPLETED,0,sum-user-id,1468114.464,airdrop-20181115-hdac-sum-user-id-withdrawal,accac570-de75-11e8-bd11-2f9252c4dc2f,AIRDROP,0
airdrop-20181115-hdac-d2ca6079-bea2-497a-9f92-6e81911d240d-withdrawal-exchange,2018.11.15 10:12,UNKNOWN,,UNKNOWN-55c0f2b7-dc24-425b-9be8-6b86719f2865,2018.11.15 10:12,UNKNOWN,0,100,0,HDAC,WITHDRAWAL,,,,0,COMPLETED,0,sum-user-id,1468014.464,airdrop-20181115-hdac-sum-user-id-withdrawal,accac570-de75-11e8-bd11-2f9252c4dc2f,AIRDROP,0
airdrop-20181115-hdac-d2d84c50-e428-4e86-b21b-5403e057e58c-withdrawal-exchange,2018.11.15 10:12,UNKNOWN,,UNKNOWN-55c0f2b7-dc24-425b-9be8-6b86719f2865,2018.11.15 10:12,UNKNOWN,0,100,0,HDAC,WITHDRAWAL,,,,0,COMPLETED,0,sum-user-id,1467914.464,airdrop-20181115-hdac-sum-user-id-withdrawal,accac570-de75-11e8-bd11-2f9252c4dc2f,AIRDROP,0
airdrop-20181115-hdac-d2e3a9c2-b59e-4f99-bb3c-5b6f4016ec23-withdrawal-exchange,2018.11.15 10:12,UNKNOWN,,UNKNOWN-55c0f2b7-dc24-425b-9be8-6b86719f2865,2018.11.15 10:12,UNKNOWN,0,100,0,HDAC,WITHDRAWAL,,,,0,COMPLETED,0,sum-user-id,1467814.464,airdrop-20181115-hdac-sum-user-id-withdrawal,accac570-de75-11e8-bd11-2f9252c4dc2f,AIRDROP,0
airdrop-20181115-hdac-d2f0d2fd-3418-488d-8d2b-137d4d056422-withdrawal-exchange,2018.11.15 10:12,UNKNOWN,,UNKNOWN-55c0f2b7-dc24-425b-9be8-6b86719f2865,2018.11.15 10:12,UNKNOWN,0,100,0,HDAC,WITHDRAWAL,,,,0,COMPLETED,0,sum-user-id,1467714.464,airdrop-20181115-hdac-sum-user-id-withdrawal,accac570-de75-11e8-bd11-2f9252c4dc2f,AIRDROP,0
airdrop-20181115-hdac-d2f4f569-ca1d-48a3-aa33-9c3f4aa92fa4-withdrawal-exchange,2018.11.15 10:12,UNKNOWN,,UNKNOWN-55c0f2b7-dc24-425b-9be8-6b86719f2865,2018.11.15 10:12,UNKNOWN,0,100,0,HDAC,WITHDRAWAL,,,,0,COMPLETED,0,sum-user-id,1467614.464,airdrop-20181115-hdac-sum-user-id-withdrawal,accac570-de75-11e8-bd11-2f9252c4dc2f,AIRDROP,0
airdrop-20181115-hdac-d2f6b7a3-aac3-4f40-8895-5fb755804e06-withdrawal-exchange,2018-11-15 10:12:13.031,UNKNOWN,,UNKNOWN-55c0f2b7-dc24-425b-9be8-6b86719f2865,2018-11-15 10:12:13.031,UNKNOWN,0,100,0,HDAC,WITHDRAWAL,,,,0,COMPLETED,0,sum-user-id,1467514.464,airdrop-20181115-hdac-sum-user-id-withdrawal,accac570-de75-11e8-bd11-2f9252c4dc2f,AIRDROP,0
airdrop-20181115-hdac-d30a4092-e289-4241-a4c1-e2141dce0f09-withdrawal-exchange,2018-11-15 10:12:13.062,UNKNOWN,,UNKNOWN-55c0f2b7-dc24-425b-9be8-6b86719f2865,2018-11-15 10:12:13.062,UNKNOWN,0,100,0,HDAC,WITHDRAWAL,,,,0,COMPLETED,0,sum-user-id,1467414.464,airdrop-20181115-hdac-sum-user-id-withdrawal,accac570-de75-11e8-bd11-2f9252c4dc2f,AIRDROP,0
airdrop-20181115-hdac-d32ca50f-68a1-48f2-8238-ad4ef17ba43b-withdrawal-exchange,2018-11-15 10:12:13.089,UNKNOWN,,UNKNOWN-55c0f2b7-dc24-425b-9be8-6b86719f2865,2018-11-15 10:12:13.089,UNKNOWN,0,100,0,HDAC,WITHDRAWAL,,,,0,COMPLETED,0,sum-user-id,1467314.464,airdrop-20181115-hdac-sum-user-id-withdrawal,accac570-de75-11e8-bd11-2f9252c4dc2f,AIRDROP,0
airdrop-20181115-hdac-d35168dd-62f5-450f-ba54-90d0acb9881e-withdrawal-exchange,2018.11.15 10:12,UNKNOWN,,UNKNOWN-55c0f2b7-dc24-425b-9be8-6b86719f2865,2018.11.15 10:12,UNKNOWN,0,100,0,HDAC,WITHDRAWAL,,,,0,COMPLETED,0,sum-user-id,1467214.464,airdrop-20181115-hdac-sum-user-id-withdrawal,accac570-de75-11e8-bd11-2f9252c4dc2f,AIRDROP,0
airdrop-20181115-hdac-d3535864-40ab-4589-b632-2221894b7c98-withdrawal-exchange,2018.11.15 10:12,UNKNOWN,,UNKNOWN-55c0f2b7-dc24-425b-9be8-6b86719f2865,2018.11.15 10:12,UNKNOWN,0,100,0,HDAC,WITHDRAWAL,,,,0,COMPLETED,0,sum-user-id,1467114.464,airdrop-20181115-hdac-sum-user-id-withdrawal,accac570-de75-11e8-bd11-2f9252c4dc2f,AIRDROP,0
airdrop-20181115-hdac-d3600a0c-65f4-4fae-befa-0249d094c26e-withdrawal-exchange,2018.11.15 10:12,UNKNOWN,,UNKNOWN-55c0f2b7-dc24-425b-9be8-6b86719f2865,2018.11.15 10:12,UNKNOWN,0,100,0,HDAC,WITHDRAWAL,,,,0,COMPLETED,0,sum-user-id,1467014.464,airdrop-20181115-hdac-sum-user-id-withdrawal,accac570-de75-11e8-bd11-2f9252c4dc2f,AIRDROP,0
airdrop-20181115-hdac-d36183ea-ab67-42b3-922e-cca2235cde35-withdrawal-exchange,2018.11.15 10:12,UNKNOWN,,UNKNOWN-55c0f2b7-dc24-425b-9be8-6b86719f2865,2018.11.15 10:12,UNKNOWN,0,100,0,HDAC,WITHDRAWAL,,,,0,COMPLETED,0,sum-user-id,1466914.464,airdrop-20181115-hdac-sum-user-id-withdrawal,accac570-de75-11e8-bd11-2f9252c4dc2f,AIRDROP,0
airdrop-20181115-hdac-d3861e69-3b52-4d76-9719-65397067d949-withdrawal-exchange,2018.11.15 10:12,UNKNOWN,,UNKNOWN-55c0f2b7-dc24-425b-9be8-6b86719f2865,2018.11.15 10:12,UNKNOWN,0,100,0,HDAC,WITHDRAWAL,,,,0,COMPLETED,0,sum-user-id,1466814.464,airdrop-20181115-hdac-sum-user-id-withdrawal,accac570-de75-11e8-bd11-2f9252c4dc2f,AIRDROP,0
airdrop-20181115-hdac-d406d153-fe04-40f1-b6a5-366f53239a7f-withdrawal-exchange,2018.11.15 10:12,UNKNOWN,,UNKNOWN-55c0f2b7-dc24-425b-9be8-6b86719f2865,2018.11.15 10:12,UNKNOWN,0,100,0,HDAC,WITHDRAWAL,,,,0,COMPLETED,0,sum-user-id,1466714.464,airdrop-20181115-hdac-sum-user-id-withdrawal,accac570-de75-11e8-bd11-2f9252c4dc2f,AIRDROP,0
airdrop-20181115-hdac-d40d3276-40ee-412c-855d-1560127dda61-withdrawal-exchange,2018.11.15 10:12,UNKNOWN,,UNKNOWN-55c0f2b7-dc24-425b-9be8-6b86719f2865,2018.11.15 10:12,UNKNOWN,0,100,0,HDAC,WITHDRAWAL,,,,0,COMPLETED,0,sum-user-id,1466614.464,airdrop-20181115-hdac-sum-user-id-withdrawal,accac570-de75-11e8-bd11-2f9252c4dc2f,AIRDROP,0
airdrop-20181115-hdac-d42006e1-b8b5-47d0-978e-12389d0f393e-withdrawal-exchange,2018.11.15 10:12,UNKNOWN,,UNKNOWN-55c0f2b7-dc24-425b-9be8-6b86719f2865,2018.11.15 10:12,UNKNOWN,0,100,0,HDAC,WITHDRAWAL,,,,0,COMPLETED,0,sum-user-id,1466514.464,airdrop-20181115-hdac-sum-user-id-withdrawal,accac570-de75-11e8-bd11-2f9252c4dc2f,AIRDROP,0
airdrop-20181115-hdac-d42c5227-8bc3-493c-8494-2ba9fb4f798f-withdrawal-exchange,2018.11.15 10:12,UNKNOWN,,UNKNOWN-55c0f2b7-dc24-425b-9be8-6b86719f2865,2018.11.15 10:12,UNKNOWN,0,100,0,HDAC,WITHDRAWAL,,,,0,COMPLETED,0,sum-user-id,1466414.464,airdrop-20181115-hdac-sum-user-id-withdrawal,accac570-de75-11e8-bd11-2f9252c4dc2f,AIRDROP,0
airdrop-20181115-hdac-d43b5f0d-afc3-4394-988f-579ebd667276-withdrawal-exchange,2018.11.15 10:12,UNKNOWN,,UNKNOWN-55c0f2b7-dc24-425b-9be8-6b86719f2865,2018.11.15 10:12,UNKNOWN,0,100,0,HDAC,WITHDRAWAL,,,,0,COMPLETED,0,sum-user-id,1466314.464,airdrop-20181115-hdac-sum-user-id-withdrawal,accac570-de75-11e8-bd11-2f9252c4dc2f,AIRDROP,0
airdrop-20181115-hdac-d46e18fd-1c75-4b29-8ecf-ce1767b73333-withdrawal-exchange,2018.11.15 10:12,UNKNOWN,,UNKNOWN-55c0f2b7-dc24-425b-9be8-6b86719f2865,2018.11.15 10:12,UNKNOWN,0,100,0,HDAC,WITHDRAWAL,,,,0,COMPLETED,0,sum-user-id,1466214.464,airdrop-20181115-hdac-sum-user-id-withdrawal,accac570-de75-11e8-bd11-2f9252c4dc2f,AIRDROP,0
airdrop-20181115-hdac-d471ab5c-71ad-46db-b856-fc3acfbd4cf2-withdrawal-exchange,2018.11.15 10:12,UNKNOWN,,UNKNOWN-55c0f2b7-dc24-425b-9be8-6b86719f2865,2018.11.15 10:12,UNKNOWN,0,100,0,HDAC,WITHDRAWAL,,,,0,COMPLETED,0,sum-user-id,1466114.464,airdrop-20181115-hdac-sum-user-id-withdrawal,accac570-de75-11e8-bd11-2f9252c4dc2f,AIRDROP,0
airdrop-20181115-hdac-d49236e1-7af4-414e-b940-a92e0c1713e0-withdrawal-exchange,2018.11.15 10:12,UNKNOWN,,UNKNOWN-55c0f2b7-dc24-425b-9be8-6b86719f2865,2018.11.15 10:12,UNKNOWN,0,100,0,HDAC,WITHDRAWAL,,,,0,COMPLETED,0,sum-user-id,1466014.464,airdrop-20181115-hdac-sum-user-id-withdrawal,accac570-de75-11e8-bd11-2f9252c4dc2f,AIRDROP,0
airdrop-20181115-hdac-d4cd95b7-16c7-46c0-8db6-a34c2233092d-withdrawal-exchange,2018.11.15 10:12,UNKNOWN,,UNKNOWN-55c0f2b7-dc24-425b-9be8-6b86719f2865,2018.11.15 10:12,UNKNOWN,0,100,0,HDAC,WITHDRAWAL,,,,0,COMPLETED,0,sum-user-id,1465914.464,airdrop-20181115-hdac-sum-user-id-withdrawal,accac570-de75-11e8-bd11-2f9252c4dc2f,AIRDROP,0
airdrop-20181115-hdac-d4e6e995-0a1a-401e-8c71-787be4fbbb39-withdrawal-exchange,2018.11.15 10:12,UNKNOWN,,UNKNOWN-55c0f2b7-dc24-425b-9be8-6b86719f2865,2018.11.15 10:12,UNKNOWN,0,100,0,HDAC,WITHDRAWAL,,,,0,COMPLETED,0,sum-user-id,1465814.464,airdrop-20181115-hdac-sum-user-id-withdrawal,accac570-de75-11e8-bd11-2f9252c4dc2f,AIRDROP,0
airdrop-20181115-hdac-d502d465-df79-4c06-908f-11581b9a4946-withdrawal-exchange,2018.11.15 10:12,UNKNOWN,,UNKNOWN-55c0f2b7-dc24-425b-9be8-6b86719f2865,2018.11.15 10:12,UNKNOWN,0,100,0,HDAC,WITHDRAWAL,,,,0,COMPLETED,0,sum-user-id,1465714.464,airdrop-20181115-hdac-sum-user-id-withdrawal,accac570-de75-11e8-bd11-2f9252c4dc2f,AIRDROP,0
airdrop-20181115-hdac-d50b67f8-2ed7-4dc4-a1a4-6055beeb30cb-withdrawal-exchange,2018.11.15 10:12,UNKNOWN,,UNKNOWN-55c0f2b7-dc24-425b-9be8-6b86719f2865,2018.11.15 10:12,UNKNOWN,0,100,0,HDAC,WITHDRAWAL,,,,0,COMPLETED,0,sum-user-id,1465614.464,airdrop-20181115-hdac-sum-user-id-withdrawal,accac570-de75-11e8-bd11-2f9252c4dc2f,AIRDROP,0
airdrop-20181115-hdac-d52dfda6-3ddf-4539-bb8e-16910df76003-withdrawal-exchange,2018.11.15 10:12,UNKNOWN,,UNKNOWN-55c0f2b7-dc24-425b-9be8-6b86719f2865,2018.11.15 10:12,UNKNOWN,0,100,0,HDAC,WITHDRAWAL,,,,0,COMPLETED,0,sum-user-id,1465514.464,airdrop-20181115-hdac-sum-user-id-withdrawal,accac570-de75-11e8-bd11-2f9252c4dc2f,AIRDROP,0
airdrop-20181115-hdac-d55a999a-07bf-4eba-a3da-217ab324482e-withdrawal-exchange,2018.11.15 10:12,UNKNOWN,,UNKNOWN-55c0f2b7-dc24-425b-9be8-6b86719f2865,2018.11.15 10:12,UNKNOWN,0,14992.5,0,HDAC,WITHDRAWAL,,,,0,COMPLETED,0,sum-user-id,1450521.964,airdrop-20181115-hdac-sum-user-id-withdrawal,accac570-de75-11e8-bd11-2f9252c4dc2f,AIRDROP,0
airdrop-20181115-hdac-d5618953-7f80-4d05-a258-9050da7d5d3a-withdrawal-exchange,2018.11.15 10:12,UNKNOWN,,UNKNOWN-55c0f2b7-dc24-425b-9be8-6b86719f2865,2018.11.15 10:12,UNKNOWN,0,100,0,HDAC,WITHDRAWAL,,,,0,COMPLETED,0,sum-user-id,1450421.964,airdrop-20181115-hdac-sum-user-id-withdrawal,accac570-de75-11e8-bd11-2f9252c4dc2f,AIRDROP,0
airdrop-20181115-hdac-d564e5fd-cad7-4328-b6bf-39cb0647c322-withdrawal-exchange,2018.11.15 10:12,UNKNOWN,,UNKNOWN-55c0f2b7-dc24-425b-9be8-6b86719f2865,2018.11.15 10:12,UNKNOWN,0,100,0,HDAC,WITHDRAWAL,,,,0,COMPLETED,0,sum-user-id,1450321.964,airdrop-20181115-hdac-sum-user-id-withdrawal,accac570-de75-11e8-bd11-2f9252c4dc2f,AIRDROP,0
airdrop-20181115-hdac-d56f1fab-f1b1-443a-ab47-b6481e28bf80-withdrawal-exchange,2018.11.15 10:12,UNKNOWN,,UNKNOWN-55c0f2b7-dc24-425b-9be8-6b86719f2865,2018.11.15 10:12,UNKNOWN,0,100,0,HDAC,WITHDRAWAL,,,,0,COMPLETED,0,sum-user-id,1450221.964,airdrop-20181115-hdac-sum-user-id-withdrawal,accac570-de75-11e8-bd11-2f9252c4dc2f,AIRDROP,0
airdrop-20181115-hdac-d58cbeb6-135c-4f31-bef7-3c198a7be91b-withdrawal-exchange,2018.11.15 10:12,UNKNOWN,,UNKNOWN-55c0f2b7-dc24-425b-9be8-6b86719f2865,2018.11.15 10:12,UNKNOWN,0,100,0,HDAC,WITHDRAWAL,,,,0,COMPLETED,0,sum-user-id,1450121.964,airdrop-20181115-hdac-sum-user-id-withdrawal,accac570-de75-11e8-bd11-2f9252c4dc2f,AIRDROP,0
airdrop-20181115-hdac-d595fee1-5ab3-4284-abb4-355e29772ad8-withdrawal-exchange,2018.11.15 10:12,UNKNOWN,,UNKNOWN-55c0f2b7-dc24-425b-9be8-6b86719f2865,2018.11.15 10:12,UNKNOWN,0,100,0,HDAC,WITHDRAWAL,,,,0,COMPLETED,0,sum-user-id,1450021.964,airdrop-20181115-hdac-sum-user-id-withdrawal,accac570-de75-11e8-bd11-2f9252c4dc2f,AIRDROP,0
airdrop-20181115-hdac-d5a8301d-6d99-4aef-9444-73043a6412fe-withdrawal-exchange,2018.11.15 10:12,UNKNOWN,,UNKNOWN-55c0f2b7-dc24-425b-9be8-6b86719f2865,2018.11.15 10:12,UNKNOWN,0,100,0,HDAC,WITHDRAWAL,,,,0,COMPLETED,0,sum-user-id,1449921.964,airdrop-20181115-hdac-sum-user-id-withdrawal,accac570-de75-11e8-bd11-2f9252c4dc2f,AIRDROP,0
airdrop-20181115-hdac-d5baccac-8750-4a7a-a698-89a7fb3b96e5-withdrawal-exchange,2018.11.15 10:12,UNKNOWN,,UNKNOWN-55c0f2b7-dc24-425b-9be8-6b86719f2865,2018.11.15 10:12,UNKNOWN,0,100,0,HDAC,WITHDRAWAL,,,,0,COMPLETED,0,sum-user-id,1449821.964,airdrop-20181115-hdac-sum-user-id-withdrawal,accac570-de75-11e8-bd11-2f9252c4dc2f,AIRDROP,0
airdrop-20181115-hdac-d5cfc0f4-e510-49b0-8f28-4050d466c6d5-withdrawal-exchange,2018.11.15 10:12,UNKNOWN,,UNKNOWN-55c0f2b7-dc24-425b-9be8-6b86719f2865,2018.11.15 10:12,UNKNOWN,0,100,0,HDAC,WITHDRAWAL,,,,0,COMPLETED,0,sum-user-id,1449721.964,airdrop-20181115-hdac-sum-user-id-withdrawal,accac570-de75-11e8-bd11-2f9252c4dc2f,AIRDROP,0
airdrop-20181115-hdac-d5d42dac-47d2-4828-83be-c347951ad268-withdrawal-exchange,2018.11.15 10:12,UNKNOWN,,UNKNOWN-55c0f2b7-dc24-425b-9be8-6b86719f2865,2018.11.15 10:12,UNKNOWN,0,100,0,HDAC,WITHDRAWAL,,,,0,COMPLETED,0,sum-user-id,1449621.964,airdrop-20181115-hdac-sum-user-id-withdrawal,accac570-de75-11e8-bd11-2f9252c4dc2f,AIRDROP,0
airdrop-20181115-hdac-d5d5828a-d906-42d2-b8d3-9e73e40ac1d0-withdrawal-exchange,2018.11.15 10:12,UNKNOWN,,UNKNOWN-55c0f2b7-dc24-425b-9be8-6b86719f2865,2018.11.15 10:12,UNKNOWN,0,100,0,HDAC,WITHDRAWAL,,,,0,COMPLETED,0,sum-user-id,1449521.964,airdrop-20181115-hdac-sum-user-id-withdrawal,accac570-de75-11e8-bd11-2f9252c4dc2f,AIRDROP,0
airdrop-20181115-hdac-d5f59c46-ca19-4174-8fe2-0686a1c4b050-withdrawal-exchange,2018-11-15 10:12:14.015,UNKNOWN,,UNKNOWN-55c0f2b7-dc24-425b-9be8-6b86719f2865,2018-11-15 10:12:14.015,UNKNOWN,0,100,0,HDAC,WITHDRAWAL,,,,0,COMPLETED,0,sum-user-id,1449421.964,airdrop-20181115-hdac-sum-user-id-withdrawal,accac570-de75-11e8-bd11-2f9252c4dc2f,AIRDROP,0
airdrop-20181115-hdac-d606a91b-8fcb-42ba-8639-29c7d12f2e65-withdrawal-exchange,2018-11-15 10:12:14.047,UNKNOWN,,UNKNOWN-55c0f2b7-dc24-425b-9be8-6b86719f2865,2018-11-15 10:12:14.047,UNKNOWN,0,100,0,HDAC,WITHDRAWAL,,,,0,COMPLETED,0,sum-user-id,1449321.964,airdrop-20181115-hdac-sum-user-id-withdrawal,accac570-de75-11e8-bd11-2f9252c4dc2f,AIRDROP,0
airdrop-20181115-hdac-d6083967-e7e1-4f09-bc97-faa21b45265a-withdrawal-exchange,2018-11-15 10:12:14.075,UNKNOWN,,UNKNOWN-55c0f2b7-dc24-425b-9be8-6b86719f2865,2018-11-15 10:12:14.075,UNKNOWN,0,100,0,HDAC,WITHDRAWAL,,,,0,COMPLETED,0,sum-user-id,1449221.964,airdrop-20181115-hdac-sum-user-id-withdrawal,accac570-de75-11e8-bd11-2f9252c4dc2f,AIRDROP,0
airdrop-20181115-hdac-d60e6fab-f2c1-4f5b-bbb2-16d54b420ba5-withdrawal-exchange,2018.11.15 10:12,UNKNOWN,,UNKNOWN-55c0f2b7-dc24-425b-9be8-6b86719f2865,2018.11.15 10:12,UNKNOWN,0,100,0,HDAC,WITHDRAWAL,,,,0,COMPLETED,0,sum-user-id,1449121.964,airdrop-20181115-hdac-sum-user-id-withdrawal,accac570-de75-11e8-bd11-2f9252c4dc2f,AIRDROP,0
airdrop-20181115-hdac-d63665e2-1cb0-47bd-934c-9cba03422aaa-withdrawal-exchange,2018.11.15 10:12,UNKNOWN,,UNKNOWN-55c0f2b7-dc24-425b-9be8-6b86719f2865,2018.11.15 10:12,UNKNOWN,0,100,0,HDAC,WITHDRAWAL,,,,0,COMPLETED,0,sum-user-id,1449021.964,airdrop-20181115-hdac-sum-user-id-withdrawal,accac570-de75-11e8-bd11-2f9252c4dc2f,AIRDROP,0
airdrop-20181115-hdac-d64ffc51-66e8-4eb6-b47a-d25d19b6a6ef-withdrawal-exchange,2018.11.15 10:12,UNKNOWN,,UNKNOWN-55c0f2b7-dc24-425b-9be8-6b86719f2865,2018.11.15 10:12,UNKNOWN,0,100,0,HDAC,WITHDRAWAL,,,,0,COMPLETED,0,sum-user-id,1448921.964,airdrop-20181115-hdac-sum-user-id-withdrawal,accac570-de75-11e8-bd11-2f9252c4dc2f,AIRDROP,0
airdrop-20181115-hdac-d65e802e-3ed2-44a3-a191-5e6a52ee8ed7-withdrawal-exchange,2018.11.15 10:12,UNKNOWN,,UNKNOWN-55c0f2b7-dc24-425b-9be8-6b86719f2865,2018.11.15 10:12,UNKNOWN,0,100,0,HDAC,WITHDRAWAL,,,,0,COMPLETED,0,sum-user-id,1448821.964,airdrop-20181115-hdac-sum-user-id-withdrawal,accac570-de75-11e8-bd11-2f9252c4dc2f,AIRDROP,0
airdrop-20181115-hdac-d6752aab-a96a-49e5-a317-9080394c1c7e-withdrawal-exchange,2018.11.15 10:12,UNKNOWN,,UNKNOWN-55c0f2b7-dc24-425b-9be8-6b86719f2865,2018.11.15 10:12,UNKNOWN,0,100,0,HDAC,WITHDRAWAL,,,,0,COMPLETED,0,sum-user-id,1448721.964,airdrop-20181115-hdac-sum-user-id-withdrawal,accac570-de75-11e8-bd11-2f9252c4dc2f,AIRDROP,0
airdrop-20181115-hdac-d683d478-6c80-4707-a078-e6048ff194e3-withdrawal-exchange,2018.11.15 10:12,UNKNOWN,,UNKNOWN-55c0f2b7-dc24-425b-9be8-6b86719f2865,2018.11.15 10:12,UNKNOWN,0,100,0,HDAC,WITHDRAWAL,,,,0,COMPLETED,0,sum-user-id,1448621.964,airdrop-20181115-hdac-sum-user-id-withdrawal,accac570-de75-11e8-bd11-2f9252c4dc2f,AIRDROP,0
airdrop-20181115-hdac-d6b7b4f1-a067-4207-bcec-44a4ee0872f1-withdrawal-exchange,2018.11.15 10:12,UNKNOWN,,UNKNOWN-55c0f2b7-dc24-425b-9be8-6b86719f2865,2018.11.15 10:12,UNKNOWN,0,100,0,HDAC,WITHDRAWAL,,,,0,COMPLETED,0,sum-user-id,1448521.964,airdrop-20181115-hdac-sum-user-id-withdrawal,accac570-de75-11e8-bd11-2f9252c4dc2f,AIRDROP,0
airdrop-20181115-hdac-d6ba64fe-4b01-4e77-957b-9b20d310fceb-withdrawal-exchange,2018.11.15 10:12,UNKNOWN,,UNKNOWN-55c0f2b7-dc24-425b-9be8-6b86719f2865,2018.11.15 10:12,UNKNOWN,0,100,0,HDAC,WITHDRAWAL,,,,0,COMPLETED,0,sum-user-id,1448421.964,airdrop-20181115-hdac-sum-user-id-withdrawal,accac570-de75-11e8-bd11-2f9252c4dc2f,AIRDROP,0
airdrop-20181115-hdac-d6e2826f-7fa9-4c00-a4a9-8cc1258a6d6c-withdrawal-exchange,2018.11.15 10:12,UNKNOWN,,UNKNOWN-55c0f2b7-dc24-425b-9be8-6b86719f2865,2018.11.15 10:12,UNKNOWN,0,100,0,HDAC,WITHDRAWAL,,,,0,COMPLETED,0,sum-user-id,1448321.964,airdrop-20181115-hdac-sum-user-id-withdrawal,accac570-de75-11e8-bd11-2f9252c4dc2f,AIRDROP,0
airdrop-20181115-hdac-d6ecd82e-6ae0-46cd-9502-54bab3117591-withdrawal-exchange,2018.11.15 10:12,UNKNOWN,,UNKNOWN-55c0f2b7-dc24-425b-9be8-6b86719f2865,2018.11.15 10:12,UNKNOWN,0,2173.226814,0,HDAC,WITHDRAWAL,,,,0,COMPLETED,0,sum-user-id,1446148.737,airdrop-20181115-hdac-sum-user-id-withdrawal,accac570-de75-11e8-bd11-2f9252c4dc2f,AIRDROP,0
airdrop-20181115-hdac-d6f52382-758d-40d7-a217-8eff86f1fe2c-withdrawal-exchange,2018.11.15 10:12,UNKNOWN,,UNKNOWN-55c0f2b7-dc24-425b-9be8-6b86719f2865,2018.11.15 10:12,UNKNOWN,0,100,0,HDAC,WITHDRAWAL,,,,0,COMPLETED,0,sum-user-id,1446048.737,airdrop-20181115-hdac-sum-user-id-withdrawal,accac570-de75-11e8-bd11-2f9252c4dc2f,AIRDROP,0
airdrop-20181115-hdac-d701be7d-b194-413b-835a-fc31fc0481af-withdrawal-exchange,2018.11.15 10:12,UNKNOWN,,UNKNOWN-55c0f2b7-dc24-425b-9be8-6b86719f2865,2018.11.15 10:12,UNKNOWN,0,100,0,HDAC,WITHDRAWAL,,,,0,COMPLETED,0,sum-user-id,1445948.737,airdrop-20181115-hdac-sum-user-id-withdrawal,accac570-de75-11e8-bd11-2f9252c4dc2f,AIRDROP,0
airdrop-20181115-hdac-d73a8895-a969-47c4-956a-bab863f2282b-withdrawal-exchange,2018.11.15 10:12,UNKNOWN,,UNKNOWN-55c0f2b7-dc24-425b-9be8-6b86719f2865,2018.11.15 10:12,UNKNOWN,0,100,0,HDAC,WITHDRAWAL,,,,0,COMPLETED,0,sum-user-id,1445848.737,airdrop-20181115-hdac-sum-user-id-withdrawal,accac570-de75-11e8-bd11-2f9252c4dc2f,AIRDROP,0
airdrop-20181115-hdac-d747c8e0-c2c4-4d1d-910c-7003c83809de-withdrawal-exchange,2018.11.15 10:12,UNKNOWN,,UNKNOWN-55c0f2b7-dc24-425b-9be8-6b86719f2865,2018.11.15 10:12,UNKNOWN,0,100,0,HDAC,WITHDRAWAL,,,,0,COMPLETED,0,sum-user-id,1445748.737,airdrop-20181115-hdac-sum-user-id-withdrawal,accac570-de75-11e8-bd11-2f9252c4dc2f,AIRDROP,0
airdrop-20181115-hdac-d75e4c9e-8a34-40c3-83cb-2e389f2485a4-withdrawal-exchange,2018.11.15 10:12,UNKNOWN,,UNKNOWN-55c0f2b7-dc24-425b-9be8-6b86719f2865,2018.11.15 10:12,UNKNOWN,0,100,0,HDAC,WITHDRAWAL,,,,0,COMPLETED,0,sum-user-id,1445648.737,airdrop-20181115-hdac-sum-user-id-withdrawal,accac570-de75-11e8-bd11-2f9252c4dc2f,AIRDROP,0
airdrop-20181115-hdac-d783715c-484e-4c2d-b5b0-ed8032ca96b2-withdrawal-exchange,2018.11.15 10:12,UNKNOWN,,UNKNOWN-55c0f2b7-dc24-425b-9be8-6b86719f2865,2018.11.15 10:12,UNKNOWN,0,100,0,HDAC,WITHDRAWAL,,,,0,COMPLETED,0,sum-user-id,1445548.737,airdrop-20181115-hdac-sum-user-id-withdrawal,accac570-de75-11e8-bd11-2f9252c4dc2f,AIRDROP,0
airdrop-20181115-hdac-d7c9fae4-aa69-4fc5-8eb3-3deabb95e3f8-withdrawal-exchange,2018.11.15 10:12,UNKNOWN,,UNKNOWN-55c0f2b7-dc24-425b-9be8-6b86719f2865,2018.11.15 10:12,UNKNOWN,0,100,0,HDAC,WITHDRAWAL,,,,0,COMPLETED,0,sum-user-id,1445448.737,airdrop-20181115-hdac-sum-user-id-withdrawal,accac570-de75-11e8-bd11-2f9252c4dc2f,AIRDROP,0
airdrop-20181115-hdac-d7f7854b-fa90-4805-bab1-5920606f3757-withdrawal-exchange,2018.11.15 10:12,UNKNOWN,,UNKNOWN-55c0f2b7-dc24-425b-9be8-6b86719f2865,2018.11.15 10:12,UNKNOWN,0,100,0,HDAC,WITHDRAWAL,,,,0,COMPLETED,0,sum-user-id,1445348.737,airdrop-20181115-hdac-sum-user-id-withdrawal,accac570-de75-11e8-bd11-2f9252c4dc2f,AIRDROP,0
airdrop-20181115-hdac-d7f8532d-9075-45f4-9ae4-434417bd139f-withdrawal-exchange,2018.11.15 10:12,UNKNOWN,,UNKNOWN-55c0f2b7-dc24-425b-9be8-6b86719f2865,2018.11.15 10:12,UNKNOWN,0,100,0,HDAC,WITHDRAWAL,,,,0,COMPLETED,0,sum-user-id,1445248.737,airdrop-20181115-hdac-sum-user-id-withdrawal,accac570-de75-11e8-bd11-2f9252c4dc2f,AIRDROP,0
airdrop-20181115-hdac-d7f92c26-6b37-4ed9-bd5b-13fbc68cd6f5-withdrawal-exchange,2018.11.15 10:12,UNKNOWN,,UNKNOWN-55c0f2b7-dc24-425b-9be8-6b86719f2865,2018.11.15 10:12,UNKNOWN,0,100,0,HDAC,WITHDRAWAL,,,,0,COMPLETED,0,sum-user-id,1445148.737,airdrop-20181115-hdac-sum-user-id-withdrawal,accac570-de75-11e8-bd11-2f9252c4dc2f,AIRDROP,0
airdrop-20181115-hdac-d81cfb66-07df-43a6-ac62-b483b18de83f-withdrawal-exchange,2018.11.15 10:12,UNKNOWN,,UNKNOWN-55c0f2b7-dc24-425b-9be8-6b86719f2865,2018.11.15 10:12,UNKNOWN,0,100,0,HDAC,WITHDRAWAL,,,,0,COMPLETED,0,sum-user-id,1445048.737,airdrop-20181115-hdac-sum-user-id-withdrawal,accac570-de75-11e8-bd11-2f9252c4dc2f,AIRDROP,0
airdrop-20181115-hdac-d82cf5e1-12b2-4738-8501-5e08d47025e3-withdrawal-exchange,2018.11.15 10:12,UNKNOWN,,UNKNOWN-55c0f2b7-dc24-425b-9be8-6b86719f2865,2018.11.15 10:12,UNKNOWN,0,100,0,HDAC,WITHDRAWAL,,,,0,COMPLETED,0,sum-user-id,1444948.737,airdrop-20181115-hdac-sum-user-id-withdrawal,accac570-de75-11e8-bd11-2f9252c4dc2f,AIRDROP,0
airdrop-20181115-hdac-d887dcb8-0b96-45b4-867c-dd0b515d3cf8-withdrawal-exchange,2018.11.15 10:12,UNKNOWN,,UNKNOWN-55c0f2b7-dc24-425b-9be8-6b86719f2865,2018.11.15 10:12,UNKNOWN,0,100,0,HDAC,WITHDRAWAL,,,,0,COMPLETED,0,sum-user-id,1444848.737,airdrop-20181115-hdac-sum-user-id-withdrawal,accac570-de75-11e8-bd11-2f9252c4dc2f,AIRDROP,0
airdrop-20181115-hdac-d8983ba1-3fb6-4dfe-8d08-1f4c2e295010-withdrawal-exchange,2018.11.15 10:12,UNKNOWN,,UNKNOWN-55c0f2b7-dc24-425b-9be8-6b86719f2865,2018.11.15 10:12,UNKNOWN,0,100,0,HDAC,WITHDRAWAL,,,,0,COMPLETED,0,sum-user-id,1444748.737,airdrop-20181115-hdac-sum-user-id-withdrawal,accac570-de75-11e8-bd11-2f9252c4dc2f,AIRDROP,0
airdrop-20181115-hdac-d8b1031e-e397-4cfc-b837-835c31a50840-withdrawal-exchange,2018.11.15 10:12,UNKNOWN,,UNKNOWN-55c0f2b7-dc24-425b-9be8-6b86719f2865,2018.11.15 10:12,UNKNOWN,0,100,0,HDAC,WITHDRAWAL,,,,0,COMPLETED,0,sum-user-id,1444648.737,airdrop-20181115-hdac-sum-user-id-withdrawal,accac570-de75-11e8-bd11-2f9252c4dc2f,AIRDROP,0
airdrop-20181115-hdac-d8dee8c9-bde2-4c0c-83bc-f30c7548ee1e-withdrawal-exchange,2018.11.15 10:12,UNKNOWN,,UNKNOWN-55c0f2b7-dc24-425b-9be8-6b86719f2865,2018.11.15 10:12,UNKNOWN,0,100,0,HDAC,WITHDRAWAL,,,,0,COMPLETED,0,sum-user-id,1444548.737,airdrop-20181115-hdac-sum-user-id-withdrawal,accac570-de75-11e8-bd11-2f9252c4dc2f,AIRDROP,0
airdrop-20181115-hdac-d90a00cd-ea05-4d87-8536-4a17c83f12ea-withdrawal-exchange,2018.11.15 10:12,UNKNOWN,,UNKNOWN-55c0f2b7-dc24-425b-9be8-6b86719f2865,2018.11.15 10:12,UNKNOWN,0,100,0,HDAC,WITHDRAWAL,,,,0,COMPLETED,0,sum-user-id,1444448.737,airdrop-20181115-hdac-sum-user-id-withdrawal,accac570-de75-11e8-bd11-2f9252c4dc2f,AIRDROP,0
airdrop-20181115-hdac-d92d99cf-15f9-4c7a-89ae-3d89c5e8e9dd-withdrawal-exchange,2018.11.15 10:12,UNKNOWN,,UNKNOWN-55c0f2b7-dc24-425b-9be8-6b86719f2865,2018.11.15 10:12,UNKNOWN,0,100,0,HDAC,WITHDRAWAL,,,,0,COMPLETED,0,sum-user-id,1444348.737,airdrop-20181115-hdac-sum-user-id-withdrawal,accac570-de75-11e8-bd11-2f9252c4dc2f,AIRDROP,0
airdrop-20181115-hdac-d954091f-5b46-433d-ba2e-6db3b8dbd10f-withdrawal-exchange,2018.11.15 10:12,UNKNOWN,,UNKNOWN-55c0f2b7-dc24-425b-9be8-6b86719f2865,2018.11.15 10:12,UNKNOWN,0,100,0,HDAC,WITHDRAWAL,,,,0,COMPLETED,0,sum-user-id,1444248.737,airdrop-20181115-hdac-sum-user-id-withdrawal,accac570-de75-11e8-bd11-2f9252c4dc2f,AIRDROP,0
airdrop-20181115-hdac-d957cc9f-c6b2-4b2d-8df6-49364c07dd11-withdrawal-exchange,2018-11-15 10:12:15.015,UNKNOWN,,UNKNOWN-55c0f2b7-dc24-425b-9be8-6b86719f2865,2018-11-15 10:12:15.015,UNKNOWN,0,100,0,HDAC,WITHDRAWAL,,,,0,COMPLETED,0,sum-user-id,1444148.737,airdrop-20181115-hdac-sum-user-id-withdrawal,accac570-de75-11e8-bd11-2f9252c4dc2f,AIRDROP,0
airdrop-20181115-hdac-d9604f4c-b581-4574-9d1e-76c64ea0bdbd-withdrawal-exchange,2018-11-15 10:12:15.047,UNKNOWN,,UNKNOWN-55c0f2b7-dc24-425b-9be8-6b86719f2865,2018-11-15 10:12:15.047,UNKNOWN,0,100,0,HDAC,WITHDRAWAL,,,,0,COMPLETED,0,sum-user-id,1444048.737,airdrop-20181115-hdac-sum-user-id-withdrawal,accac570-de75-11e8-bd11-2f9252c4dc2f,AIRDROP,0
airdrop-20181115-hdac-d9b5b514-0888-4d6a-ab1d-5d250748f5f6-withdrawal-exchange,2018-11-15 10:12:15.076,UNKNOWN,,UNKNOWN-55c0f2b7-dc24-425b-9be8-6b86719f2865,2018-11-15 10:12:15.076,UNKNOWN,0,100,0,HDAC,WITHDRAWAL,,,,0,COMPLETED,0,sum-user-id,1443948.737,airdrop-20181115-hdac-sum-user-id-withdrawal,accac570-de75-11e8-bd11-2f9252c4dc2f,AIRDROP,0
airdrop-20181115-hdac-d9dfbc2c-0b9a-437e-9413-6192c3ba3545-withdrawal-exchange,2018.11.15 10:12,UNKNOWN,,UNKNOWN-55c0f2b7-dc24-425b-9be8-6b86719f2865,2018.11.15 10:12,UNKNOWN,0,100,0,HDAC,WITHDRAWAL,,,,0,COMPLETED,0,sum-user-id,1443848.737,airdrop-20181115-hdac-sum-user-id-withdrawal,accac570-de75-11e8-bd11-2f9252c4dc2f,AIRDROP,0
airdrop-20181115-hdac-d9e9e019-05fe-43fe-a9ea-a779af7c4d12-withdrawal-exchange,2018.11.15 10:12,UNKNOWN,,UNKNOWN-55c0f2b7-dc24-425b-9be8-6b86719f2865,2018.11.15 10:12,UNKNOWN,0,100,0,HDAC,WITHDRAWAL,,,,0,COMPLETED,0,sum-user-id,1443748.737,airdrop-20181115-hdac-sum-user-id-withdrawal,accac570-de75-11e8-bd11-2f9252c4dc2f,AIRDROP,0
airdrop-20181115-hdac-da20afff-e5a6-4fc8-a503-df08d7391e02-withdrawal-exchange,2018.11.15 10:12,UNKNOWN,,UNKNOWN-55c0f2b7-dc24-425b-9be8-6b86719f2865,2018.11.15 10:12,UNKNOWN,0,100,0,HDAC,WITHDRAWAL,,,,0,COMPLETED,0,sum-user-id,1443648.737,airdrop-20181115-hdac-sum-user-id-withdrawal,accac570-de75-11e8-bd11-2f9252c4dc2f,AIRDROP,0
airdrop-20181115-hdac-da25407a-14e7-45fc-a35b-1ae67408fc3e-withdrawal-exchange,2018.11.15 10:12,UNKNOWN,,UNKNOWN-55c0f2b7-dc24-425b-9be8-6b86719f2865,2018.11.15 10:12,UNKNOWN,0,100,0,HDAC,WITHDRAWAL,,,,0,COMPLETED,0,sum-user-id,1443548.737,airdrop-20181115-hdac-sum-user-id-withdrawal,accac570-de75-11e8-bd11-2f9252c4dc2f,AIRDROP,0
airdrop-20181115-hdac-da408aa0-610b-47d8-9b13-4c1a63cca306-withdrawal-exchange,2018.11.15 10:12,UNKNOWN,,UNKNOWN-55c0f2b7-dc24-425b-9be8-6b86719f2865,2018.11.15 10:12,UNKNOWN,0,100,0,HDAC,WITHDRAWAL,,,,0,COMPLETED,0,sum-user-id,1443448.737,airdrop-20181115-hdac-sum-user-id-withdrawal,accac570-de75-11e8-bd11-2f9252c4dc2f,AIRDROP,0
airdrop-20181115-hdac-da48c567-7e4e-4958-a950-0a5f0fb3968d-withdrawal-exchange,2018.11.15 10:12,UNKNOWN,,UNKNOWN-55c0f2b7-dc24-425b-9be8-6b86719f2865,2018.11.15 10:12,UNKNOWN,0,100,0,HDAC,WITHDRAWAL,,,,0,COMPLETED,0,sum-user-id,1443348.737,airdrop-20181115-hdac-sum-user-id-withdrawal,accac570-de75-11e8-bd11-2f9252c4dc2f,AIRDROP,0
airdrop-20181115-hdac-da48c681-36b1-4dcd-b4bd-c57a084c2763-withdrawal-exchange,2018.11.15 10:12,UNKNOWN,,UNKNOWN-55c0f2b7-dc24-425b-9be8-6b86719f2865,2018.11.15 10:12,UNKNOWN,0,100,0,HDAC,WITHDRAWAL,,,,0,COMPLETED,0,sum-user-id,1443248.737,airdrop-20181115-hdac-sum-user-id-withdrawal,accac570-de75-11e8-bd11-2f9252c4dc2f,AIRDROP,0
airdrop-20181115-hdac-da5d7f1d-e70a-4331-9b2b-f61d5f0af4dc-withdrawal-exchange,2018.11.15 10:12,UNKNOWN,,UNKNOWN-55c0f2b7-dc24-425b-9be8-6b86719f2865,2018.11.15 10:12,UNKNOWN,0,100,0,HDAC,WITHDRAWAL,,,,0,COMPLETED,0,sum-user-id,1443148.737,airdrop-20181115-hdac-sum-user-id-withdrawal,accac570-de75-11e8-bd11-2f9252c4dc2f,AIRDROP,0
airdrop-20181115-hdac-da813708-8e5f-4b54-adb5-94f40422b03e-withdrawal-exchange,2018.11.15 10:12,UNKNOWN,,UNKNOWN-55c0f2b7-dc24-425b-9be8-6b86719f2865,2018.11.15 10:12,UNKNOWN,0,100,0,HDAC,WITHDRAWAL,,,,0,COMPLETED,0,sum-user-id,1443048.737,airdrop-20181115-hdac-sum-user-id-withdrawal,accac570-de75-11e8-bd11-2f9252c4dc2f,AIRDROP,0
airdrop-20181115-hdac-da9d45cc-932c-43ff-81a0-5c2fa47b2ff3-withdrawal-exchange,2018.11.15 10:12,UNKNOWN,,UNKNOWN-55c0f2b7-dc24-425b-9be8-6b86719f2865,2018.11.15 10:12,UNKNOWN,0,100,0,HDAC,WITHDRAWAL,,,,0,COMPLETED,0,sum-user-id,1442948.737,airdrop-20181115-hdac-sum-user-id-withdrawal,accac570-de75-11e8-bd11-2f9252c4dc2f,AIRDROP,0
airdrop-20181115-hdac-dab77009-0780-4460-8100-1538d870679a-withdrawal-exchange,2018.11.15 10:12,UNKNOWN,,UNKNOWN-55c0f2b7-dc24-425b-9be8-6b86719f2865,2018.11.15 10:12,UNKNOWN,0,100,0,HDAC,WITHDRAWAL,,,,0,COMPLETED,0,sum-user-id,1442848.737,airdrop-20181115-hdac-sum-user-id-withdrawal,accac570-de75-11e8-bd11-2f9252c4dc2f,AIRDROP,0
airdrop-20181115-hdac-dacfed9a-d700-4b95-984b-da7bc02896ea-withdrawal-exchange,2018.11.15 10:12,UNKNOWN,,UNKNOWN-55c0f2b7-dc24-425b-9be8-6b86719f2865,2018.11.15 10:12,UNKNOWN,0,100,0,HDAC,WITHDRAWAL,,,,0,COMPLETED,0,sum-user-id,1442748.737,airdrop-20181115-hdac-sum-user-id-withdrawal,accac570-de75-11e8-bd11-2f9252c4dc2f,AIRDROP,0
airdrop-20181115-hdac-dad6178a-45db-46f1-8243-38b9533c8669-withdrawal-exchange,2018.11.15 10:12,UNKNOWN,,UNKNOWN-55c0f2b7-dc24-425b-9be8-6b86719f2865,2018.11.15 10:12,UNKNOWN,0,100,0,HDAC,WITHDRAWAL,,,,0,COMPLETED,0,sum-user-id,1442648.737,airdrop-20181115-hdac-sum-user-id-withdrawal,accac570-de75-11e8-bd11-2f9252c4dc2f,AIRDROP,0
airdrop-20181115-hdac-db0fbd31-2c71-454e-8d21-657b617a4c0f-withdrawal-exchange,2018.11.15 10:12,UNKNOWN,,UNKNOWN-55c0f2b7-dc24-425b-9be8-6b86719f2865,2018.11.15 10:12,UNKNOWN,0,100,0,HDAC,WITHDRAWAL,,,,0,COMPLETED,0,sum-user-id,1442548.737,airdrop-20181115-hdac-sum-user-id-withdrawal,accac570-de75-11e8-bd11-2f9252c4dc2f,AIRDROP,0
airdrop-20181115-hdac-db1db3ef-5412-430f-a595-02c807735eb6-withdrawal-exchange,2018.11.15 10:12,UNKNOWN,,UNKNOWN-55c0f2b7-dc24-425b-9be8-6b86719f2865,2018.11.15 10:12,UNKNOWN,0,100,0,HDAC,WITHDRAWAL,,,,0,COMPLETED,0,sum-user-id,1442448.737,airdrop-20181115-hdac-sum-user-id-withdrawal,accac570-de75-11e8-bd11-2f9252c4dc2f,AIRDROP,0
airdrop-20181115-hdac-db33d32b-0ea1-48de-811a-c331587b792a-withdrawal-exchange,2018.11.15 10:12,UNKNOWN,,UNKNOWN-55c0f2b7-dc24-425b-9be8-6b86719f2865,2018.11.15 10:12,UNKNOWN,0,100,0,HDAC,WITHDRAWAL,,,,0,COMPLETED,0,sum-user-id,1442348.737,airdrop-20181115-hdac-sum-user-id-withdrawal,accac570-de75-11e8-bd11-2f9252c4dc2f,AIRDROP,0
airdrop-20181115-hdac-db4c3d38-6b98-42b8-9a79-2ece032b46f1-withdrawal-exchange,2018.11.15 10:12,UNKNOWN,,UNKNOWN-55c0f2b7-dc24-425b-9be8-6b86719f2865,2018.11.15 10:12,UNKNOWN,0,100,0,HDAC,WITHDRAWAL,,,,0,COMPLETED,0,sum-user-id,1442248.737,airdrop-20181115-hdac-sum-user-id-withdrawal,accac570-de75-11e8-bd11-2f9252c4dc2f,AIRDROP,0
airdrop-20181115-hdac-db4fc9a8-9432-4fcf-9792-4a01608c302f-withdrawal-exchange,2018.11.15 10:12,UNKNOWN,,UNKNOWN-55c0f2b7-dc24-425b-9be8-6b86719f2865,2018.11.15 10:12,UNKNOWN,0,100,0,HDAC,WITHDRAWAL,,,,0,COMPLETED,0,sum-user-id,1442148.737,airdrop-20181115-hdac-sum-user-id-withdrawal,accac570-de75-11e8-bd11-2f9252c4dc2f,AIRDROP,0
airdrop-20181115-hdac-db7291a1-4300-4c6a-8b38-b2b2568033ba-withdrawal-exchange,2018.11.15 10:12,UNKNOWN,,UNKNOWN-55c0f2b7-dc24-425b-9be8-6b86719f2865,2018.11.15 10:12,UNKNOWN,0,100,0,HDAC,WITHDRAWAL,,,,0,COMPLETED,0,sum-user-id,1442048.737,airdrop-20181115-hdac-sum-user-id-withdrawal,accac570-de75-11e8-bd11-2f9252c4dc2f,AIRDROP,0
airdrop-20181115-hdac-db891619-70a5-45a4-b91f-a429c79056fc-withdrawal-exchange,2018.11.15 10:12,UNKNOWN,,UNKNOWN-55c0f2b7-dc24-425b-9be8-6b86719f2865,2018.11.15 10:12,UNKNOWN,0,100,0,HDAC,WITHDRAWAL,,,,0,COMPLETED,0,sum-user-id,1441948.737,airdrop-20181115-hdac-sum-user-id-withdrawal,accac570-de75-11e8-bd11-2f9252c4dc2f,AIRDROP,0
airdrop-20181115-hdac-db8d6ed7-af52-447b-8e4a-506d3d03a13b-withdrawal-exchange,2018.11.15 10:12,UNKNOWN,,UNKNOWN-55c0f2b7-dc24-425b-9be8-6b86719f2865,2018.11.15 10:12,UNKNOWN,0,100,0,HDAC,WITHDRAWAL,,,,0,COMPLETED,0,sum-user-id,1441848.737,airdrop-20181115-hdac-sum-user-id-withdrawal,accac570-de75-11e8-bd11-2f9252c4dc2f,AIRDROP,0
airdrop-20181115-hdac-db8e5b2d-3bf8-46c7-bb3d-d726d3a60a10-withdrawal-exchange,2018.11.15 10:12,UNKNOWN,,UNKNOWN-55c0f2b7-dc24-425b-9be8-6b86719f2865,2018.11.15 10:12,UNKNOWN,0,100,0,HDAC,WITHDRAWAL,,,,0,COMPLETED,0,sum-user-id,1441748.737,airdrop-20181115-hdac-sum-user-id-withdrawal,accac570-de75-11e8-bd11-2f9252c4dc2f,AIRDROP,0
airdrop-20181115-hdac-db8f61d2-41ec-43d9-9231-f3632cca398d-withdrawal-exchange,2018.11.15 10:12,UNKNOWN,,UNKNOWN-55c0f2b7-dc24-425b-9be8-6b86719f2865,2018.11.15 10:12,UNKNOWN,0,100,0,HDAC,WITHDRAWAL,,,,0,COMPLETED,0,sum-user-id,1441648.737,airdrop-20181115-hdac-sum-user-id-withdrawal,accac570-de75-11e8-bd11-2f9252c4dc2f,AIRDROP,0
airdrop-20181115-hdac-db9ad451-0856-47a3-ab73-c5ebda6e2952-withdrawal-exchange,2018.11.15 10:12,UNKNOWN,,UNKNOWN-55c0f2b7-dc24-425b-9be8-6b86719f2865,2018.11.15 10:12,UNKNOWN,0,100,0,HDAC,WITHDRAWAL,,,,0,COMPLETED,0,sum-user-id,1441548.737,airdrop-20181115-hdac-sum-user-id-withdrawal,accac570-de75-11e8-bd11-2f9252c4dc2f,AIRDROP,0
airdrop-20181115-hdac-dbc4fe31-4d99-4655-9fd8-0da433af7817-withdrawal-exchange,2018.11.15 10:12,UNKNOWN,,UNKNOWN-55c0f2b7-dc24-425b-9be8-6b86719f2865,2018.11.15 10:12,UNKNOWN,0,100,0,HDAC,WITHDRAWAL,,,,0,COMPLETED,0,sum-user-id,1441448.737,airdrop-20181115-hdac-sum-user-id-withdrawal,accac570-de75-11e8-bd11-2f9252c4dc2f,AIRDROP,0
airdrop-20181115-hdac-dbf09c2e-171b-4539-a30c-01fc8b5433ac-withdrawal-exchange,2018.11.15 10:12,UNKNOWN,,UNKNOWN-55c0f2b7-dc24-425b-9be8-6b86719f2865,2018.11.15 10:12,UNKNOWN,0,100,0,HDAC,WITHDRAWAL,,,,0,COMPLETED,0,sum-user-id,1441348.737,airdrop-20181115-hdac-sum-user-id-withdrawal,accac570-de75-11e8-bd11-2f9252c4dc2f,AIRDROP,0
airdrop-20181115-hdac-dc07e834-efe7-4e08-829b-fbfd3361ad38-withdrawal-exchange,2018.11.15 10:12,UNKNOWN,,UNKNOWN-55c0f2b7-dc24-425b-9be8-6b86719f2865,2018.11.15 10:12,UNKNOWN,0,100,0,HDAC,WITHDRAWAL,,,,0,COMPLETED,0,sum-user-id,1441248.737,airdrop-20181115-hdac-sum-user-id-withdrawal,accac570-de75-11e8-bd11-2f9252c4dc2f,AIRDROP,0
airdrop-20181115-hdac-dc1a5558-dcc3-4e68-8003-58ca501da295-withdrawal-exchange,2018.11.15 10:12,UNKNOWN,,UNKNOWN-55c0f2b7-dc24-425b-9be8-6b86719f2865,2018.11.15 10:12,UNKNOWN,0,100,0,HDAC,WITHDRAWAL,,,,0,COMPLETED,0,sum-user-id,1441148.737,airdrop-20181115-hdac-sum-user-id-withdrawal,accac570-de75-11e8-bd11-2f9252c4dc2f,AIRDROP,0
airdrop-20181115-hdac-dc1ad812-c13b-4ac9-a3bd-58672a37f3de-withdrawal-exchange,2018.11.15 10:12,UNKNOWN,,UNKNOWN-55c0f2b7-dc24-425b-9be8-6b86719f2865,2018.11.15 10:12,UNKNOWN,0,4523.945884,0,HDAC,WITHDRAWAL,,,,0,COMPLETED,0,sum-user-id,1436624.791,airdrop-20181115-hdac-sum-user-id-withdrawal,accac570-de75-11e8-bd11-2f9252c4dc2f,AIRDROP,0
airdrop-20181115-hdac-dc29c338-ac5e-43ef-9120-bfe16ec95449-withdrawal-exchange,2018-11-15 10:12:16.004,UNKNOWN,,UNKNOWN-55c0f2b7-dc24-425b-9be8-6b86719f2865,2018-11-15 10:12:16.004,UNKNOWN,0,100,0,HDAC,WITHDRAWAL,,,,0,COMPLETED,0,sum-user-id,1436524.791,airdrop-20181115-hdac-sum-user-id-withdrawal,accac570-de75-11e8-bd11-2f9252c4dc2f,AIRDROP,0
airdrop-20181115-hdac-dc2a97c5-fd3d-4c90-8f88-359dd9c7c51a-withdrawal-exchange,2018-11-15 10:12:16.037,UNKNOWN,,UNKNOWN-55c0f2b7-dc24-425b-9be8-6b86719f2865,2018-11-15 10:12:16.037,UNKNOWN,0,100,0,HDAC,WITHDRAWAL,,,,0,COMPLETED,0,sum-user-id,1436424.791,airdrop-20181115-hdac-sum-user-id-withdrawal,accac570-de75-11e8-bd11-2f9252c4dc2f,AIRDROP,0
airdrop-20181115-hdac-dc471044-f3d6-4934-b51d-e1880f672f7f-withdrawal-exchange,2018-11-15 10:12:16.067,UNKNOWN,,UNKNOWN-55c0f2b7-dc24-425b-9be8-6b86719f2865,2018-11-15 10:12:16.067,UNKNOWN,0,100,0,HDAC,WITHDRAWAL,,,,0,COMPLETED,0,sum-user-id,1436324.791,airdrop-20181115-hdac-sum-user-id-withdrawal,accac570-de75-11e8-bd11-2f9252c4dc2f,AIRDROP,0
airdrop-20181115-hdac-dc659efe-ac8c-4a34-87f5-e62f74552eed-withdrawal-exchange,2018-11-15 10:12:16.096,UNKNOWN,,UNKNOWN-55c0f2b7-dc24-425b-9be8-6b86719f2865,2018-11-15 10:12:16.096,UNKNOWN,0,100,0,HDAC,WITHDRAWAL,,,,0,COMPLETED,0,sum-user-id,1436224.791,airdrop-20181115-hdac-sum-user-id-withdrawal,accac570-de75-11e8-bd11-2f9252c4dc2f,AIRDROP,0
airdrop-20181115-hdac-dc6f3c05-a00b-4941-a67d-bfcf8f8416a0-withdrawal-exchange,2018.11.15 10:12,UNKNOWN,,UNKNOWN-55c0f2b7-dc24-425b-9be8-6b86719f2865,2018.11.15 10:12,UNKNOWN,0,100,0,HDAC,WITHDRAWAL,,,,0,COMPLETED,0,sum-user-id,1436124.791,airdrop-20181115-hdac-sum-user-id-withdrawal,accac570-de75-11e8-bd11-2f9252c4dc2f,AIRDROP,0
airdrop-20181115-hdac-dc7a05ab-5290-444c-85ea-febdf0d78908-withdrawal-exchange,2018.11.15 10:12,UNKNOWN,,UNKNOWN-55c0f2b7-dc24-425b-9be8-6b86719f2865,2018.11.15 10:12,UNKNOWN,0,100,0,HDAC,WITHDRAWAL,,,,0,COMPLETED,0,sum-user-id,1436024.791,airdrop-20181115-hdac-sum-user-id-withdrawal,accac570-de75-11e8-bd11-2f9252c4dc2f,AIRDROP,0
airdrop-20181115-hdac-dc7c8f09-7be3-4e94-92a7-1abe48d42d9c-withdrawal-exchange,2018.11.15 10:12,UNKNOWN,,UNKNOWN-55c0f2b7-dc24-425b-9be8-6b86719f2865,2018.11.15 10:12,UNKNOWN,0,100,0,HDAC,WITHDRAWAL,,,,0,COMPLETED,0,sum-user-id,1435924.791,airdrop-20181115-hdac-sum-user-id-withdrawal,accac570-de75-11e8-bd11-2f9252c4dc2f,AIRDROP,0
airdrop-20181115-hdac-dca7df5b-e0f8-440e-8166-08c4340c5cdc-withdrawal-exchange,2018.11.15 10:12,UNKNOWN,,UNKNOWN-55c0f2b7-dc24-425b-9be8-6b86719f2865,2018.11.15 10:12,UNKNOWN,0,100,0,HDAC,WITHDRAWAL,,,,0,COMPLETED,0,sum-user-id,1435824.791,airdrop-20181115-hdac-sum-user-id-withdrawal,accac570-de75-11e8-bd11-2f9252c4dc2f,AIRDROP,0
airdrop-20181115-hdac-dca8ca6a-0cbd-4475-b3d2-8cc4f38b0a9f-withdrawal-exchange,2018.11.15 10:12,UNKNOWN,,UNKNOWN-55c0f2b7-dc24-425b-9be8-6b86719f2865,2018.11.15 10:12,UNKNOWN,0,100,0,HDAC,WITHDRAWAL,,,,0,COMPLETED,0,sum-user-id,1435724.791,airdrop-20181115-hdac-sum-user-id-withdrawal,accac570-de75-11e8-bd11-2f9252c4dc2f,AIRDROP,0
airdrop-20181115-hdac-dca99ee8-d2dc-47e3-bc9b-a9e39526de6e-withdrawal-exchange,2018.11.15 10:12,UNKNOWN,,UNKNOWN-55c0f2b7-dc24-425b-9be8-6b86719f2865,2018.11.15 10:12,UNKNOWN,0,100,0,HDAC,WITHDRAWAL,,,,0,COMPLETED,0,sum-user-id,1435624.791,airdrop-20181115-hdac-sum-user-id-withdrawal,accac570-de75-11e8-bd11-2f9252c4dc2f,AIRDROP,0
airdrop-20181115-hdac-dccedbbb-0b2b-4113-b705-6effecee1432-withdrawal-exchange,2018.11.15 10:12,UNKNOWN,,UNKNOWN-55c0f2b7-dc24-425b-9be8-6b86719f2865,2018.11.15 10:12,UNKNOWN,0,100,0,HDAC,WITHDRAWAL,,,,0,COMPLETED,0,sum-user-id,1435524.791,airdrop-20181115-hdac-sum-user-id-withdrawal,accac570-de75-11e8-bd11-2f9252c4dc2f,AIRDROP,0
airdrop-20181115-hdac-dccf40d1-c40e-43f5-a9d2-202b571892c0-withdrawal-exchange,2018.11.15 10:12,UNKNOWN,,UNKNOWN-55c0f2b7-dc24-425b-9be8-6b86719f2865,2018.11.15 10:12,UNKNOWN,0,100,0,HDAC,WITHDRAWAL,,,,0,COMPLETED,0,sum-user-id,1435424.791,airdrop-20181115-hdac-sum-user-id-withdrawal,accac570-de75-11e8-bd11-2f9252c4dc2f,AIRDROP,0
airdrop-20181115-hdac-dcdf587d-b325-433e-9e1e-47bae199f870-withdrawal-exchange,2018.11.15 10:12,UNKNOWN,,UNKNOWN-55c0f2b7-dc24-425b-9be8-6b86719f2865,2018.11.15 10:12,UNKNOWN,0,100,0,HDAC,WITHDRAWAL,,,,0,COMPLETED,0,sum-user-id,1435324.791,airdrop-20181115-hdac-sum-user-id-withdrawal,accac570-de75-11e8-bd11-2f9252c4dc2f,AIRDROP,0
airdrop-20181115-hdac-dcfba9eb-cde5-465f-9f81-f667c3955550-withdrawal-exchange,2018.11.15 10:12,UNKNOWN,,UNKNOWN-55c0f2b7-dc24-425b-9be8-6b86719f2865,2018.11.15 10:12,UNKNOWN,0,100,0,HDAC,WITHDRAWAL,,,,0,COMPLETED,0,sum-user-id,1435224.791,airdrop-20181115-hdac-sum-user-id-withdrawal,accac570-de75-11e8-bd11-2f9252c4dc2f,AIRDROP,0
airdrop-20181115-hdac-dd00dc59-171c-4b8f-82e4-a6b0afcbceed-withdrawal-exchange,2018.11.15 10:12,UNKNOWN,,UNKNOWN-55c0f2b7-dc24-425b-9be8-6b86719f2865,2018.11.15 10:12,UNKNOWN,0,100,0,HDAC,WITHDRAWAL,,,,0,COMPLETED,0,sum-user-id,1435124.791,airdrop-20181115-hdac-sum-user-id-withdrawal,accac570-de75-11e8-bd11-2f9252c4dc2f,AIRDROP,0
airdrop-20181115-hdac-dd0af390-96ce-42de-9374-cc5450dd4661-withdrawal-exchange,2018.11.15 10:12,UNKNOWN,,UNKNOWN-55c0f2b7-dc24-425b-9be8-6b86719f2865,2018.11.15 10:12,UNKNOWN,0,100,0,HDAC,WITHDRAWAL,,,,0,COMPLETED,0,sum-user-id,1435024.791,airdrop-20181115-hdac-sum-user-id-withdrawal,accac570-de75-11e8-bd11-2f9252c4dc2f,AIRDROP,0
airdrop-20181115-hdac-dd12331f-5429-4bb7-a140-e80c373670eb-withdrawal-exchange,2018.11.15 10:12,UNKNOWN,,UNKNOWN-55c0f2b7-dc24-425b-9be8-6b86719f2865,2018.11.15 10:12,UNKNOWN,0,100,0,HDAC,WITHDRAWAL,,,,0,COMPLETED,0,sum-user-id,1434924.791,airdrop-20181115-hdac-sum-user-id-withdrawal,accac570-de75-11e8-bd11-2f9252c4dc2f,AIRDROP,0
airdrop-20181115-hdac-dd3152e5-3bab-4fa3-acbe-24748d2e814f-withdrawal-exchange,2018.11.15 10:12,UNKNOWN,,UNKNOWN-55c0f2b7-dc24-425b-9be8-6b86719f2865,2018.11.15 10:12,UNKNOWN,0,100,0,HDAC,WITHDRAWAL,,,,0,COMPLETED,0,sum-user-id,1434824.791,airdrop-20181115-hdac-sum-user-id-withdrawal,accac570-de75-11e8-bd11-2f9252c4dc2f,AIRDROP,0
airdrop-20181115-hdac-dd4cde7a-fb95-4a6a-81ff-9f75d1caf1bc-withdrawal-exchange,2018.11.15 10:12,UNKNOWN,,UNKNOWN-55c0f2b7-dc24-425b-9be8-6b86719f2865,2018.11.15 10:12,UNKNOWN,0,100,0,HDAC,WITHDRAWAL,,,,0,COMPLETED,0,sum-user-id,1434724.791,airdrop-20181115-hdac-sum-user-id-withdrawal,accac570-de75-11e8-bd11-2f9252c4dc2f,AIRDROP,0
airdrop-20181115-hdac-dd6228b9-8b2f-4cae-9154-c057773dcc74-withdrawal-exchange,2018.11.15 10:12,UNKNOWN,,UNKNOWN-55c0f2b7-dc24-425b-9be8-6b86719f2865,2018.11.15 10:12,UNKNOWN,0,1062.483293,0,HDAC,WITHDRAWAL,,,,0,COMPLETED,0,sum-user-id,1103523.987,airdrop-20181115-hdac-sum-user-id-withdrawal,accac570-de75-11e8-bd11-2f9252c4dc2f,AIRDROP,0
airdrop-20181115-hdac-dd6ce34b-c6fa-4b33-97f4-0cbeeb373cdd-withdrawal-exchange,2018.11.15 10:12,UNKNOWN,,UNKNOWN-55c0f2b7-dc24-425b-9be8-6b86719f2865,2018.11.15 10:12,UNKNOWN,0,100,0,HDAC,WITHDRAWAL,,,,0,COMPLETED,0,sum-user-id,1434624.791,airdrop-20181115-hdac-sum-user-id-withdrawal,accac570-de75-11e8-bd11-2f9252c4dc2f,AIRDROP,0
airdrop-20181115-hdac-dd70bbcc-de0d-42d3-a862-a9d7bbca35e8-withdrawal-exchange,2018.11.15 10:12,UNKNOWN,,UNKNOWN-55c0f2b7-dc24-425b-9be8-6b86719f2865,2018.11.15 10:12,UNKNOWN,0,100,0,HDAC,WITHDRAWAL,,,,0,COMPLETED,0,sum-user-id,1434524.791,airdrop-20181115-hdac-sum-user-id-withdrawal,accac570-de75-11e8-bd11-2f9252c4dc2f,AIRDROP,0
airdrop-20181115-hdac-dd82064f-882a-47e2-a1c7-b6f50893d515-withdrawal-exchange,2018.11.15 10:12,UNKNOWN,,UNKNOWN-55c0f2b7-dc24-425b-9be8-6b86719f2865,2018.11.15 10:12,UNKNOWN,0,100,0,HDAC,WITHDRAWAL,,,,0,COMPLETED,0,sum-user-id,1434424.791,airdrop-20181115-hdac-sum-user-id-withdrawal,accac570-de75-11e8-bd11-2f9252c4dc2f,AIRDROP,0
airdrop-20181115-hdac-dd925e53-0d6b-4f63-b3a5-3f886758fdc9-withdrawal-exchange,2018.11.15 10:12,UNKNOWN,,UNKNOWN-55c0f2b7-dc24-425b-9be8-6b86719f2865,2018.11.15 10:12,UNKNOWN,0,100,0,HDAC,WITHDRAWAL,,,,0,COMPLETED,0,sum-user-id,1434324.791,airdrop-20181115-hdac-sum-user-id-withdrawal,accac570-de75-11e8-bd11-2f9252c4dc2f,AIRDROP,0
airdrop-20181115-hdac-dd97cf08-33e9-49f6-bbff-e491e6795360-withdrawal-exchange,2018.11.15 10:12,UNKNOWN,,UNKNOWN-55c0f2b7-dc24-425b-9be8-6b86719f2865,2018.11.15 10:12,UNKNOWN,0,100,0,HDAC,WITHDRAWAL,,,,0,COMPLETED,0,sum-user-id,1434224.791,airdrop-20181115-hdac-sum-user-id-withdrawal,accac570-de75-11e8-bd11-2f9252c4dc2f,AIRDROP,0
airdrop-20181115-hdac-dd9a180b-e9c4-4faf-a240-978fcab2620a-withdrawal-exchange,2018.11.15 10:12,UNKNOWN,,UNKNOWN-55c0f2b7-dc24-425b-9be8-6b86719f2865,2018.11.15 10:12,UNKNOWN,0,100,0,HDAC,WITHDRAWAL,,,,0,COMPLETED,0,sum-user-id,1434124.791,airdrop-20181115-hdac-sum-user-id-withdrawal,accac570-de75-11e8-bd11-2f9252c4dc2f,AIRDROP,0
airdrop-20181115-hdac-dda63df8-48ac-4e2d-89f3-a9981eaa5619-withdrawal-exchange,2018.11.15 10:12,UNKNOWN,,UNKNOWN-55c0f2b7-dc24-425b-9be8-6b86719f2865,2018.11.15 10:12,UNKNOWN,0,100,0,HDAC,WITHDRAWAL,,,,0,COMPLETED,0,sum-user-id,1434024.791,airdrop-20181115-hdac-sum-user-id-withdrawal,accac570-de75-11e8-bd11-2f9252c4dc2f,AIRDROP,0
airdrop-20181115-hdac-dda64fb1-464f-4205-9a5f-2c6cc06ae49a-withdrawal-exchange,2018.11.15 10:12,UNKNOWN,,UNKNOWN-55c0f2b7-dc24-425b-9be8-6b86719f2865,2018.11.15 10:12,UNKNOWN,0,100,0,HDAC,WITHDRAWAL,,,,0,COMPLETED,0,sum-user-id,1433924.791,airdrop-20181115-hdac-sum-user-id-withdrawal,accac570-de75-11e8-bd11-2f9252c4dc2f,AIRDROP,0
airdrop-20181115-hdac-ddbd4e8f-84fe-4f13-8ee9-7cf090e0f809-withdrawal-exchange,2018.11.15 10:12,UNKNOWN,,UNKNOWN-55c0f2b7-dc24-425b-9be8-6b86719f2865,2018.11.15 10:12,UNKNOWN,0,100,0,HDAC,WITHDRAWAL,,,,0,COMPLETED,0,sum-user-id,1433824.791,airdrop-20181115-hdac-sum-user-id-withdrawal,accac570-de75-11e8-bd11-2f9252c4dc2f,AIRDROP,0
airdrop-20181115-hdac-ddd0f81b-8ca0-471b-a2a0-74fcd1b9e781-withdrawal-exchange,2018.11.15 10:12,UNKNOWN,,UNKNOWN-55c0f2b7-dc24-425b-9be8-6b86719f2865,2018.11.15 10:12,UNKNOWN,0,100,0,HDAC,WITHDRAWAL,,,,0,COMPLETED,0,sum-user-id,1433724.791,airdrop-20181115-hdac-sum-user-id-withdrawal,accac570-de75-11e8-bd11-2f9252c4dc2f,AIRDROP,0
airdrop-20181115-hdac-ddd3ebf7-1e61-40f8-ba3f-49f217f4a6ad-withdrawal-exchange,2018.11.15 10:12,UNKNOWN,,UNKNOWN-55c0f2b7-dc24-425b-9be8-6b86719f2865,2018.11.15 10:12,UNKNOWN,0,100,0,HDAC,WITHDRAWAL,,,,0,COMPLETED,0,sum-user-id,1433624.791,airdrop-20181115-hdac-sum-user-id-withdrawal,accac570-de75-11e8-bd11-2f9252c4dc2f,AIRDROP,0
airdrop-20181115-hdac-dde7ffac-d1c6-4907-951a-d2f28f4c3975-withdrawal-exchange,2018.11.15 10:12,UNKNOWN,,UNKNOWN-55c0f2b7-dc24-425b-9be8-6b86719f2865,2018.11.15 10:12,UNKNOWN,0,100,0,HDAC,WITHDRAWAL,,,,0,COMPLETED,0,sum-user-id,1433524.791,airdrop-20181115-hdac-sum-user-id-withdrawal,accac570-de75-11e8-bd11-2f9252c4dc2f,AIRDROP,0
airdrop-20181115-hdac-ddf1954d-cf81-4de7-9736-5e65259682c8-withdrawal-exchange,2018.11.15 10:12,UNKNOWN,,UNKNOWN-55c0f2b7-dc24-425b-9be8-6b86719f2865,2018.11.15 10:12,UNKNOWN,0,100,0,HDAC,WITHDRAWAL,,,,0,COMPLETED,0,sum-user-id,1433424.791,airdrop-20181115-hdac-sum-user-id-withdrawal,accac570-de75-11e8-bd11-2f9252c4dc2f,AIRDROP,0
airdrop-20181115-hdac-de704642-4cb5-4c03-8a74-be08f334dc62-withdrawal-exchange,2018.11.15 10:12,UNKNOWN,,UNKNOWN-55c0f2b7-dc24-425b-9be8-6b86719f2865,2018.11.15 10:12,UNKNOWN,0,100,0,HDAC,WITHDRAWAL,,,,0,COMPLETED,0,sum-user-id,1433324.791,airdrop-20181115-hdac-sum-user-id-withdrawal,accac570-de75-11e8-bd11-2f9252c4dc2f,AIRDROP,0
airdrop-20181115-hdac-de8b2afb-bdf0-47ac-9332-ea29be5334b9-withdrawal-exchange,2018-11-15 10:12:17.029,UNKNOWN,,UNKNOWN-55c0f2b7-dc24-425b-9be8-6b86719f2865,2018-11-15 10:12:17.029,UNKNOWN,0,100,0,HDAC,WITHDRAWAL,,,,0,COMPLETED,0,sum-user-id,1433224.791,airdrop-20181115-hdac-sum-user-id-withdrawal,accac570-de75-11e8-bd11-2f9252c4dc2f,AIRDROP,0
airdrop-20181115-hdac-de992c9e-7c2c-4e40-818c-04ff542487df-withdrawal-exchange,2018-11-15 10:12:17.060,UNKNOWN,,UNKNOWN-55c0f2b7-dc24-425b-9be8-6b86719f2865,2018-11-15 10:12:17.060,UNKNOWN,0,100,0,HDAC,WITHDRAWAL,,,,0,COMPLETED,0,sum-user-id,1433124.791,airdrop-20181115-hdac-sum-user-id-withdrawal,accac570-de75-11e8-bd11-2f9252c4dc2f,AIRDROP,0
airdrop-20181115-hdac-dea26662-6458-419b-8dd0-928cdf93f85c-withdrawal-exchange,2018-11-15 10:12:17.091,UNKNOWN,,UNKNOWN-55c0f2b7-dc24-425b-9be8-6b86719f2865,2018-11-15 10:12:17.091,UNKNOWN,0,100,0,HDAC,WITHDRAWAL,,,,0,COMPLETED,0,sum-user-id,1433024.791,airdrop-20181115-hdac-sum-user-id-withdrawal,accac570-de75-11e8-bd11-2f9252c4dc2f,AIRDROP,0
airdrop-20181115-hdac-dec73f07-2eed-48a0-8b68-c58a6567739e-withdrawal-exchange,2018.11.15 10:12,UNKNOWN,,UNKNOWN-55c0f2b7-dc24-425b-9be8-6b86719f2865,2018.11.15 10:12,UNKNOWN,0,16657.01588,0,HDAC,WITHDRAWAL,,,,0,COMPLETED,0,sum-user-id,1416367.775,airdrop-20181115-hdac-sum-user-id-withdrawal,accac570-de75-11e8-bd11-2f9252c4dc2f,AIRDROP,0
airdrop-20181115-hdac-df073459-570a-45a4-beea-ecee338b0530-withdrawal-exchange,2018.11.15 10:12,UNKNOWN,,UNKNOWN-55c0f2b7-dc24-425b-9be8-6b86719f2865,2018.11.15 10:12,UNKNOWN,0,100,0,HDAC,WITHDRAWAL,,,,0,COMPLETED,0,sum-user-id,1416267.775,airdrop-20181115-hdac-sum-user-id-withdrawal,accac570-de75-11e8-bd11-2f9252c4dc2f,AIRDROP,0
airdrop-20181115-hdac-df237ee5-2623-4528-b8b8-96ed52d915b7-withdrawal-exchange,2018.11.15 10:12,UNKNOWN,,UNKNOWN-55c0f2b7-dc24-425b-9be8-6b86719f2865,2018.11.15 10:12,UNKNOWN,0,100,0,HDAC,WITHDRAWAL,,,,0,COMPLETED,0,sum-user-id,1416167.775,airdrop-20181115-hdac-sum-user-id-withdrawal,accac570-de75-11e8-bd11-2f9252c4dc2f,AIRDROP,0
airdrop-20181115-hdac-df7f56d0-386a-460a-b906-d098505f0d67-withdrawal-exchange,2018.11.15 10:12,UNKNOWN,,UNKNOWN-55c0f2b7-dc24-425b-9be8-6b86719f2865,2018.11.15 10:12,UNKNOWN,0,100,0,HDAC,WITHDRAWAL,,,,0,COMPLETED,0,sum-user-id,1416067.775,airdrop-20181115-hdac-sum-user-id-withdrawal,accac570-de75-11e8-bd11-2f9252c4dc2f,AIRDROP,0
airdrop-20181115-hdac-df7fa14e-de71-4840-9c96-77a7dcf69fc2-withdrawal-exchange,2018.11.15 10:12,UNKNOWN,,UNKNOWN-55c0f2b7-dc24-425b-9be8-6b86719f2865,2018.11.15 10:12,UNKNOWN,0,100,0,HDAC,WITHDRAWAL,,,,0,COMPLETED,0,sum-user-id,1415967.775,airdrop-20181115-hdac-sum-user-id-withdrawal,accac570-de75-11e8-bd11-2f9252c4dc2f,AIRDROP,0
airdrop-20181115-hdac-df84f705-2e19-4861-936c-fcebec6f2d0b-withdrawal-exchange,2018.11.15 10:12,UNKNOWN,,UNKNOWN-55c0f2b7-dc24-425b-9be8-6b86719f2865,2018.11.15 10:12,UNKNOWN,0,100,0,HDAC,WITHDRAWAL,,,,0,COMPLETED,0,sum-user-id,1415867.775,airdrop-20181115-hdac-sum-user-id-withdrawal,accac570-de75-11e8-bd11-2f9252c4dc2f,AIRDROP,0
airdrop-20181115-hdac-dfeaa60c-b5de-4c75-ab67-5296500e624b-withdrawal-exchange,2018.11.15 10:12,UNKNOWN,,UNKNOWN-55c0f2b7-dc24-425b-9be8-6b86719f2865,2018.11.15 10:12,UNKNOWN,0,100,0,HDAC,WITHDRAWAL,,,,0,COMPLETED,0,sum-user-id,1415767.775,airdrop-20181115-hdac-sum-user-id-withdrawal,accac570-de75-11e8-bd11-2f9252c4dc2f,AIRDROP,0
airdrop-20181115-hdac-e006132e-43a0-4073-9ec9-fa753bb83c3a-withdrawal-exchange,2018.11.15 10:12,UNKNOWN,,UNKNOWN-55c0f2b7-dc24-425b-9be8-6b86719f2865,2018.11.15 10:12,UNKNOWN,0,100,0,HDAC,WITHDRAWAL,,,,0,COMPLETED,0,sum-user-id,1415667.775,airdrop-20181115-hdac-sum-user-id-withdrawal,accac570-de75-11e8-bd11-2f9252c4dc2f,AIRDROP,0
airdrop-20181115-hdac-e00f4447-0dd2-43a4-aab1-074441d77d70-withdrawal-exchange,2018.11.15 10:12,UNKNOWN,,UNKNOWN-55c0f2b7-dc24-425b-9be8-6b86719f2865,2018.11.15 10:12,UNKNOWN,0,100,0,HDAC,WITHDRAWAL,,,,0,COMPLETED,0,sum-user-id,1415567.775,airdrop-20181115-hdac-sum-user-id-withdrawal,accac570-de75-11e8-bd11-2f9252c4dc2f,AIRDROP,0
airdrop-20181115-hdac-e0262d12-09e0-4f26-a96c-db708a3d8976-withdrawal-exchange,2018.11.15 10:12,UNKNOWN,,UNKNOWN-55c0f2b7-dc24-425b-9be8-6b86719f2865,2018.11.15 10:12,UNKNOWN,0,100,0,HDAC,WITHDRAWAL,,,,0,COMPLETED,0,sum-user-id,1415467.775,airdrop-20181115-hdac-sum-user-id-withdrawal,accac570-de75-11e8-bd11-2f9252c4dc2f,AIRDROP,0
airdrop-20181115-hdac-e03b170e-f0cb-4ab5-939f-68d737a27a62-withdrawal-exchange,2018.11.15 10:12,UNKNOWN,,UNKNOWN-55c0f2b7-dc24-425b-9be8-6b86719f2865,2018.11.15 10:12,UNKNOWN,0,100,0,HDAC,WITHDRAWAL,,,,0,COMPLETED,0,sum-user-id,1415367.775,airdrop-20181115-hdac-sum-user-id-withdrawal,accac570-de75-11e8-bd11-2f9252c4dc2f,AIRDROP,0
airdrop-20181115-hdac-e06ea87a-c75d-47d8-a0cf-c3ac3aa8bed5-withdrawal-exchange,2018.11.15 10:12,UNKNOWN,,UNKNOWN-55c0f2b7-dc24-425b-9be8-6b86719f2865,2018.11.15 10:12,UNKNOWN,0,100,0,HDAC,WITHDRAWAL,,,,0,COMPLETED,0,sum-user-id,1415267.775,airdrop-20181115-hdac-sum-user-id-withdrawal,accac570-de75-11e8-bd11-2f9252c4dc2f,AIRDROP,0
airdrop-20181115-hdac-e06eca20-27a7-4b41-a1a9-31df24188cad-withdrawal-exchange,2018.11.15 10:12,UNKNOWN,,UNKNOWN-55c0f2b7-dc24-425b-9be8-6b86719f2865,2018.11.15 10:12,UNKNOWN,0,100,0,HDAC,WITHDRAWAL,,,,0,COMPLETED,0,sum-user-id,1415167.775,airdrop-20181115-hdac-sum-user-id-withdrawal,accac570-de75-11e8-bd11-2f9252c4dc2f,AIRDROP,0
airdrop-20181115-hdac-e098418e-d88e-4987-b81f-cc68df559565-withdrawal-exchange,2018.11.15 10:12,UNKNOWN,,UNKNOWN-55c0f2b7-dc24-425b-9be8-6b86719f2865,2018.11.15 10:12,UNKNOWN,0,100,0,HDAC,WITHDRAWAL,,,,0,COMPLETED,0,sum-user-id,1415067.775,airdrop-20181115-hdac-sum-user-id-withdrawal,accac570-de75-11e8-bd11-2f9252c4dc2f,AIRDROP,0
airdrop-20181115-hdac-e0d35aba-07a8-43b0-9d2c-af944a6c4fe8-withdrawal-exchange,2018.11.15 10:12,UNKNOWN,,UNKNOWN-55c0f2b7-dc24-425b-9be8-6b86719f2865,2018.11.15 10:12,UNKNOWN,0,100,0,HDAC,WITHDRAWAL,,,,0,COMPLETED,0,sum-user-id,1414967.775,airdrop-20181115-hdac-sum-user-id-withdrawal,accac570-de75-11e8-bd11-2f9252c4dc2f,AIRDROP,0
airdrop-20181115-hdac-e0d4f92f-4244-4d9f-9398-70b02e7d0fa9-withdrawal-exchange,2018.11.15 10:12,UNKNOWN,,UNKNOWN-55c0f2b7-dc24-425b-9be8-6b86719f2865,2018.11.15 10:12,UNKNOWN,0,100,0,HDAC,WITHDRAWAL,,,,0,COMPLETED,0,sum-user-id,1414867.775,airdrop-20181115-hdac-sum-user-id-withdrawal,accac570-de75-11e8-bd11-2f9252c4dc2f,AIRDROP,0
airdrop-20181115-hdac-e0d59cee-e017-4b02-a003-86338597c66e-withdrawal-exchange,2018.11.15 10:12,UNKNOWN,,UNKNOWN-55c0f2b7-dc24-425b-9be8-6b86719f2865,2018.11.15 10:12,UNKNOWN,0,100,0,HDAC,WITHDRAWAL,,,,0,COMPLETED,0,sum-user-id,1414767.775,airdrop-20181115-hdac-sum-user-id-withdrawal,accac570-de75-11e8-bd11-2f9252c4dc2f,AIRDROP,0
airdrop-20181115-hdac-e0efa99f-4c77-4ee6-ba9b-0e7a9c5bd2b7-withdrawal-exchange,2018.11.15 10:12,UNKNOWN,,UNKNOWN-55c0f2b7-dc24-425b-9be8-6b86719f2865,2018.11.15 10:12,UNKNOWN,0,100,0,HDAC,WITHDRAWAL,,,,0,COMPLETED,0,sum-user-id,1414667.775,airdrop-20181115-hdac-sum-user-id-withdrawal,accac570-de75-11e8-bd11-2f9252c4dc2f,AIRDROP,0
airdrop-20181115-hdac-e0f65b41-46eb-4783-9c60-f9f939bbb8ab-withdrawal-exchange,2018.11.15 10:12,UNKNOWN,,UNKNOWN-55c0f2b7-dc24-425b-9be8-6b86719f2865,2018.11.15 10:12,UNKNOWN,0,100,0,HDAC,WITHDRAWAL,,,,0,COMPLETED,0,sum-user-id,1414567.775,airdrop-20181115-hdac-sum-user-id-withdrawal,accac570-de75-11e8-bd11-2f9252c4dc2f,AIRDROP,0
airdrop-20181115-hdac-e0fdc9ac-d192-4a23-a9a0-960cf83789b5-withdrawal-exchange,2018.11.15 10:12,UNKNOWN,,UNKNOWN-55c0f2b7-dc24-425b-9be8-6b86719f2865,2018.11.15 10:12,UNKNOWN,0,100,0,HDAC,WITHDRAWAL,,,,0,COMPLETED,0,sum-user-id,1414467.775,airdrop-20181115-hdac-sum-user-id-withdrawal,accac570-de75-11e8-bd11-2f9252c4dc2f,AIRDROP,0
airdrop-20181115-hdac-e13931cd-529f-4efd-9b20-43662d05d570-withdrawal-exchange,2018.11.15 10:12,UNKNOWN,,UNKNOWN-55c0f2b7-dc24-425b-9be8-6b86719f2865,2018.11.15 10:12,UNKNOWN,0,100,0,HDAC,WITHDRAWAL,,,,0,COMPLETED,0,sum-user-id,1414367.775,airdrop-20181115-hdac-sum-user-id-withdrawal,accac570-de75-11e8-bd11-2f9252c4dc2f,AIRDROP,0
airdrop-20181115-hdac-e13a4b0e-0c65-4531-a7cf-78450d27c127-withdrawal-exchange,2018.11.15 10:12,UNKNOWN,,UNKNOWN-55c0f2b7-dc24-425b-9be8-6b86719f2865,2018.11.15 10:12,UNKNOWN,0,100,0,HDAC,WITHDRAWAL,,,,0,COMPLETED,0,sum-user-id,1414267.775,airdrop-20181115-hdac-sum-user-id-withdrawal,accac570-de75-11e8-bd11-2f9252c4dc2f,AIRDROP,0
airdrop-20181115-hdac-e15fca12-b752-4747-a7a5-632eafaa81ef-withdrawal-exchange,2018.11.15 10:12,UNKNOWN,,UNKNOWN-55c0f2b7-dc24-425b-9be8-6b86719f2865,2018.11.15 10:12,UNKNOWN,0,100,0,HDAC,WITHDRAWAL,,,,0,COMPLETED,0,sum-user-id,1414167.775,airdrop-20181115-hdac-sum-user-id-withdrawal,accac570-de75-11e8-bd11-2f9252c4dc2f,AIRDROP,0
airdrop-20181115-hdac-e1679044-6604-4ee2-affa-905d0fe2a629-withdrawal-exchange,2018.11.15 10:12,UNKNOWN,,UNKNOWN-55c0f2b7-dc24-425b-9be8-6b86719f2865,2018.11.15 10:12,UNKNOWN,0,100,0,HDAC,WITHDRAWAL,,,,0,COMPLETED,0,sum-user-id,1414067.775,airdrop-20181115-hdac-sum-user-id-withdrawal,accac570-de75-11e8-bd11-2f9252c4dc2f,AIRDROP,0
airdrop-20181115-hdac-e16f463d-2315-4372-91b4-68d00935c15b-withdrawal-exchange,2018.11.15 10:12,UNKNOWN,,UNKNOWN-55c0f2b7-dc24-425b-9be8-6b86719f2865,2018.11.15 10:12,UNKNOWN,0,100,0,HDAC,WITHDRAWAL,,,,0,COMPLETED,0,sum-user-id,1413967.775,airdrop-20181115-hdac-sum-user-id-withdrawal,accac570-de75-11e8-bd11-2f9252c4dc2f,AIRDROP,0
airdrop-20181115-hdac-e1887fa8-373e-4a9a-811e-85f1790033ae-withdrawal-exchange,2018.11.15 10:12,UNKNOWN,,UNKNOWN-55c0f2b7-dc24-425b-9be8-6b86719f2865,2018.11.15 10:12,UNKNOWN,0,100,0,HDAC,WITHDRAWAL,,,,0,COMPLETED,0,sum-user-id,1413867.775,airdrop-20181115-hdac-sum-user-id-withdrawal,accac570-de75-11e8-bd11-2f9252c4dc2f,AIRDROP,0
airdrop-20181115-hdac-e18cd202-33bb-4626-98d1-256879cbe281-withdrawal-exchange,2018.11.15 10:12,UNKNOWN,,UNKNOWN-55c0f2b7-dc24-425b-9be8-6b86719f2865,2018.11.15 10:12,UNKNOWN,0,100,0,HDAC,WITHDRAWAL,,,,0,COMPLETED,0,sum-user-id,1413767.775,airdrop-20181115-hdac-sum-user-id-withdrawal,accac570-de75-11e8-bd11-2f9252c4dc2f,AIRDROP,0
airdrop-20181115-hdac-e1b23a60-1052-4ae1-97fd-ec96b2e97b29-withdrawal-exchange,2018.11.15 10:12,UNKNOWN,,UNKNOWN-55c0f2b7-dc24-425b-9be8-6b86719f2865,2018.11.15 10:12,UNKNOWN,0,100,0,HDAC,WITHDRAWAL,,,,0,COMPLETED,0,sum-user-id,1413667.775,airdrop-20181115-hdac-sum-user-id-withdrawal,accac570-de75-11e8-bd11-2f9252c4dc2f,AIRDROP,0
airdrop-20181115-hdac-e1cdd84a-5bba-40b3-badf-f71444371a3a-withdrawal-exchange,2018.11.15 10:12,UNKNOWN,,UNKNOWN-55c0f2b7-dc24-425b-9be8-6b86719f2865,2018.11.15 10:12,UNKNOWN,0,100,0,HDAC,WITHDRAWAL,,,,0,COMPLETED,0,sum-user-id,1413567.775,airdrop-20181115-hdac-sum-user-id-withdrawal,accac570-de75-11e8-bd11-2f9252c4dc2f,AIRDROP,0
airdrop-20181115-hdac-e1d32bbf-c306-4468-a57e-b37206530878-withdrawal-exchange,2018-11-15 10:12:18.028,UNKNOWN,,UNKNOWN-55c0f2b7-dc24-425b-9be8-6b86719f2865,2018-11-15 10:12:18.028,UNKNOWN,0,100,0,HDAC,WITHDRAWAL,,,,0,COMPLETED,0,sum-user-id,1413467.775,airdrop-20181115-hdac-sum-user-id-withdrawal,accac570-de75-11e8-bd11-2f9252c4dc2f,AIRDROP,0
airdrop-20181115-hdac-e1d5ea84-ca4b-4ff4-b020-abd5a6c557fe-withdrawal-exchange,2018-11-15 10:12:18.058,UNKNOWN,,UNKNOWN-55c0f2b7-dc24-425b-9be8-6b86719f2865,2018-11-15 10:12:18.058,UNKNOWN,0,100,0,HDAC,WITHDRAWAL,,,,0,COMPLETED,0,sum-user-id,1413367.775,airdrop-20181115-hdac-sum-user-id-withdrawal,accac570-de75-11e8-bd11-2f9252c4dc2f,AIRDROP,0
airdrop-20181115-hdac-e219b0ab-e983-4f3e-9815-9c4066eacb79-withdrawal-exchange,2018-11-15 10:12:18.085,UNKNOWN,,UNKNOWN-55c0f2b7-dc24-425b-9be8-6b86719f2865,2018-11-15 10:12:18.085,UNKNOWN,0,100,0,HDAC,WITHDRAWAL,,,,0,COMPLETED,0,sum-user-id,1413267.775,airdrop-20181115-hdac-sum-user-id-withdrawal,accac570-de75-11e8-bd11-2f9252c4dc2f,AIRDROP,0
airdrop-20181115-hdac-e21d3fd1-5381-4f4d-8d6d-d60256daf1b7-withdrawal-exchange,2018.11.15 10:12,UNKNOWN,,UNKNOWN-55c0f2b7-dc24-425b-9be8-6b86719f2865,2018.11.15 10:12,UNKNOWN,0,100,0,HDAC,WITHDRAWAL,,,,0,COMPLETED,0,sum-user-id,1413167.775,airdrop-20181115-hdac-sum-user-id-withdrawal,accac570-de75-11e8-bd11-2f9252c4dc2f,AIRDROP,0
airdrop-20181115-hdac-e22f76c0-1039-4b0d-a7a3-df6ebd6b1c16-withdrawal-exchange,2018.11.15 10:12,UNKNOWN,,UNKNOWN-55c0f2b7-dc24-425b-9be8-6b86719f2865,2018.11.15 10:12,UNKNOWN,0,100,0,HDAC,WITHDRAWAL,,,,0,COMPLETED,0,sum-user-id,1413067.775,airdrop-20181115-hdac-sum-user-id-withdrawal,accac570-de75-11e8-bd11-2f9252c4dc2f,AIRDROP,0
airdrop-20181115-hdac-e2384a60-b5f8-412a-99eb-29ecffa816f3-withdrawal-exchange,2018.11.15 10:12,UNKNOWN,,UNKNOWN-55c0f2b7-dc24-425b-9be8-6b86719f2865,2018.11.15 10:12,UNKNOWN,0,100,0,HDAC,WITHDRAWAL,,,,0,COMPLETED,0,sum-user-id,1412967.775,airdrop-20181115-hdac-sum-user-id-withdrawal,accac570-de75-11e8-bd11-2f9252c4dc2f,AIRDROP,0
airdrop-20181115-hdac-e247a5c3-33ce-463a-90c3-fee415c9fc7e-withdrawal-exchange,2018.11.15 10:12,UNKNOWN,,UNKNOWN-55c0f2b7-dc24-425b-9be8-6b86719f2865,2018.11.15 10:12,UNKNOWN,0,100,0,HDAC,WITHDRAWAL,,,,0,COMPLETED,0,sum-user-id,1412867.775,airdrop-20181115-hdac-sum-user-id-withdrawal,accac570-de75-11e8-bd11-2f9252c4dc2f,AIRDROP,0
airdrop-20181115-hdac-e265c07d-6ed1-4446-a327-9b189b3f1429-withdrawal-exchange,2018.11.15 10:12,UNKNOWN,,UNKNOWN-55c0f2b7-dc24-425b-9be8-6b86719f2865,2018.11.15 10:12,UNKNOWN,0,100,0,HDAC,WITHDRAWAL,,,,0,COMPLETED,0,sum-user-id,1412767.775,airdrop-20181115-hdac-sum-user-id-withdrawal,accac570-de75-11e8-bd11-2f9252c4dc2f,AIRDROP,0
airdrop-20181115-hdac-e27c3f91-5f1b-4830-ba86-10642218c8b0-withdrawal-exchange,2018.11.15 10:12,UNKNOWN,,UNKNOWN-55c0f2b7-dc24-425b-9be8-6b86719f2865,2018.11.15 10:12,UNKNOWN,0,100,0,HDAC,WITHDRAWAL,,,,0,COMPLETED,0,sum-user-id,1412667.775,airdrop-20181115-hdac-sum-user-id-withdrawal,accac570-de75-11e8-bd11-2f9252c4dc2f,AIRDROP,0
airdrop-20181115-hdac-e2893b69-6dc1-4eaa-bd4f-abf3b7d82485-withdrawal-exchange,2018.11.15 10:12,UNKNOWN,,UNKNOWN-55c0f2b7-dc24-425b-9be8-6b86719f2865,2018.11.15 10:12,UNKNOWN,0,100,0,HDAC,WITHDRAWAL,,,,0,COMPLETED,0,sum-user-id,1412567.775,airdrop-20181115-hdac-sum-user-id-withdrawal,accac570-de75-11e8-bd11-2f9252c4dc2f,AIRDROP,0
airdrop-20181115-hdac-e28db737-a436-44f3-bd3e-3a573e945365-withdrawal-exchange,2018.11.15 10:12,UNKNOWN,,UNKNOWN-55c0f2b7-dc24-425b-9be8-6b86719f2865,2018.11.15 10:12,UNKNOWN,0,100,0,HDAC,WITHDRAWAL,,,,0,COMPLETED,0,sum-user-id,1412467.775,airdrop-20181115-hdac-sum-user-id-withdrawal,accac570-de75-11e8-bd11-2f9252c4dc2f,AIRDROP,0
airdrop-20181115-hdac-e2aa43b2-e994-449d-98ff-0436ba67bc51-withdrawal-exchange,2018.11.15 10:12,UNKNOWN,,UNKNOWN-55c0f2b7-dc24-425b-9be8-6b86719f2865,2018.11.15 10:12,UNKNOWN,0,100,0,HDAC,WITHDRAWAL,,,,0,COMPLETED,0,sum-user-id,1412367.775,airdrop-20181115-hdac-sum-user-id-withdrawal,accac570-de75-11e8-bd11-2f9252c4dc2f,AIRDROP,0
airdrop-20181115-hdac-e2dcf041-9f73-4abd-8ebc-06df47124b02-withdrawal-exchange,2018.11.15 10:12,UNKNOWN,,UNKNOWN-55c0f2b7-dc24-425b-9be8-6b86719f2865,2018.11.15 10:12,UNKNOWN,0,100,0,HDAC,WITHDRAWAL,,,,0,COMPLETED,0,sum-user-id,1412267.775,airdrop-20181115-hdac-sum-user-id-withdrawal,accac570-de75-11e8-bd11-2f9252c4dc2f,AIRDROP,0
airdrop-20181115-hdac-e3124e2d-f9c8-4397-b961-b2ec04d862d1-withdrawal-exchange,2018.11.15 10:12,UNKNOWN,,UNKNOWN-55c0f2b7-dc24-425b-9be8-6b86719f2865,2018.11.15 10:12,UNKNOWN,0,100,0,HDAC,WITHDRAWAL,,,,0,COMPLETED,0,sum-user-id,1412167.775,airdrop-20181115-hdac-sum-user-id-withdrawal,accac570-de75-11e8-bd11-2f9252c4dc2f,AIRDROP,0
airdrop-20181115-hdac-e31c6ffc-98e0-4506-a9f3-934f82b365c7-withdrawal-exchange,2018.11.15 10:12,UNKNOWN,,UNKNOWN-55c0f2b7-dc24-425b-9be8-6b86719f2865,2018.11.15 10:12,UNKNOWN,0,100,0,HDAC,WITHDRAWAL,,,,0,COMPLETED,0,sum-user-id,1412067.775,airdrop-20181115-hdac-sum-user-id-withdrawal,accac570-de75-11e8-bd11-2f9252c4dc2f,AIRDROP,0
airdrop-20181115-hdac-e325c8a2-5a5a-4224-a98e-a7352c9d8080-withdrawal-exchange,2018.11.15 10:12,UNKNOWN,,UNKNOWN-55c0f2b7-dc24-425b-9be8-6b86719f2865,2018.11.15 10:12,UNKNOWN,0,100,0,HDAC,WITHDRAWAL,,,,0,COMPLETED,0,sum-user-id,1411967.775,airdrop-20181115-hdac-sum-user-id-withdrawal,accac570-de75-11e8-bd11-2f9252c4dc2f,AIRDROP,0
airdrop-20181115-hdac-e3810cc0-59d4-45c3-930d-a4bcc869c9d5-withdrawal-exchange,2018.11.15 10:12,UNKNOWN,,UNKNOWN-55c0f2b7-dc24-425b-9be8-6b86719f2865,2018.11.15 10:12,UNKNOWN,0,100,0,HDAC,WITHDRAWAL,,,,0,COMPLETED,0,sum-user-id,1411867.775,airdrop-20181115-hdac-sum-user-id-withdrawal,accac570-de75-11e8-bd11-2f9252c4dc2f,AIRDROP,0
airdrop-20181115-hdac-e38c63de-0b05-427e-b51f-c68e8a55c4ae-withdrawal-exchange,2018.11.15 10:12,UNKNOWN,,UNKNOWN-55c0f2b7-dc24-425b-9be8-6b86719f2865,2018.11.15 10:12,UNKNOWN,0,100,0,HDAC,WITHDRAWAL,,,,0,COMPLETED,0,sum-user-id,1411767.775,airdrop-20181115-hdac-sum-user-id-withdrawal,accac570-de75-11e8-bd11-2f9252c4dc2f,AIRDROP,0
airdrop-20181115-hdac-e3fb6a4e-3180-422f-bee4-fbc0b577707f-withdrawal-exchange,2018.11.15 10:12,UNKNOWN,,UNKNOWN-55c0f2b7-dc24-425b-9be8-6b86719f2865,2018.11.15 10:12,UNKNOWN,0,100,0,HDAC,WITHDRAWAL,,,,0,COMPLETED,0,sum-user-id,1411667.775,airdrop-20181115-hdac-sum-user-id-withdrawal,accac570-de75-11e8-bd11-2f9252c4dc2f,AIRDROP,0
airdrop-20181115-hdac-e402e4f4-d72c-4f0e-8ad9-f4e1be2b2696-withdrawal-exchange,2018.11.15 10:12,UNKNOWN,,UNKNOWN-55c0f2b7-dc24-425b-9be8-6b86719f2865,2018.11.15 10:12,UNKNOWN,0,100,0,HDAC,WITHDRAWAL,,,,0,COMPLETED,0,sum-user-id,1411567.775,airdrop-20181115-hdac-sum-user-id-withdrawal,accac570-de75-11e8-bd11-2f9252c4dc2f,AIRDROP,0
airdrop-20181115-hdac-e40d8781-d5ec-44e4-a0e3-6357e26aa9f4-withdrawal-exchange,2018.11.15 10:12,UNKNOWN,,UNKNOWN-55c0f2b7-dc24-425b-9be8-6b86719f2865,2018.11.15 10:12,UNKNOWN,0,100,0,HDAC,WITHDRAWAL,,,,0,COMPLETED,0,sum-user-id,1411467.775,airdrop-20181115-hdac-sum-user-id-withdrawal,accac570-de75-11e8-bd11-2f9252c4dc2f,AIRDROP,0
airdrop-20181115-hdac-e42971eb-6a0e-4a38-874d-bc19d348ec12-withdrawal-exchange,2018.11.15 10:12,UNKNOWN,,UNKNOWN-55c0f2b7-dc24-425b-9be8-6b86719f2865,2018.11.15 10:12,UNKNOWN,0,100,0,HDAC,WITHDRAWAL,,,,0,COMPLETED,0,sum-user-id,1411367.775,airdrop-20181115-hdac-sum-user-id-withdrawal,accac570-de75-11e8-bd11-2f9252c4dc2f,AIRDROP,0
airdrop-20181115-hdac-e491b794-55ae-4711-aec9-44d42e2e71f3-withdrawal-exchange,2018.11.15 10:12,UNKNOWN,,UNKNOWN-55c0f2b7-dc24-425b-9be8-6b86719f2865,2018.11.15 10:12,UNKNOWN,0,100,0,HDAC,WITHDRAWAL,,,,0,COMPLETED,0,sum-user-id,1411267.775,airdrop-20181115-hdac-sum-user-id-withdrawal,accac570-de75-11e8-bd11-2f9252c4dc2f,AIRDROP,0
airdrop-20181115-hdac-e4a365bf-916f-40bd-b22b-1ad4853bebfe-withdrawal-exchange,2018.11.15 10:12,UNKNOWN,,UNKNOWN-55c0f2b7-dc24-425b-9be8-6b86719f2865,2018.11.15 10:12,UNKNOWN,0,100,0,HDAC,WITHDRAWAL,,,,0,COMPLETED,0,sum-user-id,1411167.775,airdrop-20181115-hdac-sum-user-id-withdrawal,accac570-de75-11e8-bd11-2f9252c4dc2f,AIRDROP,0
airdrop-20181115-hdac-e4a5bf06-185a-4e15-aed9-3e30396b6b9b-withdrawal-exchange,2018.11.15 10:12,UNKNOWN,,UNKNOWN-55c0f2b7-dc24-425b-9be8-6b86719f2865,2018.11.15 10:12,UNKNOWN,0,100,0,HDAC,WITHDRAWAL,,,,0,COMPLETED,0,sum-user-id,1411067.775,airdrop-20181115-hdac-sum-user-id-withdrawal,accac570-de75-11e8-bd11-2f9252c4dc2f,AIRDROP,0
airdrop-20181115-hdac-e4b3e05d-abf1-4348-b652-afe1c1455d35-withdrawal-exchange,2018.11.15 10:12,UNKNOWN,,UNKNOWN-55c0f2b7-dc24-425b-9be8-6b86719f2865,2018.11.15 10:12,UNKNOWN,0,100,0,HDAC,WITHDRAWAL,,,,0,COMPLETED,0,sum-user-id,1410967.775,airdrop-20181115-hdac-sum-user-id-withdrawal,accac570-de75-11e8-bd11-2f9252c4dc2f,AIRDROP,0
airdrop-20181115-hdac-e525e797-b53a-4aa0-b493-a041b092e72a-withdrawal-exchange,2018.11.15 10:12,UNKNOWN,,UNKNOWN-55c0f2b7-dc24-425b-9be8-6b86719f2865,2018.11.15 10:12,UNKNOWN,0,100,0,HDAC,WITHDRAWAL,,,,0,COMPLETED,0,sum-user-id,1410867.775,airdrop-20181115-hdac-sum-user-id-withdrawal,accac570-de75-11e8-bd11-2f9252c4dc2f,AIRDROP,0
airdrop-20181115-hdac-e537d1bf-43cd-4b4a-b8ac-2b7fd08b33b4-withdrawal-exchange,2018.11.15 10:12,UNKNOWN,,UNKNOWN-55c0f2b7-dc24-425b-9be8-6b86719f2865,2018.11.15 10:12,UNKNOWN,0,100,0,HDAC,WITHDRAWAL,,,,0,COMPLETED,0,sum-user-id,1410767.775,airdrop-20181115-hdac-sum-user-id-withdrawal,accac570-de75-11e8-bd11-2f9252c4dc2f,AIRDROP,0
airdrop-20181115-hdac-e53c0167-6bff-4bb2-9623-161c32826972-withdrawal-exchange,2018.11.15 10:12,UNKNOWN,,UNKNOWN-55c0f2b7-dc24-425b-9be8-6b86719f2865,2018.11.15 10:12,UNKNOWN,0,100,0,HDAC,WITHDRAWAL,,,,0,COMPLETED,0,sum-user-id,1410667.775,airdrop-20181115-hdac-sum-user-id-withdrawal,accac570-de75-11e8-bd11-2f9252c4dc2f,AIRDROP,0
airdrop-20181115-hdac-e53e752c-29e1-437b-a434-53212aa83000-withdrawal-exchange,2018.11.15 10:12,UNKNOWN,,UNKNOWN-55c0f2b7-dc24-425b-9be8-6b86719f2865,2018.11.15 10:12,UNKNOWN,0,11136.47509,0,HDAC,WITHDRAWAL,,,,0,COMPLETED,0,sum-user-id,1399531.3,airdrop-20181115-hdac-sum-user-id-withdrawal,accac570-de75-11e8-bd11-2f9252c4dc2f,AIRDROP,0
airdrop-20181115-hdac-e53e8b78-3593-465f-b6db-f0a17f2464e1-withdrawal-exchange,2018.11.15 10:12,UNKNOWN,,UNKNOWN-55c0f2b7-dc24-425b-9be8-6b86719f2865,2018.11.15 10:12,UNKNOWN,0,100,0,HDAC,WITHDRAWAL,,,,0,COMPLETED,0,sum-user-id,1399431.3,airdrop-20181115-hdac-sum-user-id-withdrawal,accac570-de75-11e8-bd11-2f9252c4dc2f,AIRDROP,0
airdrop-20181115-hdac-e548ad9e-6efd-4657-a3b6-c919fc61c6ce-withdrawal-exchange,2018.11.15 10:12,UNKNOWN,,UNKNOWN-55c0f2b7-dc24-425b-9be8-6b86719f2865,2018.11.15 10:12,UNKNOWN,0,100,0,HDAC,WITHDRAWAL,,,,0,COMPLETED,0,sum-user-id,1399331.3,airdrop-20181115-hdac-sum-user-id-withdrawal,accac570-de75-11e8-bd11-2f9252c4dc2f,AIRDROP,0
airdrop-20181115-hdac-e55f52d6-74f4-41e5-92ac-92e3ce1747b6-withdrawal-exchange,2018-11-15 10:12:19.020,UNKNOWN,,UNKNOWN-55c0f2b7-dc24-425b-9be8-6b86719f2865,2018-11-15 10:12:19.020,UNKNOWN,0,100,0,HDAC,WITHDRAWAL,,,,0,COMPLETED,0,sum-user-id,1399231.3,airdrop-20181115-hdac-sum-user-id-withdrawal,accac570-de75-11e8-bd11-2f9252c4dc2f,AIRDROP,0
airdrop-20181115-hdac-e5addccb-d1db-4a2a-b9ae-b8b1bd1787ea-withdrawal-exchange,2018-11-15 10:12:19.054,UNKNOWN,,UNKNOWN-55c0f2b7-dc24-425b-9be8-6b86719f2865,2018-11-15 10:12:19.054,UNKNOWN,0,100,0,HDAC,WITHDRAWAL,,,,0,COMPLETED,0,sum-user-id,1399131.3,airdrop-20181115-hdac-sum-user-id-withdrawal,accac570-de75-11e8-bd11-2f9252c4dc2f,AIRDROP,0
airdrop-20181115-hdac-e5ccd0ff-c90c-479b-b648-f24a2b4068e0-withdrawal-exchange,2018-11-15 10:12:19.086,UNKNOWN,,UNKNOWN-55c0f2b7-dc24-425b-9be8-6b86719f2865,2018-11-15 10:12:19.086,UNKNOWN,0,100,0,HDAC,WITHDRAWAL,,,,0,COMPLETED,0,sum-user-id,1399031.3,airdrop-20181115-hdac-sum-user-id-withdrawal,accac570-de75-11e8-bd11-2f9252c4dc2f,AIRDROP,0
airdrop-20181115-hdac-e60a6242-4985-4daf-a285-01e857c11f81-withdrawal-exchange,2018.11.15 10:12,UNKNOWN,,UNKNOWN-55c0f2b7-dc24-425b-9be8-6b86719f2865,2018.11.15 10:12,UNKNOWN,0,100,0,HDAC,WITHDRAWAL,,,,0,COMPLETED,0,sum-user-id,1398931.3,airdrop-20181115-hdac-sum-user-id-withdrawal,accac570-de75-11e8-bd11-2f9252c4dc2f,AIRDROP,0
airdrop-20181115-hdac-e613684a-5bc3-46a8-b1aa-47964f99f631-withdrawal-exchange,2018.11.15 10:12,UNKNOWN,,UNKNOWN-55c0f2b7-dc24-425b-9be8-6b86719f2865,2018.11.15 10:12,UNKNOWN,0,100,0,HDAC,WITHDRAWAL,,,,0,COMPLETED,0,sum-user-id,1398831.3,airdrop-20181115-hdac-sum-user-id-withdrawal,accac570-de75-11e8-bd11-2f9252c4dc2f,AIRDROP,0
airdrop-20181115-hdac-e625e783-4bc3-43f4-b8db-754e43917b0d-withdrawal-exchange,2018.11.15 10:12,UNKNOWN,,UNKNOWN-55c0f2b7-dc24-425b-9be8-6b86719f2865,2018.11.15 10:12,UNKNOWN,0,100,0,HDAC,WITHDRAWAL,,,,0,COMPLETED,0,sum-user-id,1398731.3,airdrop-20181115-hdac-sum-user-id-withdrawal,accac570-de75-11e8-bd11-2f9252c4dc2f,AIRDROP,0
airdrop-20181115-hdac-e6349abf-251a-40ae-8807-6c63a8d1b6ee-withdrawal-exchange,2018.11.15 10:12,UNKNOWN,,UNKNOWN-55c0f2b7-dc24-425b-9be8-6b86719f2865,2018.11.15 10:12,UNKNOWN,0,100,0,HDAC,WITHDRAWAL,,,,0,COMPLETED,0,sum-user-id,1398631.3,airdrop-20181115-hdac-sum-user-id-withdrawal,accac570-de75-11e8-bd11-2f9252c4dc2f,AIRDROP,0
airdrop-20181115-hdac-e6516c73-5980-4bab-9ff2-46a3f09563de-withdrawal-exchange,2018.11.15 10:12,UNKNOWN,,UNKNOWN-55c0f2b7-dc24-425b-9be8-6b86719f2865,2018.11.15 10:12,UNKNOWN,0,100,0,HDAC,WITHDRAWAL,,,,0,COMPLETED,0,sum-user-id,1398531.3,airdrop-20181115-hdac-sum-user-id-withdrawal,accac570-de75-11e8-bd11-2f9252c4dc2f,AIRDROP,0
airdrop-20181115-hdac-e6992edc-3fd8-4845-96e2-43bd331068ba-withdrawal-exchange,2018.11.15 10:12,UNKNOWN,,UNKNOWN-55c0f2b7-dc24-425b-9be8-6b86719f2865,2018.11.15 10:12,UNKNOWN,0,100,0,HDAC,WITHDRAWAL,,,,0,COMPLETED,0,sum-user-id,1398431.3,airdrop-20181115-hdac-sum-user-id-withdrawal,accac570-de75-11e8-bd11-2f9252c4dc2f,AIRDROP,0
airdrop-20181115-hdac-e6b3b613-6395-453d-bc50-dcaf890ffd9c-withdrawal-exchange,2018.11.15 10:12,UNKNOWN,,UNKNOWN-55c0f2b7-dc24-425b-9be8-6b86719f2865,2018.11.15 10:12,UNKNOWN,0,100,0,HDAC,WITHDRAWAL,,,,0,COMPLETED,0,sum-user-id,1398331.3,airdrop-20181115-hdac-sum-user-id-withdrawal,accac570-de75-11e8-bd11-2f9252c4dc2f,AIRDROP,0
airdrop-20181115-hdac-e6c63982-3c73-411c-be03-62d601047290-withdrawal-exchange,2018.11.15 10:12,UNKNOWN,,UNKNOWN-55c0f2b7-dc24-425b-9be8-6b86719f2865,2018.11.15 10:12,UNKNOWN,0,100,0,HDAC,WITHDRAWAL,,,,0,COMPLETED,0,sum-user-id,1398231.3,airdrop-20181115-hdac-sum-user-id-withdrawal,accac570-de75-11e8-bd11-2f9252c4dc2f,AIRDROP,0
airdrop-20181115-hdac-e6e38d39-c44f-4fe1-bf03-44b751d3819c-withdrawal-exchange,2018.11.15 10:12,UNKNOWN,,UNKNOWN-55c0f2b7-dc24-425b-9be8-6b86719f2865,2018.11.15 10:12,UNKNOWN,0,100,0,HDAC,WITHDRAWAL,,,,0,COMPLETED,0,sum-user-id,1398131.3,airdrop-20181115-hdac-sum-user-id-withdrawal,accac570-de75-11e8-bd11-2f9252c4dc2f,AIRDROP,0
airdrop-20181115-hdac-e7333aad-22fd-4ca3-b9de-018a57114f6f-withdrawal-exchange,2018.11.15 10:12,UNKNOWN,,UNKNOWN-55c0f2b7-dc24-425b-9be8-6b86719f2865,2018.11.15 10:12,UNKNOWN,0,100,0,HDAC,WITHDRAWAL,,,,0,COMPLETED,0,sum-user-id,1398031.3,airdrop-20181115-hdac-sum-user-id-withdrawal,accac570-de75-11e8-bd11-2f9252c4dc2f,AIRDROP,0
airdrop-20181115-hdac-e7503ec3-71d3-4b93-81b9-ff8bdc444395-withdrawal-exchange,2018.11.15 10:12,UNKNOWN,,UNKNOWN-55c0f2b7-dc24-425b-9be8-6b86719f2865,2018.11.15 10:12,UNKNOWN,0,100,0,HDAC,WITHDRAWAL,,,,0,COMPLETED,0,sum-user-id,1397931.3,airdrop-20181115-hdac-sum-user-id-withdrawal,accac570-de75-11e8-bd11-2f9252c4dc2f,AIRDROP,0
airdrop-20181115-hdac-e774e1e3-a006-436b-9846-b6da2041f923-withdrawal-exchange,2018.11.15 10:12,UNKNOWN,,UNKNOWN-55c0f2b7-dc24-425b-9be8-6b86719f2865,2018.11.15 10:12,UNKNOWN,0,100,0,HDAC,WITHDRAWAL,,,,0,COMPLETED,0,sum-user-id,1397831.3,airdrop-20181115-hdac-sum-user-id-withdrawal,accac570-de75-11e8-bd11-2f9252c4dc2f,AIRDROP,0
airdrop-20181115-hdac-e79153f2-8c18-458a-8fef-21d70f8d137a-withdrawal-exchange,2018.11.15 10:12,UNKNOWN,,UNKNOWN-55c0f2b7-dc24-425b-9be8-6b86719f2865,2018.11.15 10:12,UNKNOWN,0,100,0,HDAC,WITHDRAWAL,,,,0,COMPLETED,0,sum-user-id,1397731.3,airdrop-20181115-hdac-sum-user-id-withdrawal,accac570-de75-11e8-bd11-2f9252c4dc2f,AIRDROP,0
airdrop-20181115-hdac-e7c4c856-1c5c-48f3-8f21-edc8778820e2-withdrawal-exchange,2018.11.15 10:12,UNKNOWN,,UNKNOWN-55c0f2b7-dc24-425b-9be8-6b86719f2865,2018.11.15 10:12,UNKNOWN,0,100,0,HDAC,WITHDRAWAL,,,,0,COMPLETED,0,sum-user-id,1397631.3,airdrop-20181115-hdac-sum-user-id-withdrawal,accac570-de75-11e8-bd11-2f9252c4dc2f,AIRDROP,0
airdrop-20181115-hdac-e7cf0ba0-825e-44bb-9587-a306771a836f-withdrawal-exchange,2018.11.15 10:12,UNKNOWN,,UNKNOWN-55c0f2b7-dc24-425b-9be8-6b86719f2865,2018.11.15 10:12,UNKNOWN,0,100,0,HDAC,WITHDRAWAL,,,,0,COMPLETED,0,sum-user-id,1397531.3,airdrop-20181115-hdac-sum-user-id-withdrawal,accac570-de75-11e8-bd11-2f9252c4dc2f,AIRDROP,0
airdrop-20181115-hdac-e7d0a6e3-885a-4f6a-92b0-6c664187efac-withdrawal-exchange,2018.11.15 10:12,UNKNOWN,,UNKNOWN-55c0f2b7-dc24-425b-9be8-6b86719f2865,2018.11.15 10:12,UNKNOWN,0,100,0,HDAC,WITHDRAWAL,,,,0,COMPLETED,0,sum-user-id,1397431.3,airdrop-20181115-hdac-sum-user-id-withdrawal,accac570-de75-11e8-bd11-2f9252c4dc2f,AIRDROP,0
airdrop-20181115-hdac-e7eac078-696e-4dd4-a5d0-f351d18b37fc-withdrawal-exchange,2018.11.15 10:12,UNKNOWN,,UNKNOWN-55c0f2b7-dc24-425b-9be8-6b86719f2865,2018.11.15 10:12,UNKNOWN,0,100,0,HDAC,WITHDRAWAL,,,,0,COMPLETED,0,sum-user-id,1397331.3,airdrop-20181115-hdac-sum-user-id-withdrawal,accac570-de75-11e8-bd11-2f9252c4dc2f,AIRDROP,0
airdrop-20181115-hdac-e7f093c6-0613-4ef3-a88f-9aea01bb0ffd-withdrawal-exchange,2018.11.15 10:12,UNKNOWN,,UNKNOWN-55c0f2b7-dc24-425b-9be8-6b86719f2865,2018.11.15 10:12,UNKNOWN,0,100,0,HDAC,WITHDRAWAL,,,,0,COMPLETED,0,sum-user-id,1397231.3,airdrop-20181115-hdac-sum-user-id-withdrawal,accac570-de75-11e8-bd11-2f9252c4dc2f,AIRDROP,0
airdrop-20181115-hdac-e7fcd2df-956f-41d7-af74-affaee58cfb7-withdrawal-exchange,2018.11.15 10:12,UNKNOWN,,UNKNOWN-55c0f2b7-dc24-425b-9be8-6b86719f2865,2018.11.15 10:12,UNKNOWN,0,100,0,HDAC,WITHDRAWAL,,,,0,COMPLETED,0,sum-user-id,1397131.3,airdrop-20181115-hdac-sum-user-id-withdrawal,accac570-de75-11e8-bd11-2f9252c4dc2f,AIRDROP,0
airdrop-20181115-hdac-e81bcd25-10b5-406c-bf24-aff1ac94cdd7-withdrawal-exchange,2018.11.15 10:12,UNKNOWN,,UNKNOWN-55c0f2b7-dc24-425b-9be8-6b86719f2865,2018.11.15 10:12,UNKNOWN,0,100,0,HDAC,WITHDRAWAL,,,,0,COMPLETED,0,sum-user-id,1397031.3,airdrop-20181115-hdac-sum-user-id-withdrawal,accac570-de75-11e8-bd11-2f9252c4dc2f,AIRDROP,0
airdrop-20181115-hdac-e82307ab-dcb2-46de-80ac-b1356c270771-withdrawal-exchange,2018.11.15 10:12,UNKNOWN,,UNKNOWN-55c0f2b7-dc24-425b-9be8-6b86719f2865,2018.11.15 10:12,UNKNOWN,0,100,0,HDAC,WITHDRAWAL,,,,0,COMPLETED,0,sum-user-id,1396931.3,airdrop-20181115-hdac-sum-user-id-withdrawal,accac570-de75-11e8-bd11-2f9252c4dc2f,AIRDROP,0
airdrop-20181115-hdac-e82a1282-b405-4772-8108-6b5091a89e8d-withdrawal-exchange,2018.11.15 10:12,UNKNOWN,,UNKNOWN-55c0f2b7-dc24-425b-9be8-6b86719f2865,2018.11.15 10:12,UNKNOWN,0,100,0,HDAC,WITHDRAWAL,,,,0,COMPLETED,0,sum-user-id,1396831.3,airdrop-20181115-hdac-sum-user-id-withdrawal,accac570-de75-11e8-bd11-2f9252c4dc2f,AIRDROP,0
airdrop-20181115-hdac-e840efff-a259-4e6a-8a71-d440b3b1d295-withdrawal-exchange,2018.11.15 10:12,UNKNOWN,,UNKNOWN-55c0f2b7-dc24-425b-9be8-6b86719f2865,2018.11.15 10:12,UNKNOWN,0,100,0,HDAC,WITHDRAWAL,,,,0,COMPLETED,0,sum-user-id,1396731.3,airdrop-20181115-hdac-sum-user-id-withdrawal,accac570-de75-11e8-bd11-2f9252c4dc2f,AIRDROP,0
airdrop-20181115-hdac-e84ff7d6-a77c-43f7-8384-f9935c81c270-withdrawal-exchange,2018.11.15 10:12,UNKNOWN,,UNKNOWN-55c0f2b7-dc24-425b-9be8-6b86719f2865,2018.11.15 10:12,UNKNOWN,0,100,0,HDAC,WITHDRAWAL,,,,0,COMPLETED,0,sum-user-id,1396631.3,airdrop-20181115-hdac-sum-user-id-withdrawal,accac570-de75-11e8-bd11-2f9252c4dc2f,AIRDROP,0
airdrop-20181115-hdac-e85bfcb6-4d40-4ff6-a499-649f95ed828a-withdrawal-exchange,2018.11.15 10:12,UNKNOWN,,UNKNOWN-55c0f2b7-dc24-425b-9be8-6b86719f2865,2018.11.15 10:12,UNKNOWN,0,100,0,HDAC,WITHDRAWAL,,,,0,COMPLETED,0,sum-user-id,1396531.3,airdrop-20181115-hdac-sum-user-id-withdrawal,accac570-de75-11e8-bd11-2f9252c4dc2f,AIRDROP,0
airdrop-20181115-hdac-e85fbecf-115e-49d2-a549-66eba0b81c8b-withdrawal-exchange,2018.11.15 10:12,UNKNOWN,,UNKNOWN-55c0f2b7-dc24-425b-9be8-6b86719f2865,2018.11.15 10:12,UNKNOWN,0,100,0,HDAC,WITHDRAWAL,,,,0,COMPLETED,0,sum-user-id,1396431.3,airdrop-20181115-hdac-sum-user-id-withdrawal,accac570-de75-11e8-bd11-2f9252c4dc2f,AIRDROP,0
airdrop-20181115-hdac-e86179d0-c3df-4554-98ac-b6b43b82efee-withdrawal-exchange,2018.11.15 10:12,UNKNOWN,,UNKNOWN-55c0f2b7-dc24-425b-9be8-6b86719f2865,2018.11.15 10:12,UNKNOWN,0,100,0,HDAC,WITHDRAWAL,,,,0,COMPLETED,0,sum-user-id,1396331.3,airdrop-20181115-hdac-sum-user-id-withdrawal,accac570-de75-11e8-bd11-2f9252c4dc2f,AIRDROP,0
airdrop-20181115-hdac-e87bae73-8e83-4007-b52b-91f28f9ee8af-withdrawal-exchange,2018.11.15 10:12,UNKNOWN,,UNKNOWN-55c0f2b7-dc24-425b-9be8-6b86719f2865,2018.11.15 10:12,UNKNOWN,0,100,0,HDAC,WITHDRAWAL,,,,0,COMPLETED,0,sum-user-id,1396231.3,airdrop-20181115-hdac-sum-user-id-withdrawal,accac570-de75-11e8-bd11-2f9252c4dc2f,AIRDROP,0
airdrop-20181115-hdac-e8911258-b4ff-47f3-af1a-1c00dea06d7f-withdrawal-exchange,2018.11.15 10:12,UNKNOWN,,UNKNOWN-55c0f2b7-dc24-425b-9be8-6b86719f2865,2018.11.15 10:12,UNKNOWN,0,100,0,HDAC,WITHDRAWAL,,,,0,COMPLETED,0,sum-user-id,1396131.3,airdrop-20181115-hdac-sum-user-id-withdrawal,accac570-de75-11e8-bd11-2f9252c4dc2f,AIRDROP,0
airdrop-20181115-hdac-e8920e9a-0505-420a-be96-0d333219f065-withdrawal-exchange,2018-11-15 10:12:20.004,UNKNOWN,,UNKNOWN-55c0f2b7-dc24-425b-9be8-6b86719f2865,2018-11-15 10:12:20.004,UNKNOWN,0,100,0,HDAC,WITHDRAWAL,,,,0,COMPLETED,0,sum-user-id,1396031.3,airdrop-20181115-hdac-sum-user-id-withdrawal,accac570-de75-11e8-bd11-2f9252c4dc2f,AIRDROP,0
airdrop-20181115-hdac-e89999fc-d9b7-4ea1-9ed3-1da8911073e4-withdrawal-exchange,2018-11-15 10:12:20.039,UNKNOWN,,UNKNOWN-55c0f2b7-dc24-425b-9be8-6b86719f2865,2018-11-15 10:12:20.039,UNKNOWN,0,100,0,HDAC,WITHDRAWAL,,,,0,COMPLETED,0,sum-user-id,1395931.3,airdrop-20181115-hdac-sum-user-id-withdrawal,accac570-de75-11e8-bd11-2f9252c4dc2f,AIRDROP,0
airdrop-20181115-hdac-e899ef9d-1de4-43e9-b139-fdda8a93844a-withdrawal-exchange,2018-11-15 10:12:20.071,UNKNOWN,,UNKNOWN-55c0f2b7-dc24-425b-9be8-6b86719f2865,2018-11-15 10:12:20.071,UNKNOWN,0,100,0,HDAC,WITHDRAWAL,,,,0,COMPLETED,0,sum-user-id,1395831.3,airdrop-20181115-hdac-sum-user-id-withdrawal,accac570-de75-11e8-bd11-2f9252c4dc2f,AIRDROP,0
airdrop-20181115-hdac-e8c987c2-9149-4329-bf61-7ce29ea67234-withdrawal-exchange,2018.11.15 10:12,UNKNOWN,,UNKNOWN-55c0f2b7-dc24-425b-9be8-6b86719f2865,2018.11.15 10:12,UNKNOWN,0,100,0,HDAC,WITHDRAWAL,,,,0,COMPLETED,0,sum-user-id,1395731.3,airdrop-20181115-hdac-sum-user-id-withdrawal,accac570-de75-11e8-bd11-2f9252c4dc2f,AIRDROP,0
airdrop-20181115-hdac-e8f5387e-fbb6-491c-9a7b-131303711ecf-withdrawal-exchange,2018.11.15 10:12,UNKNOWN,,UNKNOWN-55c0f2b7-dc24-425b-9be8-6b86719f2865,2018.11.15 10:12,UNKNOWN,0,100,0,HDAC,WITHDRAWAL,,,,0,COMPLETED,0,sum-user-id,1395631.3,airdrop-20181115-hdac-sum-user-id-withdrawal,accac570-de75-11e8-bd11-2f9252c4dc2f,AIRDROP,0
airdrop-20181115-hdac-e8f65679-eb1e-451e-91de-2c63d0ba0167-withdrawal-exchange,2018.11.15 10:12,UNKNOWN,,UNKNOWN-55c0f2b7-dc24-425b-9be8-6b86719f2865,2018.11.15 10:12,UNKNOWN,0,100,0,HDAC,WITHDRAWAL,,,,0,COMPLETED,0,sum-user-id,1395531.3,airdrop-20181115-hdac-sum-user-id-withdrawal,accac570-de75-11e8-bd11-2f9252c4dc2f,AIRDROP,0
airdrop-20181115-hdac-e8fd359a-6909-4a4b-86e9-158d61d828a4-withdrawal-exchange,2018.11.15 10:12,UNKNOWN,,UNKNOWN-55c0f2b7-dc24-425b-9be8-6b86719f2865,2018.11.15 10:12,UNKNOWN,0,100,0,HDAC,WITHDRAWAL,,,,0,COMPLETED,0,sum-user-id,1395431.3,airdrop-20181115-hdac-sum-user-id-withdrawal,accac570-de75-11e8-bd11-2f9252c4dc2f,AIRDROP,0
airdrop-20181115-hdac-e91e4e8e-45eb-4556-b7a4-af9ed149766e-withdrawal-exchange,2018.11.15 10:12,UNKNOWN,,UNKNOWN-55c0f2b7-dc24-425b-9be8-6b86719f2865,2018.11.15 10:12,UNKNOWN,0,100,0,HDAC,WITHDRAWAL,,,,0,COMPLETED,0,sum-user-id,1395331.3,airdrop-20181115-hdac-sum-user-id-withdrawal,accac570-de75-11e8-bd11-2f9252c4dc2f,AIRDROP,0
airdrop-20181115-hdac-e945f74b-9f3b-4682-9d6a-d617afda18ef-withdrawal-exchange,2018.11.15 10:12,UNKNOWN,,UNKNOWN-55c0f2b7-dc24-425b-9be8-6b86719f2865,2018.11.15 10:12,UNKNOWN,0,100,0,HDAC,WITHDRAWAL,,,,0,COMPLETED,0,sum-user-id,1395231.3,airdrop-20181115-hdac-sum-user-id-withdrawal,accac570-de75-11e8-bd11-2f9252c4dc2f,AIRDROP,0
airdrop-20181115-hdac-e963baee-f49f-4314-abc3-bedca467ef59-withdrawal-exchange,2018.11.15 10:12,UNKNOWN,,UNKNOWN-55c0f2b7-dc24-425b-9be8-6b86719f2865,2018.11.15 10:12,UNKNOWN,0,100,0,HDAC,WITHDRAWAL,,,,0,COMPLETED,0,sum-user-id,1395131.3,airdrop-20181115-hdac-sum-user-id-withdrawal,accac570-de75-11e8-bd11-2f9252c4dc2f,AIRDROP,0
airdrop-20181115-hdac-e966ea34-76f3-4ec0-bcd5-0c58caee1a2a-withdrawal-exchange,2018.11.15 10:12,UNKNOWN,,UNKNOWN-55c0f2b7-dc24-425b-9be8-6b86719f2865,2018.11.15 10:12,UNKNOWN,0,100,0,HDAC,WITHDRAWAL,,,,0,COMPLETED,0,sum-user-id,1395031.3,airdrop-20181115-hdac-sum-user-id-withdrawal,accac570-de75-11e8-bd11-2f9252c4dc2f,AIRDROP,0
airdrop-20181115-hdac-e9b8dbfe-f268-4e5e-bd89-c5fe70b90a8d-withdrawal-exchange,2018.11.15 10:12,UNKNOWN,,UNKNOWN-55c0f2b7-dc24-425b-9be8-6b86719f2865,2018.11.15 10:12,UNKNOWN,0,100,0,HDAC,WITHDRAWAL,,,,0,COMPLETED,0,sum-user-id,1394931.3,airdrop-20181115-hdac-sum-user-id-withdrawal,accac570-de75-11e8-bd11-2f9252c4dc2f,AIRDROP,0
airdrop-20181115-hdac-e9dc577a-af2a-4547-8f15-0dd9d873f01d-withdrawal-exchange,2018.11.15 10:12,UNKNOWN,,UNKNOWN-55c0f2b7-dc24-425b-9be8-6b86719f2865,2018.11.15 10:12,UNKNOWN,0,100,0,HDAC,WITHDRAWAL,,,,0,COMPLETED,0,sum-user-id,1394831.3,airdrop-20181115-hdac-sum-user-id-withdrawal,accac570-de75-11e8-bd11-2f9252c4dc2f,AIRDROP,0
airdrop-20181115-hdac-e9e6c152-2458-429d-986a-8b004ad6b513-withdrawal-exchange,2018.11.15 10:12,UNKNOWN,,UNKNOWN-55c0f2b7-dc24-425b-9be8-6b86719f2865,2018.11.15 10:12,UNKNOWN,0,100,0,HDAC,WITHDRAWAL,,,,0,COMPLETED,0,sum-user-id,1394731.3,airdrop-20181115-hdac-sum-user-id-withdrawal,accac570-de75-11e8-bd11-2f9252c4dc2f,AIRDROP,0
airdrop-20181115-hdac-e9f5a3db-3bed-443f-98cf-6b2d292e6604-withdrawal-exchange,2018.11.15 10:12,UNKNOWN,,UNKNOWN-55c0f2b7-dc24-425b-9be8-6b86719f2865,2018.11.15 10:12,UNKNOWN,0,100,0,HDAC,WITHDRAWAL,,,,0,COMPLETED,0,sum-user-id,1394631.3,airdrop-20181115-hdac-sum-user-id-withdrawal,accac570-de75-11e8-bd11-2f9252c4dc2f,AIRDROP,0
airdrop-20181115-hdac-ea006e90-62cc-4331-8a6a-67ffd9835a98-withdrawal-exchange,2018.11.15 10:12,UNKNOWN,,UNKNOWN-55c0f2b7-dc24-425b-9be8-6b86719f2865,2018.11.15 10:12,UNKNOWN,0,100,0,HDAC,WITHDRAWAL,,,,0,COMPLETED,0,sum-user-id,1394531.3,airdrop-20181115-hdac-sum-user-id-withdrawal,accac570-de75-11e8-bd11-2f9252c4dc2f,AIRDROP,0
airdrop-20181115-hdac-ea26fb4e-561e-4e8b-b258-0cec6b1440d9-withdrawal-exchange,2018.11.15 10:12,UNKNOWN,,UNKNOWN-55c0f2b7-dc24-425b-9be8-6b86719f2865,2018.11.15 10:12,UNKNOWN,0,100,0,HDAC,WITHDRAWAL,,,,0,COMPLETED,0,sum-user-id,1394431.3,airdrop-20181115-hdac-sum-user-id-withdrawal,accac570-de75-11e8-bd11-2f9252c4dc2f,AIRDROP,0
airdrop-20181115-hdac-ea73d496-acb9-4128-835f-7274292ba4e7-withdrawal-exchange,2018.11.15 10:12,UNKNOWN,,UNKNOWN-55c0f2b7-dc24-425b-9be8-6b86719f2865,2018.11.15 10:12,UNKNOWN,0,100,0,HDAC,WITHDRAWAL,,,,0,COMPLETED,0,sum-user-id,1394331.3,airdrop-20181115-hdac-sum-user-id-withdrawal,accac570-de75-11e8-bd11-2f9252c4dc2f,AIRDROP,0
airdrop-20181115-hdac-ea9f77f5-f4a6-4606-b6cb-a3f7bf39e9cd-withdrawal-exchange,2018.11.15 10:12,UNKNOWN,,UNKNOWN-55c0f2b7-dc24-425b-9be8-6b86719f2865,2018.11.15 10:12,UNKNOWN,0,100,0,HDAC,WITHDRAWAL,,,,0,COMPLETED,0,sum-user-id,1394231.3,airdrop-20181115-hdac-sum-user-id-withdrawal,accac570-de75-11e8-bd11-2f9252c4dc2f,AIRDROP,0
airdrop-20181115-hdac-eaa22954-4eb0-49b8-a913-04db673a278c-withdrawal-exchange,2018.11.15 10:12,UNKNOWN,,UNKNOWN-55c0f2b7-dc24-425b-9be8-6b86719f2865,2018.11.15 10:12,UNKNOWN,0,100,0,HDAC,WITHDRAWAL,,,,0,COMPLETED,0,sum-user-id,1394131.3,airdrop-20181115-hdac-sum-user-id-withdrawal,accac570-de75-11e8-bd11-2f9252c4dc2f,AIRDROP,0
airdrop-20181115-hdac-eaaff5d5-717a-4be1-8c64-0877406dd544-withdrawal-exchange,2018.11.15 10:12,UNKNOWN,,UNKNOWN-55c0f2b7-dc24-425b-9be8-6b86719f2865,2018.11.15 10:12,UNKNOWN,0,100,0,HDAC,WITHDRAWAL,,,,0,COMPLETED,0,sum-user-id,1394031.3,airdrop-20181115-hdac-sum-user-id-withdrawal,accac570-de75-11e8-bd11-2f9252c4dc2f,AIRDROP,0
airdrop-20181115-hdac-eab9ad6c-e913-42f0-9893-12b346251228-withdrawal-exchange,2018.11.15 10:12,UNKNOWN,,UNKNOWN-55c0f2b7-dc24-425b-9be8-6b86719f2865,2018.11.15 10:12,UNKNOWN,0,100,0,HDAC,WITHDRAWAL,,,,0,COMPLETED,0,sum-user-id,1393931.3,airdrop-20181115-hdac-sum-user-id-withdrawal,accac570-de75-11e8-bd11-2f9252c4dc2f,AIRDROP,0
airdrop-20181115-hdac-eadce53c-fa04-4c5a-ae57-3545eaca3099-withdrawal-exchange,2018.11.15 10:12,UNKNOWN,,UNKNOWN-55c0f2b7-dc24-425b-9be8-6b86719f2865,2018.11.15 10:12,UNKNOWN,0,100,0,HDAC,WITHDRAWAL,,,,0,COMPLETED,0,sum-user-id,1393831.3,airdrop-20181115-hdac-sum-user-id-withdrawal,accac570-de75-11e8-bd11-2f9252c4dc2f,AIRDROP,0
airdrop-20181115-hdac-eaf8e590-ca06-4162-90f7-0f08b178a24a-withdrawal-exchange,2018.11.15 10:12,UNKNOWN,,UNKNOWN-55c0f2b7-dc24-425b-9be8-6b86719f2865,2018.11.15 10:12,UNKNOWN,0,100,0,HDAC,WITHDRAWAL,,,,0,COMPLETED,0,sum-user-id,1393731.3,airdrop-20181115-hdac-sum-user-id-withdrawal,accac570-de75-11e8-bd11-2f9252c4dc2f,AIRDROP,0
airdrop-20181115-hdac-eb2b6436-f95b-4ee9-8c2f-bc8324d87fb0-withdrawal-exchange,2018.11.15 10:12,UNKNOWN,,UNKNOWN-55c0f2b7-dc24-425b-9be8-6b86719f2865,2018.11.15 10:12,UNKNOWN,0,100,0,HDAC,WITHDRAWAL,,,,0,COMPLETED,0,sum-user-id,1393631.3,airdrop-20181115-hdac-sum-user-id-withdrawal,accac570-de75-11e8-bd11-2f9252c4dc2f,AIRDROP,0
airdrop-20181115-hdac-eb35b8c0-9f31-434c-8542-5db2edeef50b-withdrawal-exchange,2018.11.15 10:12,UNKNOWN,,UNKNOWN-55c0f2b7-dc24-425b-9be8-6b86719f2865,2018.11.15 10:12,UNKNOWN,0,100,0,HDAC,WITHDRAWAL,,,,0,COMPLETED,0,sum-user-id,1393531.3,airdrop-20181115-hdac-sum-user-id-withdrawal,accac570-de75-11e8-bd11-2f9252c4dc2f,AIRDROP,0
airdrop-20181115-hdac-eb4a43b6-269f-4fcb-a0f2-bcce012f53ec-withdrawal-exchange,2018.11.15 10:12,UNKNOWN,,UNKNOWN-55c0f2b7-dc24-425b-9be8-6b86719f2865,2018.11.15 10:12,UNKNOWN,0,100,0,HDAC,WITHDRAWAL,,,,0,COMPLETED,0,sum-user-id,1393431.3,airdrop-20181115-hdac-sum-user-id-withdrawal,accac570-de75-11e8-bd11-2f9252c4dc2f,AIRDROP,0
airdrop-20181115-hdac-eb610209-610c-48bf-98a3-de53dd038268-withdrawal-exchange,2018.11.15 10:12,UNKNOWN,,UNKNOWN-55c0f2b7-dc24-425b-9be8-6b86719f2865,2018.11.15 10:12,UNKNOWN,0,100,0,HDAC,WITHDRAWAL,,,,0,COMPLETED,0,sum-user-id,1393331.3,airdrop-20181115-hdac-sum-user-id-withdrawal,accac570-de75-11e8-bd11-2f9252c4dc2f,AIRDROP,0
airdrop-20181115-hdac-eb7f8362-145b-4ca3-bde8-e8d7430e04b7-withdrawal-exchange,2018.11.15 10:12,UNKNOWN,,UNKNOWN-55c0f2b7-dc24-425b-9be8-6b86719f2865,2018.11.15 10:12,UNKNOWN,0,100,0,HDAC,WITHDRAWAL,,,,0,COMPLETED,0,sum-user-id,1393231.3,airdrop-20181115-hdac-sum-user-id-withdrawal,accac570-de75-11e8-bd11-2f9252c4dc2f,AIRDROP,0
airdrop-20181115-hdac-eba463f5-7cb9-40e7-8c29-2003a4670007-withdrawal-exchange,2018.11.15 10:12,UNKNOWN,,UNKNOWN-55c0f2b7-dc24-425b-9be8-6b86719f2865,2018.11.15 10:12,UNKNOWN,0,100,0,HDAC,WITHDRAWAL,,,,0,COMPLETED,0,sum-user-id,1393131.3,airdrop-20181115-hdac-sum-user-id-withdrawal,accac570-de75-11e8-bd11-2f9252c4dc2f,AIRDROP,0
airdrop-20181115-hdac-eba5faec-b767-4b8a-b748-35a7f9e701c8-withdrawal-exchange,2018.11.15 10:12,UNKNOWN,,UNKNOWN-55c0f2b7-dc24-425b-9be8-6b86719f2865,2018.11.15 10:12,UNKNOWN,0,100,0,HDAC,WITHDRAWAL,,,,0,COMPLETED,0,sum-user-id,1393031.3,airdrop-20181115-hdac-sum-user-id-withdrawal,accac570-de75-11e8-bd11-2f9252c4dc2f,AIRDROP,0
airdrop-20181115-hdac-ebaae58d-003f-4069-952a-7118c6b03bfb-withdrawal-exchange,2018-11-15 10:12:21.008,UNKNOWN,,UNKNOWN-55c0f2b7-dc24-425b-9be8-6b86719f2865,2018-11-15 10:12:21.008,UNKNOWN,0,100,0,HDAC,WITHDRAWAL,,,,0,COMPLETED,0,sum-user-id,1392931.3,airdrop-20181115-hdac-sum-user-id-withdrawal,accac570-de75-11e8-bd11-2f9252c4dc2f,AIRDROP,0
airdrop-20181115-hdac-ebc22512-239d-4bba-a0a1-5123cfbf91e8-withdrawal-exchange,2018-11-15 10:12:21.038,UNKNOWN,,UNKNOWN-55c0f2b7-dc24-425b-9be8-6b86719f2865,2018-11-15 10:12:21.038,UNKNOWN,0,100,0,HDAC,WITHDRAWAL,,,,0,COMPLETED,0,sum-user-id,1392831.3,airdrop-20181115-hdac-sum-user-id-withdrawal,accac570-de75-11e8-bd11-2f9252c4dc2f,AIRDROP,0
airdrop-20181115-hdac-ebe837ba-4286-4782-9d64-42e8a7074e20-withdrawal-exchange,2018-11-15 10:12:21.068,UNKNOWN,,UNKNOWN-55c0f2b7-dc24-425b-9be8-6b86719f2865,2018-11-15 10:12:21.068,UNKNOWN,0,100,0,HDAC,WITHDRAWAL,,,,0,COMPLETED,0,sum-user-id,1392731.3,airdrop-20181115-hdac-sum-user-id-withdrawal,accac570-de75-11e8-bd11-2f9252c4dc2f,AIRDROP,0
airdrop-20181115-hdac-ec06feb7-ee4a-4971-a86a-e006ea010d03-withdrawal-exchange,2018.11.15 10:12,UNKNOWN,,UNKNOWN-55c0f2b7-dc24-425b-9be8-6b86719f2865,2018.11.15 10:12,UNKNOWN,0,100,0,HDAC,WITHDRAWAL,,,,0,COMPLETED,0,sum-user-id,1392631.3,airdrop-20181115-hdac-sum-user-id-withdrawal,accac570-de75-11e8-bd11-2f9252c4dc2f,AIRDROP,0
airdrop-20181115-hdac-ec190863-a0c7-49ef-816a-f560fc6c35af-withdrawal-exchange,2018.11.15 10:12,UNKNOWN,,UNKNOWN-55c0f2b7-dc24-425b-9be8-6b86719f2865,2018.11.15 10:12,UNKNOWN,0,100,0,HDAC,WITHDRAWAL,,,,0,COMPLETED,0,sum-user-id,1392531.3,airdrop-20181115-hdac-sum-user-id-withdrawal,accac570-de75-11e8-bd11-2f9252c4dc2f,AIRDROP,0
airdrop-20181115-hdac-ec19eccc-e6b5-46dd-a0b0-28f1c0a5ff3b-withdrawal-exchange,2018.11.15 10:12,UNKNOWN,,UNKNOWN-55c0f2b7-dc24-425b-9be8-6b86719f2865,2018.11.15 10:12,UNKNOWN,0,100,0,HDAC,WITHDRAWAL,,,,0,COMPLETED,0,sum-user-id,1392431.3,airdrop-20181115-hdac-sum-user-id-withdrawal,accac570-de75-11e8-bd11-2f9252c4dc2f,AIRDROP,0
airdrop-20181115-hdac-ec2d484d-3375-4bea-be40-8f9d87ae4ee0-withdrawal-exchange,2018.11.15 10:12,UNKNOWN,,UNKNOWN-55c0f2b7-dc24-425b-9be8-6b86719f2865,2018.11.15 10:12,UNKNOWN,0,100,0,HDAC,WITHDRAWAL,,,,0,COMPLETED,0,sum-user-id,1392331.3,airdrop-20181115-hdac-sum-user-id-withdrawal,accac570-de75-11e8-bd11-2f9252c4dc2f,AIRDROP,0
airdrop-20181115-hdac-ec387074-76aa-4cdf-b883-80fcd460472d-withdrawal-exchange,2018.11.15 10:12,UNKNOWN,,UNKNOWN-55c0f2b7-dc24-425b-9be8-6b86719f2865,2018.11.15 10:12,UNKNOWN,0,100,0,HDAC,WITHDRAWAL,,,,0,COMPLETED,0,sum-user-id,1392231.3,airdrop-20181115-hdac-sum-user-id-withdrawal,accac570-de75-11e8-bd11-2f9252c4dc2f,AIRDROP,0
airdrop-20181115-hdac-ec82f2c8-aedb-41f8-b766-8bdaeb15129b-withdrawal-exchange,2018.11.15 10:12,UNKNOWN,,UNKNOWN-55c0f2b7-dc24-425b-9be8-6b86719f2865,2018.11.15 10:12,UNKNOWN,0,100,0,HDAC,WITHDRAWAL,,,,0,COMPLETED,0,sum-user-id,1392131.3,airdrop-20181115-hdac-sum-user-id-withdrawal,accac570-de75-11e8-bd11-2f9252c4dc2f,AIRDROP,0
airdrop-20181115-hdac-ec843f33-af17-43c4-a66b-4398a014945f-withdrawal-exchange,2018.11.15 10:12,UNKNOWN,,UNKNOWN-55c0f2b7-dc24-425b-9be8-6b86719f2865,2018.11.15 10:12,UNKNOWN,0,100,0,HDAC,WITHDRAWAL,,,,0,COMPLETED,0,sum-user-id,1392031.3,airdrop-20181115-hdac-sum-user-id-withdrawal,accac570-de75-11e8-bd11-2f9252c4dc2f,AIRDROP,0
airdrop-20181115-hdac-ec86e614-3271-43f1-9aca-5c4a33288619-withdrawal-exchange,2018.11.15 10:12,UNKNOWN,,UNKNOWN-55c0f2b7-dc24-425b-9be8-6b86719f2865,2018.11.15 10:12,UNKNOWN,0,100,0,HDAC,WITHDRAWAL,,,,0,COMPLETED,0,sum-user-id,1391931.3,airdrop-20181115-hdac-sum-user-id-withdrawal,accac570-de75-11e8-bd11-2f9252c4dc2f,AIRDROP,0
airdrop-20181115-hdac-ec8b3a04-f247-44a8-b668-0592fec8d2a2-withdrawal-exchange,2018.11.15 10:12,UNKNOWN,,UNKNOWN-55c0f2b7-dc24-425b-9be8-6b86719f2865,2018.11.15 10:12,UNKNOWN,0,100,0,HDAC,WITHDRAWAL,,,,0,COMPLETED,0,sum-user-id,1391831.3,airdrop-20181115-hdac-sum-user-id-withdrawal,accac570-de75-11e8-bd11-2f9252c4dc2f,AIRDROP,0
airdrop-20181115-hdac-ec9e7a7b-28d2-4d76-97c0-2f28571da469-withdrawal-exchange,2018.11.15 10:12,UNKNOWN,,UNKNOWN-55c0f2b7-dc24-425b-9be8-6b86719f2865,2018.11.15 10:12,UNKNOWN,0,100,0,HDAC,WITHDRAWAL,,,,0,COMPLETED,0,sum-user-id,1391731.3,airdrop-20181115-hdac-sum-user-id-withdrawal,accac570-de75-11e8-bd11-2f9252c4dc2f,AIRDROP,0
airdrop-20181115-hdac-ecae444c-9d33-4413-bbcb-2f450d2bf36a-withdrawal-exchange,2018.11.15 10:12,UNKNOWN,,UNKNOWN-55c0f2b7-dc24-425b-9be8-6b86719f2865,2018.11.15 10:12,UNKNOWN,0,100,0,HDAC,WITHDRAWAL,,,,0,COMPLETED,0,sum-user-id,1391631.3,airdrop-20181115-hdac-sum-user-id-withdrawal,accac570-de75-11e8-bd11-2f9252c4dc2f,AIRDROP,0
airdrop-20181115-hdac-ecb484be-9f76-49f1-9d00-b00002f5e49f-withdrawal-exchange,2018.11.15 10:12,UNKNOWN,,UNKNOWN-55c0f2b7-dc24-425b-9be8-6b86719f2865,2018.11.15 10:12,UNKNOWN,0,100,0,HDAC,WITHDRAWAL,,,,0,COMPLETED,0,sum-user-id,1391531.3,airdrop-20181115-hdac-sum-user-id-withdrawal,accac570-de75-11e8-bd11-2f9252c4dc2f,AIRDROP,0
airdrop-20181115-hdac-ecbdb8c1-eaa4-41e2-b6e5-16b37c0d19f7-withdrawal-exchange,2018.11.15 10:12,UNKNOWN,,UNKNOWN-55c0f2b7-dc24-425b-9be8-6b86719f2865,2018.11.15 10:12,UNKNOWN,0,100,0,HDAC,WITHDRAWAL,,,,0,COMPLETED,0,sum-user-id,1391431.3,airdrop-20181115-hdac-sum-user-id-withdrawal,accac570-de75-11e8-bd11-2f9252c4dc2f,AIRDROP,0
airdrop-20181115-hdac-ecd709b5-1e5d-4f8a-8f14-fa5711bf717d-withdrawal-exchange,2018.11.15 10:12,UNKNOWN,,UNKNOWN-55c0f2b7-dc24-425b-9be8-6b86719f2865,2018.11.15 10:12,UNKNOWN,0,100,0,HDAC,WITHDRAWAL,,,,0,COMPLETED,0,sum-user-id,1391331.3,airdrop-20181115-hdac-sum-user-id-withdrawal,accac570-de75-11e8-bd11-2f9252c4dc2f,AIRDROP,0
airdrop-20181115-hdac-ecf276e6-810f-44a1-acdb-444a77242f4a-withdrawal-exchange,2018.11.15 10:12,UNKNOWN,,UNKNOWN-55c0f2b7-dc24-425b-9be8-6b86719f2865,2018.11.15 10:12,UNKNOWN,0,100,0,HDAC,WITHDRAWAL,,,,0,COMPLETED,0,sum-user-id,1391231.3,airdrop-20181115-hdac-sum-user-id-withdrawal,accac570-de75-11e8-bd11-2f9252c4dc2f,AIRDROP,0
airdrop-20181115-hdac-ecf43342-764a-4f56-8b17-aebf72ae8095-withdrawal-exchange,2018.11.15 10:12,UNKNOWN,,UNKNOWN-55c0f2b7-dc24-425b-9be8-6b86719f2865,2018.11.15 10:12,UNKNOWN,0,100,0,HDAC,WITHDRAWAL,,,,0,COMPLETED,0,sum-user-id,1391131.3,airdrop-20181115-hdac-sum-user-id-withdrawal,accac570-de75-11e8-bd11-2f9252c4dc2f,AIRDROP,0
airdrop-20181115-hdac-ecf80e5e-2a29-47a6-aa98-3d9efd97713f-withdrawal-exchange,2018.11.15 10:12,UNKNOWN,,UNKNOWN-55c0f2b7-dc24-425b-9be8-6b86719f2865,2018.11.15 10:12,UNKNOWN,0,100,0,HDAC,WITHDRAWAL,,,,0,COMPLETED,0,sum-user-id,1391031.3,airdrop-20181115-hdac-sum-user-id-withdrawal,accac570-de75-11e8-bd11-2f9252c4dc2f,AIRDROP,0
airdrop-20181115-hdac-ecfbb7ae-5280-4e2a-abea-0b38f37028dd-withdrawal-exchange,2018.11.15 10:12,UNKNOWN,,UNKNOWN-55c0f2b7-dc24-425b-9be8-6b86719f2865,2018.11.15 10:12,UNKNOWN,0,100,0,HDAC,WITHDRAWAL,,,,0,COMPLETED,0,sum-user-id,1390931.3,airdrop-20181115-hdac-sum-user-id-withdrawal,accac570-de75-11e8-bd11-2f9252c4dc2f,AIRDROP,0
airdrop-20181115-hdac-ed17cb2e-d338-4c8f-8219-a5ed7b11984f-withdrawal-exchange,2018.11.15 10:12,UNKNOWN,,UNKNOWN-55c0f2b7-dc24-425b-9be8-6b86719f2865,2018.11.15 10:12,UNKNOWN,0,100,0,HDAC,WITHDRAWAL,,,,0,COMPLETED,0,sum-user-id,1390831.3,airdrop-20181115-hdac-sum-user-id-withdrawal,accac570-de75-11e8-bd11-2f9252c4dc2f,AIRDROP,0
airdrop-20181115-hdac-ed18f24d-79aa-4cbe-9e6a-99388664c959-withdrawal-exchange,2018.11.15 10:12,UNKNOWN,,UNKNOWN-55c0f2b7-dc24-425b-9be8-6b86719f2865,2018.11.15 10:12,UNKNOWN,0,100,0,HDAC,WITHDRAWAL,,,,0,COMPLETED,0,sum-user-id,1390731.3,airdrop-20181115-hdac-sum-user-id-withdrawal,accac570-de75-11e8-bd11-2f9252c4dc2f,AIRDROP,0
airdrop-20181115-hdac-ed196def-02d9-41aa-b625-d2ab98cbd6a5-withdrawal-exchange,2018.11.15 10:12,UNKNOWN,,UNKNOWN-55c0f2b7-dc24-425b-9be8-6b86719f2865,2018.11.15 10:12,UNKNOWN,0,100,0,HDAC,WITHDRAWAL,,,,0,COMPLETED,0,sum-user-id,1390631.3,airdrop-20181115-hdac-sum-user-id-withdrawal,accac570-de75-11e8-bd11-2f9252c4dc2f,AIRDROP,0
airdrop-20181115-hdac-ed6b2cd4-ae2c-4ac3-b608-992c05d7020f-withdrawal-exchange,2018-11-15 10:12:29.029,UNKNOWN,,UNKNOWN-55c0f2b7-dc24-425b-9be8-6b86719f2865,2018-11-15 10:12:29.029,UNKNOWN,0,274.09128,0,HDAC,WITHDRAWAL,,,,0,COMPLETED,0,sum-user-id,1103249.895,airdrop-20181115-hdac-sum-user-id-withdrawal,accac570-de75-11e8-bd11-2f9252c4dc2f,AIRDROP,0
airdrop-20181115-hdac-ed6f7018-5152-4181-9a2b-b521b6228933-withdrawal-exchange,2018.11.15 10:12,UNKNOWN,,UNKNOWN-55c0f2b7-dc24-425b-9be8-6b86719f2865,2018.11.15 10:12,UNKNOWN,0,100,0,HDAC,WITHDRAWAL,,,,0,COMPLETED,0,sum-user-id,1390531.3,airdrop-20181115-hdac-sum-user-id-withdrawal,accac570-de75-11e8-bd11-2f9252c4dc2f,AIRDROP,0
airdrop-20181115-hdac-ed8373a0-b128-42a0-904c-b4f1555a5972-withdrawal-exchange,2018.11.15 10:12,UNKNOWN,,UNKNOWN-55c0f2b7-dc24-425b-9be8-6b86719f2865,2018.11.15 10:12,UNKNOWN,0,100,0,HDAC,WITHDRAWAL,,,,0,COMPLETED,0,sum-user-id,1390431.3,airdrop-20181115-hdac-sum-user-id-withdrawal,accac570-de75-11e8-bd11-2f9252c4dc2f,AIRDROP,0
airdrop-20181115-hdac-ed9b66be-e1cf-4317-b49f-d0e4e669375b-withdrawal-exchange,2018.11.15 10:12,UNKNOWN,,UNKNOWN-55c0f2b7-dc24-425b-9be8-6b86719f2865,2018.11.15 10:12,UNKNOWN,0,100,0,HDAC,WITHDRAWAL,,,,0,COMPLETED,0,sum-user-id,1390331.3,airdrop-20181115-hdac-sum-user-id-withdrawal,accac570-de75-11e8-bd11-2f9252c4dc2f,AIRDROP,0
airdrop-20181115-hdac-edafa411-614a-4eca-9d05-f5715e22ecdb-withdrawal-exchange,2018.11.15 10:12,UNKNOWN,,UNKNOWN-55c0f2b7-dc24-425b-9be8-6b86719f2865,2018.11.15 10:12,UNKNOWN,0,100,0,HDAC,WITHDRAWAL,,,,0,COMPLETED,0,sum-user-id,1390231.3,airdrop-20181115-hdac-sum-user-id-withdrawal,accac570-de75-11e8-bd11-2f9252c4dc2f,AIRDROP,0
airdrop-20181115-hdac-edcda4e7-f426-4b87-81b9-9fde8c65ded7-withdrawal-exchange,2018.11.15 10:12,UNKNOWN,,UNKNOWN-55c0f2b7-dc24-425b-9be8-6b86719f2865,2018.11.15 10:12,UNKNOWN,0,100,0,HDAC,WITHDRAWAL,,,,0,COMPLETED,0,sum-user-id,1390131.3,airdrop-20181115-hdac-sum-user-id-withdrawal,accac570-de75-11e8-bd11-2f9252c4dc2f,AIRDROP,0
airdrop-20181115-hdac-ee0c3703-0fd8-4d90-8ee2-1e26102c94ce-withdrawal-exchange,2018.11.15 10:12,UNKNOWN,,UNKNOWN-55c0f2b7-dc24-425b-9be8-6b86719f2865,2018.11.15 10:12,UNKNOWN,0,100,0,HDAC,WITHDRAWAL,,,,0,COMPLETED,0,sum-user-id,1390031.3,airdrop-20181115-hdac-sum-user-id-withdrawal,accac570-de75-11e8-bd11-2f9252c4dc2f,AIRDROP,0
airdrop-20181115-hdac-ee1b830b-2ddb-412b-b015-e97fc1563a36-withdrawal-exchange,2018.11.15 10:12,UNKNOWN,,UNKNOWN-55c0f2b7-dc24-425b-9be8-6b86719f2865,2018.11.15 10:12,UNKNOWN,0,100,0,HDAC,WITHDRAWAL,,,,0,COMPLETED,0,sum-user-id,1389931.3,airdrop-20181115-hdac-sum-user-id-withdrawal,accac570-de75-11e8-bd11-2f9252c4dc2f,AIRDROP,0
airdrop-20181115-hdac-ee2539f5-56a7-48bd-a0df-e776edf322e9-withdrawal-exchange,2018.11.15 10:12,UNKNOWN,,UNKNOWN-55c0f2b7-dc24-425b-9be8-6b86719f2865,2018.11.15 10:12,UNKNOWN,0,100,0,HDAC,WITHDRAWAL,,,,0,COMPLETED,0,sum-user-id,1389831.3,airdrop-20181115-hdac-sum-user-id-withdrawal,accac570-de75-11e8-bd11-2f9252c4dc2f,AIRDROP,0
airdrop-20181115-hdac-ee344e37-2928-4b98-8c46-48184386e907-withdrawal-exchange,2018-11-15 10:12:22.021,UNKNOWN,,UNKNOWN-55c0f2b7-dc24-425b-9be8-6b86719f2865,2018-11-15 10:12:22.021,UNKNOWN,0,100,0,HDAC,WITHDRAWAL,,,,0,COMPLETED,0,sum-user-id,1389731.3,airdrop-20181115-hdac-sum-user-id-withdrawal,accac570-de75-11e8-bd11-2f9252c4dc2f,AIRDROP,0
airdrop-20181115-hdac-ee4aab8f-b44a-47f2-81fa-23aaab613584-withdrawal-exchange,2018-11-15 10:12:22.049,UNKNOWN,,UNKNOWN-55c0f2b7-dc24-425b-9be8-6b86719f2865,2018-11-15 10:12:22.049,UNKNOWN,0,100,0,HDAC,WITHDRAWAL,,,,0,COMPLETED,0,sum-user-id,1389631.3,airdrop-20181115-hdac-sum-user-id-withdrawal,accac570-de75-11e8-bd11-2f9252c4dc2f,AIRDROP,0
airdrop-20181115-hdac-ee7051be-9ff2-44e4-a4a6-608d24284f81-withdrawal-exchange,2018-11-15 10:12:22.080,UNKNOWN,,UNKNOWN-55c0f2b7-dc24-425b-9be8-6b86719f2865,2018-11-15 10:12:22.080,UNKNOWN,0,100,0,HDAC,WITHDRAWAL,,,,0,COMPLETED,0,sum-user-id,1389531.3,airdrop-20181115-hdac-sum-user-id-withdrawal,accac570-de75-11e8-bd11-2f9252c4dc2f,AIRDROP,0
airdrop-20181115-hdac-ee749278-17d8-4d17-95e8-02caab5ac40d-withdrawal-exchange,2018.11.15 10:12,UNKNOWN,,UNKNOWN-55c0f2b7-dc24-425b-9be8-6b86719f2865,2018.11.15 10:12,UNKNOWN,0,100,0,HDAC,WITHDRAWAL,,,,0,COMPLETED,0,sum-user-id,1389431.3,airdrop-20181115-hdac-sum-user-id-withdrawal,accac570-de75-11e8-bd11-2f9252c4dc2f,AIRDROP,0
airdrop-20181115-hdac-ee84c180-fe33-48ce-9c40-a6847791d19b-withdrawal-exchange,2018.11.15 10:12,UNKNOWN,,UNKNOWN-55c0f2b7-dc24-425b-9be8-6b86719f2865,2018.11.15 10:12,UNKNOWN,0,100,0,HDAC,WITHDRAWAL,,,,0,COMPLETED,0,sum-user-id,1389331.3,airdrop-20181115-hdac-sum-user-id-withdrawal,accac570-de75-11e8-bd11-2f9252c4dc2f,AIRDROP,0
airdrop-20181115-hdac-eea9fde4-7021-4d8c-b773-8fe95898a15c-withdrawal-exchange,2018.11.15 10:12,UNKNOWN,,UNKNOWN-55c0f2b7-dc24-425b-9be8-6b86719f2865,2018.11.15 10:12,UNKNOWN,0,100,0,HDAC,WITHDRAWAL,,,,0,COMPLETED,0,sum-user-id,1389231.3,airdrop-20181115-hdac-sum-user-id-withdrawal,accac570-de75-11e8-bd11-2f9252c4dc2f,AIRDROP,0
airdrop-20181115-hdac-eeb16885-949b-4240-8748-366851402cef-withdrawal-exchange,2018.11.15 10:12,UNKNOWN,,UNKNOWN-55c0f2b7-dc24-425b-9be8-6b86719f2865,2018.11.15 10:12,UNKNOWN,0,100,0,HDAC,WITHDRAWAL,,,,0,COMPLETED,0,sum-user-id,1389131.3,airdrop-20181115-hdac-sum-user-id-withdrawal,accac570-de75-11e8-bd11-2f9252c4dc2f,AIRDROP,0
airdrop-20181115-hdac-eebb6572-663d-4da0-acda-66fbdbafae9b-withdrawal-exchange,2018.11.15 10:12,UNKNOWN,,UNKNOWN-55c0f2b7-dc24-425b-9be8-6b86719f2865,2018.11.15 10:12,UNKNOWN,0,100,0,HDAC,WITHDRAWAL,,,,0,COMPLETED,0,sum-user-id,1389031.3,airdrop-20181115-hdac-sum-user-id-withdrawal,accac570-de75-11e8-bd11-2f9252c4dc2f,AIRDROP,0
airdrop-20181115-hdac-eec3d052-5ce7-4938-b178-940045462a20-withdrawal-exchange,2018.11.15 10:12,UNKNOWN,,UNKNOWN-55c0f2b7-dc24-425b-9be8-6b86719f2865,2018.11.15 10:12,UNKNOWN,0,100,0,HDAC,WITHDRAWAL,,,,0,COMPLETED,0,sum-user-id,1388931.3,airdrop-20181115-hdac-sum-user-id-withdrawal,accac570-de75-11e8-bd11-2f9252c4dc2f,AIRDROP,0
airdrop-20181115-hdac-eec5a639-e69d-4ae1-92e1-cd579d03e7c3-withdrawal-exchange,2018.11.15 10:12,UNKNOWN,,UNKNOWN-55c0f2b7-dc24-425b-9be8-6b86719f2865,2018.11.15 10:12,UNKNOWN,0,100,0,HDAC,WITHDRAWAL,,,,0,COMPLETED,0,sum-user-id,1388831.3,airdrop-20181115-hdac-sum-user-id-withdrawal,accac570-de75-11e8-bd11-2f9252c4dc2f,AIRDROP,0
airdrop-20181115-hdac-eecd1204-5583-4158-87a1-20ef48e0794c-withdrawal-exchange,2018.11.15 10:12,UNKNOWN,,UNKNOWN-55c0f2b7-dc24-425b-9be8-6b86719f2865,2018.11.15 10:12,UNKNOWN,0,100,0,HDAC,WITHDRAWAL,,,,0,COMPLETED,0,sum-user-id,1388731.3,airdrop-20181115-hdac-sum-user-id-withdrawal,accac570-de75-11e8-bd11-2f9252c4dc2f,AIRDROP,0
airdrop-20181115-hdac-eeea143b-5fac-4284-bcbb-5aee6ec89256-withdrawal-exchange,2018.11.15 10:12,UNKNOWN,,UNKNOWN-55c0f2b7-dc24-425b-9be8-6b86719f2865,2018.11.15 10:12,UNKNOWN,0,100,0,HDAC,WITHDRAWAL,,,,0,COMPLETED,0,sum-user-id,1388631.3,airdrop-20181115-hdac-sum-user-id-withdrawal,accac570-de75-11e8-bd11-2f9252c4dc2f,AIRDROP,0
airdrop-20181115-hdac-ef07db9c-c1e7-4a59-88dd-d5c89be60406-withdrawal-exchange,2018.11.15 10:12,UNKNOWN,,UNKNOWN-55c0f2b7-dc24-425b-9be8-6b86719f2865,2018.11.15 10:12,UNKNOWN,0,100,0,HDAC,WITHDRAWAL,,,,0,COMPLETED,0,sum-user-id,1388531.3,airdrop-20181115-hdac-sum-user-id-withdrawal,accac570-de75-11e8-bd11-2f9252c4dc2f,AIRDROP,0
airdrop-20181115-hdac-ef3076b6-6279-4676-9813-0d88f33bc0b6-withdrawal-exchange,2018.11.15 10:12,UNKNOWN,,UNKNOWN-55c0f2b7-dc24-425b-9be8-6b86719f2865,2018.11.15 10:12,UNKNOWN,0,100,0,HDAC,WITHDRAWAL,,,,0,COMPLETED,0,sum-user-id,1388431.3,airdrop-20181115-hdac-sum-user-id-withdrawal,accac570-de75-11e8-bd11-2f9252c4dc2f,AIRDROP,0
airdrop-20181115-hdac-ef5ed78f-dd5a-4217-a652-5b72c1be85f7-withdrawal-exchange,2018.11.15 10:12,UNKNOWN,,UNKNOWN-55c0f2b7-dc24-425b-9be8-6b86719f2865,2018.11.15 10:12,UNKNOWN,0,100,0,HDAC,WITHDRAWAL,,,,0,COMPLETED,0,sum-user-id,1388331.3,airdrop-20181115-hdac-sum-user-id-withdrawal,accac570-de75-11e8-bd11-2f9252c4dc2f,AIRDROP,0
airdrop-20181115-hdac-ef6cf6a9-f611-4135-9fb8-4acc2576a3e4-withdrawal-exchange,2018.11.15 10:12,UNKNOWN,,UNKNOWN-55c0f2b7-dc24-425b-9be8-6b86719f2865,2018.11.15 10:12,UNKNOWN,0,100,0,HDAC,WITHDRAWAL,,,,0,COMPLETED,0,sum-user-id,1388231.3,airdrop-20181115-hdac-sum-user-id-withdrawal,accac570-de75-11e8-bd11-2f9252c4dc2f,AIRDROP,0
airdrop-20181115-hdac-efb46577-94e7-459b-8365-98c6aed80f1c-withdrawal-exchange,2018.11.15 10:12,UNKNOWN,,UNKNOWN-55c0f2b7-dc24-425b-9be8-6b86719f2865,2018.11.15 10:12,UNKNOWN,0,100,0,HDAC,WITHDRAWAL,,,,0,COMPLETED,0,sum-user-id,1388131.3,airdrop-20181115-hdac-sum-user-id-withdrawal,accac570-de75-11e8-bd11-2f9252c4dc2f,AIRDROP,0
airdrop-20181115-hdac-f01ca60a-a09e-4474-bf3b-31924b7ac23a-withdrawal-exchange,2018.11.15 10:12,UNKNOWN,,UNKNOWN-55c0f2b7-dc24-425b-9be8-6b86719f2865,2018.11.15 10:12,UNKNOWN,0,100,0,HDAC,WITHDRAWAL,,,,0,COMPLETED,0,sum-user-id,1388031.3,airdrop-20181115-hdac-sum-user-id-withdrawal,accac570-de75-11e8-bd11-2f9252c4dc2f,AIRDROP,0
airdrop-20181115-hdac-f02d6492-f82b-4b63-87d7-d1c96eb596c5-withdrawal-exchange,2018.11.15 10:12,UNKNOWN,,UNKNOWN-55c0f2b7-dc24-425b-9be8-6b86719f2865,2018.11.15 10:12,UNKNOWN,0,100,0,HDAC,WITHDRAWAL,,,,0,COMPLETED,0,sum-user-id,1387931.3,airdrop-20181115-hdac-sum-user-id-withdrawal,accac570-de75-11e8-bd11-2f9252c4dc2f,AIRDROP,0
airdrop-20181115-hdac-f041ad68-8b97-49ca-9bcf-e6f7fedd9e0b-withdrawal-exchange,2018.11.15 10:12,UNKNOWN,,UNKNOWN-55c0f2b7-dc24-425b-9be8-6b86719f2865,2018.11.15 10:12,UNKNOWN,0,100,0,HDAC,WITHDRAWAL,,,,0,COMPLETED,0,sum-user-id,1387831.3,airdrop-20181115-hdac-sum-user-id-withdrawal,accac570-de75-11e8-bd11-2f9252c4dc2f,AIRDROP,0
airdrop-20181115-hdac-f0466734-0e19-43ea-b6af-263dc6901b48-withdrawal-exchange,2018.11.15 10:12,UNKNOWN,,UNKNOWN-55c0f2b7-dc24-425b-9be8-6b86719f2865,2018.11.15 10:12,UNKNOWN,0,100,0,HDAC,WITHDRAWAL,,,,0,COMPLETED,0,sum-user-id,1387731.3,airdrop-20181115-hdac-sum-user-id-withdrawal,accac570-de75-11e8-bd11-2f9252c4dc2f,AIRDROP,0
airdrop-20181115-hdac-f0889814-f67b-4429-9806-ae94d81d85a0-withdrawal-exchange,2018.11.15 10:12,UNKNOWN,,UNKNOWN-55c0f2b7-dc24-425b-9be8-6b86719f2865,2018.11.15 10:12,UNKNOWN,0,100,0,HDAC,WITHDRAWAL,,,,0,COMPLETED,0,sum-user-id,1387631.3,airdrop-20181115-hdac-sum-user-id-withdrawal,accac570-de75-11e8-bd11-2f9252c4dc2f,AIRDROP,0
airdrop-20181115-hdac-f0a01519-2284-4bfb-810c-7799f044c207-withdrawal-exchange,2018.11.15 10:12,UNKNOWN,,UNKNOWN-55c0f2b7-dc24-425b-9be8-6b86719f2865,2018.11.15 10:12,UNKNOWN,0,100,0,HDAC,WITHDRAWAL,,,,0,COMPLETED,0,sum-user-id,1387531.3,airdrop-20181115-hdac-sum-user-id-withdrawal,accac570-de75-11e8-bd11-2f9252c4dc2f,AIRDROP,0
airdrop-20181115-hdac-f0adb886-ddb5-402d-95eb-32dd76acf93f-withdrawal-exchange,2018.11.15 10:12,UNKNOWN,,UNKNOWN-55c0f2b7-dc24-425b-9be8-6b86719f2865,2018.11.15 10:12,UNKNOWN,0,100,0,HDAC,WITHDRAWAL,,,,0,COMPLETED,0,sum-user-id,1387431.3,airdrop-20181115-hdac-sum-user-id-withdrawal,accac570-de75-11e8-bd11-2f9252c4dc2f,AIRDROP,0
airdrop-20181115-hdac-f0af4af8-2c01-40fd-9851-5cea38c2f64b-withdrawal-exchange,2018.11.15 10:12,UNKNOWN,,UNKNOWN-55c0f2b7-dc24-425b-9be8-6b86719f2865,2018.11.15 10:12,UNKNOWN,0,100,0,HDAC,WITHDRAWAL,,,,0,COMPLETED,0,sum-user-id,1387331.3,airdrop-20181115-hdac-sum-user-id-withdrawal,accac570-de75-11e8-bd11-2f9252c4dc2f,AIRDROP,0
airdrop-20181115-hdac-f0b0deea-cc3d-489d-ac5d-2da99e4fcbd1-withdrawal-exchange,2018.11.15 10:12,UNKNOWN,,UNKNOWN-55c0f2b7-dc24-425b-9be8-6b86719f2865,2018.11.15 10:12,UNKNOWN,0,100,0,HDAC,WITHDRAWAL,,,,0,COMPLETED,0,sum-user-id,1387231.3,airdrop-20181115-hdac-sum-user-id-withdrawal,accac570-de75-11e8-bd11-2f9252c4dc2f,AIRDROP,0
airdrop-20181115-hdac-f0bb495b-2fc4-40a7-bcfb-0067427b5f71-withdrawal-exchange,2018.11.15 10:12,UNKNOWN,,UNKNOWN-55c0f2b7-dc24-425b-9be8-6b86719f2865,2018.11.15 10:12,UNKNOWN,0,100,0,HDAC,WITHDRAWAL,,,,0,COMPLETED,0,sum-user-id,1387131.3,airdrop-20181115-hdac-sum-user-id-withdrawal,accac570-de75-11e8-bd11-2f9252c4dc2f,AIRDROP,0
airdrop-20181115-hdac-f0d81d38-6a70-4e83-af08-d2d1b74384a3-withdrawal-exchange,2018.11.15 10:12,UNKNOWN,,UNKNOWN-55c0f2b7-dc24-425b-9be8-6b86719f2865,2018.11.15 10:12,UNKNOWN,0,100,0,HDAC,WITHDRAWAL,,,,0,COMPLETED,0,sum-user-id,1387031.3,airdrop-20181115-hdac-sum-user-id-withdrawal,accac570-de75-11e8-bd11-2f9252c4dc2f,AIRDROP,0
airdrop-20181115-hdac-f0d81f93-4a3c-4711-b4aa-1f460ffe66f1-withdrawal-exchange,2018.11.15 10:12,UNKNOWN,,UNKNOWN-55c0f2b7-dc24-425b-9be8-6b86719f2865,2018.11.15 10:12,UNKNOWN,0,100,0,HDAC,WITHDRAWAL,,,,0,COMPLETED,0,sum-user-id,1386931.3,airdrop-20181115-hdac-sum-user-id-withdrawal,accac570-de75-11e8-bd11-2f9252c4dc2f,AIRDROP,0
airdrop-20181115-hdac-f0dc3011-690a-4f6d-ac74-e11e43d5ba5f-withdrawal-exchange,2018.11.15 10:12,UNKNOWN,,UNKNOWN-55c0f2b7-dc24-425b-9be8-6b86719f2865,2018.11.15 10:12,UNKNOWN,0,100,0,HDAC,WITHDRAWAL,,,,0,COMPLETED,0,sum-user-id,1386831.3,airdrop-20181115-hdac-sum-user-id-withdrawal,accac570-de75-11e8-bd11-2f9252c4dc2f,AIRDROP,0
airdrop-20181115-hdac-f0e10348-c12f-451d-b11b-d0dd6305f7ae-withdrawal-exchange,2018.11.15 10:12,UNKNOWN,,UNKNOWN-55c0f2b7-dc24-425b-9be8-6b86719f2865,2018.11.15 10:12,UNKNOWN,0,100,0,HDAC,WITHDRAWAL,,,,0,COMPLETED,0,sum-user-id,1386731.3,airdrop-20181115-hdac-sum-user-id-withdrawal,accac570-de75-11e8-bd11-2f9252c4dc2f,AIRDROP,0
airdrop-20181115-hdac-f0e7e0ec-da75-4d6e-864d-e25d0148cf79-withdrawal-exchange,2018.11.15 10:12,UNKNOWN,,UNKNOWN-55c0f2b7-dc24-425b-9be8-6b86719f2865,2018.11.15 10:12,UNKNOWN,0,100,0,HDAC,WITHDRAWAL,,,,0,COMPLETED,0,sum-user-id,1386631.3,airdrop-20181115-hdac-sum-user-id-withdrawal,accac570-de75-11e8-bd11-2f9252c4dc2f,AIRDROP,0
airdrop-20181115-hdac-f13822a6-ed10-4a99-90d6-5a90e7647ebf-withdrawal-exchange,2018-11-15 10:12:23.006,UNKNOWN,,UNKNOWN-55c0f2b7-dc24-425b-9be8-6b86719f2865,2018-11-15 10:12:23.006,UNKNOWN,0,100,0,HDAC,WITHDRAWAL,,,,0,COMPLETED,0,sum-user-id,1386531.3,airdrop-20181115-hdac-sum-user-id-withdrawal,accac570-de75-11e8-bd11-2f9252c4dc2f,AIRDROP,0
airdrop-20181115-hdac-f18f61bf-2bba-4c5b-a3de-a0d5dfaf29fe-withdrawal-exchange,2018-11-15 10:12:23.038,UNKNOWN,,UNKNOWN-55c0f2b7-dc24-425b-9be8-6b86719f2865,2018-11-15 10:12:23.038,UNKNOWN,0,100,0,HDAC,WITHDRAWAL,,,,0,COMPLETED,0,sum-user-id,1386431.3,airdrop-20181115-hdac-sum-user-id-withdrawal,accac570-de75-11e8-bd11-2f9252c4dc2f,AIRDROP,0
airdrop-20181115-hdac-f1980d0f-adf8-40a7-bab7-af9c703c86ad-withdrawal-exchange,2018-11-15 10:12:23.066,UNKNOWN,,UNKNOWN-55c0f2b7-dc24-425b-9be8-6b86719f2865,2018-11-15 10:12:23.066,UNKNOWN,0,100,0,HDAC,WITHDRAWAL,,,,0,COMPLETED,0,sum-user-id,1386331.3,airdrop-20181115-hdac-sum-user-id-withdrawal,accac570-de75-11e8-bd11-2f9252c4dc2f,AIRDROP,0
airdrop-20181115-hdac-f1adb3ec-94eb-4aa0-91f1-4282ff1ed92b-withdrawal-exchange,2018-11-15 10:12:23.098,UNKNOWN,,UNKNOWN-55c0f2b7-dc24-425b-9be8-6b86719f2865,2018-11-15 10:12:23.098,UNKNOWN,0,100,0,HDAC,WITHDRAWAL,,,,0,COMPLETED,0,sum-user-id,1386231.3,airdrop-20181115-hdac-sum-user-id-withdrawal,accac570-de75-11e8-bd11-2f9252c4dc2f,AIRDROP,0
airdrop-20181115-hdac-f20beeb4-93ee-4373-8e7a-82faa1b77cb7-withdrawal-exchange,2018.11.15 10:12,UNKNOWN,,UNKNOWN-55c0f2b7-dc24-425b-9be8-6b86719f2865,2018.11.15 10:12,UNKNOWN,0,100,0,HDAC,WITHDRAWAL,,,,0,COMPLETED,0,sum-user-id,1386131.3,airdrop-20181115-hdac-sum-user-id-withdrawal,accac570-de75-11e8-bd11-2f9252c4dc2f,AIRDROP,0
airdrop-20181115-hdac-f20e7d10-4228-4fc0-b6d7-caee80c995a8-withdrawal-exchange,2018.11.15 10:12,UNKNOWN,,UNKNOWN-55c0f2b7-dc24-425b-9be8-6b86719f2865,2018.11.15 10:12,UNKNOWN,0,100,0,HDAC,WITHDRAWAL,,,,0,COMPLETED,0,sum-user-id,1386031.3,airdrop-20181115-hdac-sum-user-id-withdrawal,accac570-de75-11e8-bd11-2f9252c4dc2f,AIRDROP,0
airdrop-20181115-hdac-f23875b1-fd01-400d-bc3c-afd0dfacb3e2-withdrawal-exchange,2018.11.15 10:12,UNKNOWN,,UNKNOWN-55c0f2b7-dc24-425b-9be8-6b86719f2865,2018.11.15 10:12,UNKNOWN,0,100,0,HDAC,WITHDRAWAL,,,,0,COMPLETED,0,sum-user-id,1385931.3,airdrop-20181115-hdac-sum-user-id-withdrawal,accac570-de75-11e8-bd11-2f9252c4dc2f,AIRDROP,0
airdrop-20181115-hdac-f249065a-f98c-4926-bbe9-962032fc7794-withdrawal-exchange,2018.11.15 10:12,UNKNOWN,,UNKNOWN-55c0f2b7-dc24-425b-9be8-6b86719f2865,2018.11.15 10:12,UNKNOWN,0,100,0,HDAC,WITHDRAWAL,,,,0,COMPLETED,0,sum-user-id,1385831.3,airdrop-20181115-hdac-sum-user-id-withdrawal,accac570-de75-11e8-bd11-2f9252c4dc2f,AIRDROP,0
airdrop-20181115-hdac-f279d65b-f7d4-48b8-8bc6-901ff3540f03-withdrawal-exchange,2018.11.15 10:12,UNKNOWN,,UNKNOWN-55c0f2b7-dc24-425b-9be8-6b86719f2865,2018.11.15 10:12,UNKNOWN,0,100,0,HDAC,WITHDRAWAL,,,,0,COMPLETED,0,sum-user-id,1385731.3,airdrop-20181115-hdac-sum-user-id-withdrawal,accac570-de75-11e8-bd11-2f9252c4dc2f,AIRDROP,0
airdrop-20181115-hdac-f27c3a48-e888-4591-bf91-47e64cb7cf06-withdrawal-exchange,2018.11.15 10:12,UNKNOWN,,UNKNOWN-55c0f2b7-dc24-425b-9be8-6b86719f2865,2018.11.15 10:12,UNKNOWN,0,100,0,HDAC,WITHDRAWAL,,,,0,COMPLETED,0,sum-user-id,1385631.3,airdrop-20181115-hdac-sum-user-id-withdrawal,accac570-de75-11e8-bd11-2f9252c4dc2f,AIRDROP,0
airdrop-20181115-hdac-f2bfe3b1-cb10-4c7a-ad20-621d71c1839c-withdrawal-exchange,2018.11.15 10:12,UNKNOWN,,UNKNOWN-55c0f2b7-dc24-425b-9be8-6b86719f2865,2018.11.15 10:12,UNKNOWN,0,100,0,HDAC,WITHDRAWAL,,,,0,COMPLETED,0,sum-user-id,1385531.3,airdrop-20181115-hdac-sum-user-id-withdrawal,accac570-de75-11e8-bd11-2f9252c4dc2f,AIRDROP,0
airdrop-20181115-hdac-f2ed4519-4aa3-465b-9c29-e56c2929cbbc-withdrawal-exchange,2018.11.15 10:12,UNKNOWN,,UNKNOWN-55c0f2b7-dc24-425b-9be8-6b86719f2865,2018.11.15 10:12,UNKNOWN,0,100,0,HDAC,WITHDRAWAL,,,,0,COMPLETED,0,sum-user-id,1385431.3,airdrop-20181115-hdac-sum-user-id-withdrawal,accac570-de75-11e8-bd11-2f9252c4dc2f,AIRDROP,0
airdrop-20181115-hdac-f2f4fc31-bd10-474f-9207-35f7c475ef25-withdrawal-exchange,2018.11.15 10:12,UNKNOWN,,UNKNOWN-55c0f2b7-dc24-425b-9be8-6b86719f2865,2018.11.15 10:12,UNKNOWN,0,100,0,HDAC,WITHDRAWAL,,,,0,COMPLETED,0,sum-user-id,1385331.3,airdrop-20181115-hdac-sum-user-id-withdrawal,accac570-de75-11e8-bd11-2f9252c4dc2f,AIRDROP,0
airdrop-20181115-hdac-f31559f9-8f17-4076-aa81-3041422e2711-withdrawal-exchange,2018.11.15 10:12,UNKNOWN,,UNKNOWN-55c0f2b7-dc24-425b-9be8-6b86719f2865,2018.11.15 10:12,UNKNOWN,0,100,0,HDAC,WITHDRAWAL,,,,0,COMPLETED,0,sum-user-id,1385231.3,airdrop-20181115-hdac-sum-user-id-withdrawal,accac570-de75-11e8-bd11-2f9252c4dc2f,AIRDROP,0
airdrop-20181115-hdac-f31deeb2-fa4d-4cee-9d02-0bdf52256230-withdrawal-exchange,2018.11.15 10:12,UNKNOWN,,UNKNOWN-55c0f2b7-dc24-425b-9be8-6b86719f2865,2018.11.15 10:12,UNKNOWN,0,100,0,HDAC,WITHDRAWAL,,,,0,COMPLETED,0,sum-user-id,1385131.3,airdrop-20181115-hdac-sum-user-id-withdrawal,accac570-de75-11e8-bd11-2f9252c4dc2f,AIRDROP,0
airdrop-20181115-hdac-f33859d6-230f-4fed-bc46-9bc510405b91-withdrawal-exchange,2018.11.15 10:12,UNKNOWN,,UNKNOWN-55c0f2b7-dc24-425b-9be8-6b86719f2865,2018.11.15 10:12,UNKNOWN,0,100,0,HDAC,WITHDRAWAL,,,,0,COMPLETED,0,sum-user-id,1385031.3,airdrop-20181115-hdac-sum-user-id-withdrawal,accac570-de75-11e8-bd11-2f9252c4dc2f,AIRDROP,0
airdrop-20181115-hdac-f356a0fe-1220-45ab-9ca5-353a0f85c745-withdrawal-exchange,2018.11.15 10:12,UNKNOWN,,UNKNOWN-55c0f2b7-dc24-425b-9be8-6b86719f2865,2018.11.15 10:12,UNKNOWN,0,100,0,HDAC,WITHDRAWAL,,,,0,COMPLETED,0,sum-user-id,1384931.3,airdrop-20181115-hdac-sum-user-id-withdrawal,accac570-de75-11e8-bd11-2f9252c4dc2f,AIRDROP,0
airdrop-20181115-hdac-f3622562-8a3b-41e7-acb9-c1c2a838cad1-withdrawal-exchange,2018.11.15 10:12,UNKNOWN,,UNKNOWN-55c0f2b7-dc24-425b-9be8-6b86719f2865,2018.11.15 10:12,UNKNOWN,0,100,0,HDAC,WITHDRAWAL,,,,0,COMPLETED,0,sum-user-id,1384831.3,airdrop-20181115-hdac-sum-user-id-withdrawal,accac570-de75-11e8-bd11-2f9252c4dc2f,AIRDROP,0
airdrop-20181115-hdac-f3635508-b887-4354-ae10-e467535c9c07-withdrawal-exchange,2018.11.15 10:12,UNKNOWN,,UNKNOWN-55c0f2b7-dc24-425b-9be8-6b86719f2865,2018.11.15 10:12,UNKNOWN,0,100,0,HDAC,WITHDRAWAL,,,,0,COMPLETED,0,sum-user-id,1384731.3,airdrop-20181115-hdac-sum-user-id-withdrawal,accac570-de75-11e8-bd11-2f9252c4dc2f,AIRDROP,0
airdrop-20181115-hdac-f3b2a261-43d2-4cf4-a4ac-f3925ac9ddc2-withdrawal-exchange,2018.11.15 10:12,UNKNOWN,,UNKNOWN-55c0f2b7-dc24-425b-9be8-6b86719f2865,2018.11.15 10:12,UNKNOWN,0,100,0,HDAC,WITHDRAWAL,,,,0,COMPLETED,0,sum-user-id,1384631.3,airdrop-20181115-hdac-sum-user-id-withdrawal,accac570-de75-11e8-bd11-2f9252c4dc2f,AIRDROP,0
airdrop-20181115-hdac-f3b6b9ee-6fec-411f-a7bb-e71dacfdc1ab-withdrawal-exchange,2018.11.15 10:12,UNKNOWN,,UNKNOWN-55c0f2b7-dc24-425b-9be8-6b86719f2865,2018.11.15 10:12,UNKNOWN,0,100,0,HDAC,WITHDRAWAL,,,,0,COMPLETED,0,sum-user-id,1384531.3,airdrop-20181115-hdac-sum-user-id-withdrawal,accac570-de75-11e8-bd11-2f9252c4dc2f,AIRDROP,0
airdrop-20181115-hdac-f3ccefd3-15b2-405f-a6f4-9e02cce9ae0d-withdrawal-exchange,2018.11.15 10:12,UNKNOWN,,UNKNOWN-55c0f2b7-dc24-425b-9be8-6b86719f2865,2018.11.15 10:12,UNKNOWN,0,100,0,HDAC,WITHDRAWAL,,,,0,COMPLETED,0,sum-user-id,1384431.3,airdrop-20181115-hdac-sum-user-id-withdrawal,accac570-de75-11e8-bd11-2f9252c4dc2f,AIRDROP,0
airdrop-20181115-hdac-f410f516-2710-43ba-b592-a55137a25e53-withdrawal-exchange,2018.11.15 10:12,UNKNOWN,,UNKNOWN-55c0f2b7-dc24-425b-9be8-6b86719f2865,2018.11.15 10:12,UNKNOWN,0,90.83611,0,HDAC,WITHDRAWAL,,,,0,COMPLETED,0,sum-user-id,1384340.464,airdrop-20181115-hdac-sum-user-id-withdrawal,accac570-de75-11e8-bd11-2f9252c4dc2f,AIRDROP,0
airdrop-20181115-hdac-f41a6b40-4ead-48d1-a70a-eb757ee61eae-withdrawal-exchange,2018.11.15 10:12,UNKNOWN,,UNKNOWN-55c0f2b7-dc24-425b-9be8-6b86719f2865,2018.11.15 10:12,UNKNOWN,0,100,0,HDAC,WITHDRAWAL,,,,0,COMPLETED,0,sum-user-id,1384240.464,airdrop-20181115-hdac-sum-user-id-withdrawal,accac570-de75-11e8-bd11-2f9252c4dc2f,AIRDROP,0
airdrop-20181115-hdac-f4386c63-057e-4c21-8c81-08e4303288c4-withdrawal-exchange,2018.11.15 10:12,UNKNOWN,,UNKNOWN-55c0f2b7-dc24-425b-9be8-6b86719f2865,2018.11.15 10:12,UNKNOWN,0,100,0,HDAC,WITHDRAWAL,,,,0,COMPLETED,0,sum-user-id,1384140.464,airdrop-20181115-hdac-sum-user-id-withdrawal,accac570-de75-11e8-bd11-2f9252c4dc2f,AIRDROP,0
airdrop-20181115-hdac-f467899a-c71b-497d-99f7-161ca8e95fde-withdrawal-exchange,2018.11.15 10:12,UNKNOWN,,UNKNOWN-55c0f2b7-dc24-425b-9be8-6b86719f2865,2018.11.15 10:12,UNKNOWN,0,100,0,HDAC,WITHDRAWAL,,,,0,COMPLETED,0,sum-user-id,1384040.464,airdrop-20181115-hdac-sum-user-id-withdrawal,accac570-de75-11e8-bd11-2f9252c4dc2f,AIRDROP,0
airdrop-20181115-hdac-f4af1573-002c-456d-a71d-5d8082e318f1-withdrawal-exchange,2018.11.15 10:12,UNKNOWN,,UNKNOWN-55c0f2b7-dc24-425b-9be8-6b86719f2865,2018.11.15 10:12,UNKNOWN,0,100,0,HDAC,WITHDRAWAL,,,,0,COMPLETED,0,sum-user-id,1383940.464,airdrop-20181115-hdac-sum-user-id-withdrawal,accac570-de75-11e8-bd11-2f9252c4dc2f,AIRDROP,0
airdrop-20181115-hdac-f4e5c5a3-89b1-4739-979b-1e23fab59906-withdrawal-exchange,2018.11.15 10:12,UNKNOWN,,UNKNOWN-55c0f2b7-dc24-425b-9be8-6b86719f2865,2018.11.15 10:12,UNKNOWN,0,100,0,HDAC,WITHDRAWAL,,,,0,COMPLETED,0,sum-user-id,1383840.464,airdrop-20181115-hdac-sum-user-id-withdrawal,accac570-de75-11e8-bd11-2f9252c4dc2f,AIRDROP,0
airdrop-20181115-hdac-f4e71af1-2fe3-4f24-a092-46bc3ca951d2-withdrawal-exchange,2018.11.15 10:12,UNKNOWN,,UNKNOWN-55c0f2b7-dc24-425b-9be8-6b86719f2865,2018.11.15 10:12,UNKNOWN,0,100,0,HDAC,WITHDRAWAL,,,,0,COMPLETED,0,sum-user-id,1383740.464,airdrop-20181115-hdac-sum-user-id-withdrawal,accac570-de75-11e8-bd11-2f9252c4dc2f,AIRDROP,0
airdrop-20181115-hdac-f5002748-5c3b-4de0-9fd0-dc6770082f3b-withdrawal-exchange,2018.11.15 10:12,UNKNOWN,,UNKNOWN-55c0f2b7-dc24-425b-9be8-6b86719f2865,2018.11.15 10:12,UNKNOWN,0,100,0,HDAC,WITHDRAWAL,,,,0,COMPLETED,0,sum-user-id,1383640.464,airdrop-20181115-hdac-sum-user-id-withdrawal,accac570-de75-11e8-bd11-2f9252c4dc2f,AIRDROP,0
airdrop-20181115-hdac-f5062e01-ff53-40f3-89ae-18608647e782-withdrawal-exchange,2018.11.15 10:12,UNKNOWN,,UNKNOWN-55c0f2b7-dc24-425b-9be8-6b86719f2865,2018.11.15 10:12,UNKNOWN,0,100,0,HDAC,WITHDRAWAL,,,,0,COMPLETED,0,sum-user-id,1383540.464,airdrop-20181115-hdac-sum-user-id-withdrawal,accac570-de75-11e8-bd11-2f9252c4dc2f,AIRDROP,0
airdrop-20181115-hdac-f51e1ed8-f91f-410a-b4b9-e2af4c085753-withdrawal-exchange,2018.11.15 10:12,UNKNOWN,,UNKNOWN-55c0f2b7-dc24-425b-9be8-6b86719f2865,2018.11.15 10:12,UNKNOWN,0,100,0,HDAC,WITHDRAWAL,,,,0,COMPLETED,0,sum-user-id,1383440.464,airdrop-20181115-hdac-sum-user-id-withdrawal,accac570-de75-11e8-bd11-2f9252c4dc2f,AIRDROP,0
airdrop-20181115-hdac-f5513b60-16a9-4993-9b7c-2947d723b4a6-withdrawal-exchange,2018-11-15 10:12:24.011,UNKNOWN,,UNKNOWN-55c0f2b7-dc24-425b-9be8-6b86719f2865,2018-11-15 10:12:24.011,UNKNOWN,0,100,0,HDAC,WITHDRAWAL,,,,0,COMPLETED,0,sum-user-id,1383340.464,airdrop-20181115-hdac-sum-user-id-withdrawal,accac570-de75-11e8-bd11-2f9252c4dc2f,AIRDROP,0
airdrop-20181115-hdac-f55f651c-2cc5-432a-9d91-0fc996f22ceb-withdrawal-exchange,2018-11-15 10:12:24.044,UNKNOWN,,UNKNOWN-55c0f2b7-dc24-425b-9be8-6b86719f2865,2018-11-15 10:12:24.044,UNKNOWN,0,100,0,HDAC,WITHDRAWAL,,,,0,COMPLETED,0,sum-user-id,1383240.464,airdrop-20181115-hdac-sum-user-id-withdrawal,accac570-de75-11e8-bd11-2f9252c4dc2f,AIRDROP,0
airdrop-20181115-hdac-f57f21f8-eee8-479a-8668-e467f7132306-withdrawal-exchange,2018-11-15 10:12:24.079,UNKNOWN,,UNKNOWN-55c0f2b7-dc24-425b-9be8-6b86719f2865,2018-11-15 10:12:24.079,UNKNOWN,0,100,0,HDAC,WITHDRAWAL,,,,0,COMPLETED,0,sum-user-id,1383140.464,airdrop-20181115-hdac-sum-user-id-withdrawal,accac570-de75-11e8-bd11-2f9252c4dc2f,AIRDROP,0
airdrop-20181115-hdac-f5d59078-5c83-41aa-a1c7-75ba0cda28f8-withdrawal-exchange,2018.11.15 10:12,UNKNOWN,,UNKNOWN-55c0f2b7-dc24-425b-9be8-6b86719f2865,2018.11.15 10:12,UNKNOWN,0,100,0,HDAC,WITHDRAWAL,,,,0,COMPLETED,0,sum-user-id,1383040.464,airdrop-20181115-hdac-sum-user-id-withdrawal,accac570-de75-11e8-bd11-2f9252c4dc2f,AIRDROP,0
airdrop-20181115-hdac-f5db0060-c717-4967-ab20-328d9932e482-withdrawal-exchange,2018.11.15 10:12,UNKNOWN,,UNKNOWN-55c0f2b7-dc24-425b-9be8-6b86719f2865,2018.11.15 10:12,UNKNOWN,0,100,0,HDAC,WITHDRAWAL,,,,0,COMPLETED,0,sum-user-id,1382940.464,airdrop-20181115-hdac-sum-user-id-withdrawal,accac570-de75-11e8-bd11-2f9252c4dc2f,AIRDROP,0
airdrop-20181115-hdac-f5fd5c5d-a51d-4f82-b91c-b7495df89082-withdrawal-exchange,2018.11.15 10:12,UNKNOWN,,UNKNOWN-55c0f2b7-dc24-425b-9be8-6b86719f2865,2018.11.15 10:12,UNKNOWN,0,100,0,HDAC,WITHDRAWAL,,,,0,COMPLETED,0,sum-user-id,1382840.464,airdrop-20181115-hdac-sum-user-id-withdrawal,accac570-de75-11e8-bd11-2f9252c4dc2f,AIRDROP,0
airdrop-20181115-hdac-f6104c4c-898e-4753-bab7-f5f8377e76c8-withdrawal-exchange,2018.11.15 10:12,UNKNOWN,,UNKNOWN-55c0f2b7-dc24-425b-9be8-6b86719f2865,2018.11.15 10:12,UNKNOWN,0,100,0,HDAC,WITHDRAWAL,,,,0,COMPLETED,0,sum-user-id,1382740.464,airdrop-20181115-hdac-sum-user-id-withdrawal,accac570-de75-11e8-bd11-2f9252c4dc2f,AIRDROP,0
airdrop-20181115-hdac-f63c2af6-fe4d-4651-86bc-220f83fddef7-withdrawal-exchange,2018.11.15 10:12,UNKNOWN,,UNKNOWN-55c0f2b7-dc24-425b-9be8-6b86719f2865,2018.11.15 10:12,UNKNOWN,0,100,0,HDAC,WITHDRAWAL,,,,0,COMPLETED,0,sum-user-id,1382640.464,airdrop-20181115-hdac-sum-user-id-withdrawal,accac570-de75-11e8-bd11-2f9252c4dc2f,AIRDROP,0
airdrop-20181115-hdac-f63e545a-7cd5-488a-8769-85236ddc1a2d-withdrawal-exchange,2018.11.15 10:12,UNKNOWN,,UNKNOWN-55c0f2b7-dc24-425b-9be8-6b86719f2865,2018.11.15 10:12,UNKNOWN,0,100,0,HDAC,WITHDRAWAL,,,,0,COMPLETED,0,sum-user-id,1382540.464,airdrop-20181115-hdac-sum-user-id-withdrawal,accac570-de75-11e8-bd11-2f9252c4dc2f,AIRDROP,0
airdrop-20181115-hdac-f64de83b-b9da-4d27-b577-116cd09d5d46-withdrawal-exchange,2018.11.15 10:12,UNKNOWN,,UNKNOWN-55c0f2b7-dc24-425b-9be8-6b86719f2865,2018.11.15 10:12,UNKNOWN,0,100,0,HDAC,WITHDRAWAL,,,,0,COMPLETED,0,sum-user-id,1382440.464,airdrop-20181115-hdac-sum-user-id-withdrawal,accac570-de75-11e8-bd11-2f9252c4dc2f,AIRDROP,0
airdrop-20181115-hdac-f655301d-f9e2-43cf-a949-63f4afe0fb8f-withdrawal-exchange,2018.11.15 10:12,UNKNOWN,,UNKNOWN-55c0f2b7-dc24-425b-9be8-6b86719f2865,2018.11.15 10:12,UNKNOWN,0,100,0,HDAC,WITHDRAWAL,,,,0,COMPLETED,0,sum-user-id,1382340.464,airdrop-20181115-hdac-sum-user-id-withdrawal,accac570-de75-11e8-bd11-2f9252c4dc2f,AIRDROP,0
airdrop-20181115-hdac-f65b0570-c561-4ecc-bb1e-7a60910c2431-withdrawal-exchange,2018.11.15 10:12,UNKNOWN,,UNKNOWN-55c0f2b7-dc24-425b-9be8-6b86719f2865,2018.11.15 10:12,UNKNOWN,0,100,0,HDAC,WITHDRAWAL,,,,0,COMPLETED,0,sum-user-id,1382240.464,airdrop-20181115-hdac-sum-user-id-withdrawal,accac570-de75-11e8-bd11-2f9252c4dc2f,AIRDROP,0
airdrop-20181115-hdac-f6665fe8-e3e0-4c99-8a70-d265db8913ff-withdrawal-exchange,2018.11.15 10:12,UNKNOWN,,UNKNOWN-55c0f2b7-dc24-425b-9be8-6b86719f2865,2018.11.15 10:12,UNKNOWN,0,100,0,HDAC,WITHDRAWAL,,,,0,COMPLETED,0,sum-user-id,1382140.464,airdrop-20181115-hdac-sum-user-id-withdrawal,accac570-de75-11e8-bd11-2f9252c4dc2f,AIRDROP,0
airdrop-20181115-hdac-f6727088-91bd-4d92-890f-dc87f5ea3ead-withdrawal-exchange,2018.11.15 10:12,UNKNOWN,,UNKNOWN-55c0f2b7-dc24-425b-9be8-6b86719f2865,2018.11.15 10:12,UNKNOWN,0,100,0,HDAC,WITHDRAWAL,,,,0,COMPLETED,0,sum-user-id,1382040.464,airdrop-20181115-hdac-sum-user-id-withdrawal,accac570-de75-11e8-bd11-2f9252c4dc2f,AIRDROP,0
airdrop-20181115-hdac-f6967baf-dc35-4629-971d-581d3c56dd5f-withdrawal-exchange,2018.11.15 10:12,UNKNOWN,,UNKNOWN-55c0f2b7-dc24-425b-9be8-6b86719f2865,2018.11.15 10:12,UNKNOWN,0,100,0,HDAC,WITHDRAWAL,,,,0,COMPLETED,0,sum-user-id,1381940.464,airdrop-20181115-hdac-sum-user-id-withdrawal,accac570-de75-11e8-bd11-2f9252c4dc2f,AIRDROP,0
airdrop-20181115-hdac-f6a49950-1672-49b5-9c47-21c89c9a39cd-withdrawal-exchange,2018.11.15 10:12,UNKNOWN,,UNKNOWN-55c0f2b7-dc24-425b-9be8-6b86719f2865,2018.11.15 10:12,UNKNOWN,0,100,0,HDAC,WITHDRAWAL,,,,0,COMPLETED,0,sum-user-id,1381840.464,airdrop-20181115-hdac-sum-user-id-withdrawal,accac570-de75-11e8-bd11-2f9252c4dc2f,AIRDROP,0
airdrop-20181115-hdac-f6aae383-6247-48cd-82f0-7c9b4b9ef0eb-withdrawal-exchange,2018.11.15 10:12,UNKNOWN,,UNKNOWN-55c0f2b7-dc24-425b-9be8-6b86719f2865,2018.11.15 10:12,UNKNOWN,0,100,0,HDAC,WITHDRAWAL,,,,0,COMPLETED,0,sum-user-id,1381740.464,airdrop-20181115-hdac-sum-user-id-withdrawal,accac570-de75-11e8-bd11-2f9252c4dc2f,AIRDROP,0
airdrop-20181115-hdac-f6aaf9bc-edc5-4202-bba7-446a3f84d92d-withdrawal-exchange,2018.11.15 10:12,UNKNOWN,,UNKNOWN-55c0f2b7-dc24-425b-9be8-6b86719f2865,2018.11.15 10:12,UNKNOWN,0,100,0,HDAC,WITHDRAWAL,,,,0,COMPLETED,0,sum-user-id,1381640.464,airdrop-20181115-hdac-sum-user-id-withdrawal,accac570-de75-11e8-bd11-2f9252c4dc2f,AIRDROP,0
airdrop-20181115-hdac-f6e3ca79-f686-46cc-81a4-8480de59c11d-withdrawal-exchange,2018.11.15 10:12,UNKNOWN,,UNKNOWN-55c0f2b7-dc24-425b-9be8-6b86719f2865,2018.11.15 10:12,UNKNOWN,0,100,0,HDAC,WITHDRAWAL,,,,0,COMPLETED,0,sum-user-id,1381540.464,airdrop-20181115-hdac-sum-user-id-withdrawal,accac570-de75-11e8-bd11-2f9252c4dc2f,AIRDROP,0
airdrop-20181115-hdac-f6f72b36-869b-4e28-9be8-47c758edb34a-withdrawal-exchange,2018.11.15 10:12,UNKNOWN,,UNKNOWN-55c0f2b7-dc24-425b-9be8-6b86719f2865,2018.11.15 10:12,UNKNOWN,0,100,0,HDAC,WITHDRAWAL,,,,0,COMPLETED,0,sum-user-id,1381440.464,airdrop-20181115-hdac-sum-user-id-withdrawal,accac570-de75-11e8-bd11-2f9252c4dc2f,AIRDROP,0
airdrop-20181115-hdac-f6fee776-e3ea-4b59-a573-7ba61044074b-withdrawal-exchange,2018.11.15 10:12,UNKNOWN,,UNKNOWN-55c0f2b7-dc24-425b-9be8-6b86719f2865,2018.11.15 10:12,UNKNOWN,0,100,0,HDAC,WITHDRAWAL,,,,0,COMPLETED,0,sum-user-id,1381340.464,airdrop-20181115-hdac-sum-user-id-withdrawal,accac570-de75-11e8-bd11-2f9252c4dc2f,AIRDROP,0
airdrop-20181115-hdac-f7071bb5-d3df-42a7-8cf0-94af7136e27b-withdrawal-exchange,2018.11.15 10:12,UNKNOWN,,UNKNOWN-55c0f2b7-dc24-425b-9be8-6b86719f2865,2018.11.15 10:12,UNKNOWN,0,100,0,HDAC,WITHDRAWAL,,,,0,COMPLETED,0,sum-user-id,1381240.464,airdrop-20181115-hdac-sum-user-id-withdrawal,accac570-de75-11e8-bd11-2f9252c4dc2f,AIRDROP,0
airdrop-20181115-hdac-f72c779b-2f70-4ac6-b9ec-4bcec420112f-withdrawal-exchange,2018.11.15 10:12,UNKNOWN,,UNKNOWN-55c0f2b7-dc24-425b-9be8-6b86719f2865,2018.11.15 10:12,UNKNOWN,0,100,0,HDAC,WITHDRAWAL,,,,0,COMPLETED,0,sum-user-id,1381140.464,airdrop-20181115-hdac-sum-user-id-withdrawal,accac570-de75-11e8-bd11-2f9252c4dc2f,AIRDROP,0
airdrop-20181115-hdac-f7481e98-fccc-4e59-821e-7982abdd8b91-withdrawal-exchange,2018.11.15 10:12,UNKNOWN,,UNKNOWN-55c0f2b7-dc24-425b-9be8-6b86719f2865,2018.11.15 10:12,UNKNOWN,0,100,0,HDAC,WITHDRAWAL,,,,0,COMPLETED,0,sum-user-id,1381040.464,airdrop-20181115-hdac-sum-user-id-withdrawal,accac570-de75-11e8-bd11-2f9252c4dc2f,AIRDROP,0
airdrop-20181115-hdac-f759c950-83bd-48c2-aef4-3a72ade03d79-withdrawal-exchange,2018.11.15 10:12,UNKNOWN,,UNKNOWN-55c0f2b7-dc24-425b-9be8-6b86719f2865,2018.11.15 10:12,UNKNOWN,0,100,0,HDAC,WITHDRAWAL,,,,0,COMPLETED,0,sum-user-id,1380940.464,airdrop-20181115-hdac-sum-user-id-withdrawal,accac570-de75-11e8-bd11-2f9252c4dc2f,AIRDROP,0
airdrop-20181115-hdac-f76f0cf8-0542-4577-bf3c-a5eb71afe4cf-withdrawal-exchange,2018.11.15 10:12,UNKNOWN,,UNKNOWN-55c0f2b7-dc24-425b-9be8-6b86719f2865,2018.11.15 10:12,UNKNOWN,0,100,0,HDAC,WITHDRAWAL,,,,0,COMPLETED,0,sum-user-id,1380840.464,airdrop-20181115-hdac-sum-user-id-withdrawal,accac570-de75-11e8-bd11-2f9252c4dc2f,AIRDROP,0
airdrop-20181115-hdac-f77c3979-7ebe-424f-be8d-ee680a41e66b-withdrawal-exchange,2018.11.15 10:12,UNKNOWN,,UNKNOWN-55c0f2b7-dc24-425b-9be8-6b86719f2865,2018.11.15 10:12,UNKNOWN,0,100,0,HDAC,WITHDRAWAL,,,,0,COMPLETED,0,sum-user-id,1380740.464,airdrop-20181115-hdac-sum-user-id-withdrawal,accac570-de75-11e8-bd11-2f9252c4dc2f,AIRDROP,0
airdrop-20181115-hdac-f78695f5-5d0e-4d7c-b6f9-177f8d02f685-withdrawal-exchange,2018-11-15 10:12:29.058,UNKNOWN,,UNKNOWN-55c0f2b7-dc24-425b-9be8-6b86719f2865,2018-11-15 10:12:29.058,UNKNOWN,0,1883.513533,0,HDAC,WITHDRAWAL,,,,0,COMPLETED,0,sum-user-id,1101366.382,airdrop-20181115-hdac-sum-user-id-withdrawal,accac570-de75-11e8-bd11-2f9252c4dc2f,AIRDROP,0
airdrop-20181115-hdac-f7a3d4f2-f414-48ce-b90f-6c8d74b033b1-withdrawal-exchange,2018.11.15 10:12,UNKNOWN,,UNKNOWN-55c0f2b7-dc24-425b-9be8-6b86719f2865,2018.11.15 10:12,UNKNOWN,0,100,0,HDAC,WITHDRAWAL,,,,0,COMPLETED,0,sum-user-id,1380640.464,airdrop-20181115-hdac-sum-user-id-withdrawal,accac570-de75-11e8-bd11-2f9252c4dc2f,AIRDROP,0
airdrop-20181115-hdac-f7f36f5e-d59d-4df1-8124-84703c605d2a-withdrawal-exchange,2018.11.15 10:12,UNKNOWN,,UNKNOWN-55c0f2b7-dc24-425b-9be8-6b86719f2865,2018.11.15 10:12,UNKNOWN,0,100,0,HDAC,WITHDRAWAL,,,,0,COMPLETED,0,sum-user-id,1380540.464,airdrop-20181115-hdac-sum-user-id-withdrawal,accac570-de75-11e8-bd11-2f9252c4dc2f,AIRDROP,0
airdrop-20181115-hdac-f81cbd8f-dcc0-4357-ad51-22bd0bd77fc6-withdrawal-exchange,2018.11.15 10:12,UNKNOWN,,UNKNOWN-55c0f2b7-dc24-425b-9be8-6b86719f2865,2018.11.15 10:12,UNKNOWN,0,100,0,HDAC,WITHDRAWAL,,,,0,COMPLETED,0,sum-user-id,1380440.464,airdrop-20181115-hdac-sum-user-id-withdrawal,accac570-de75-11e8-bd11-2f9252c4dc2f,AIRDROP,0
airdrop-20181115-hdac-f85e03b1-0b34-4c55-8d60-d302de3d5f93-withdrawal-exchange,2018.11.15 10:12,UNKNOWN,,UNKNOWN-55c0f2b7-dc24-425b-9be8-6b86719f2865,2018.11.15 10:12,UNKNOWN,0,100,0,HDAC,WITHDRAWAL,,,,0,COMPLETED,0,sum-user-id,1380340.464,airdrop-20181115-hdac-sum-user-id-withdrawal,accac570-de75-11e8-bd11-2f9252c4dc2f,AIRDROP,0
airdrop-20181115-hdac-f86e81e1-3ab3-453e-94b3-e3e578e617aa-withdrawal-exchange,2018-11-15 10:12:25.019,UNKNOWN,,UNKNOWN-55c0f2b7-dc24-425b-9be8-6b86719f2865,2018-11-15 10:12:25.019,UNKNOWN,0,100,0,HDAC,WITHDRAWAL,,,,0,COMPLETED,0,sum-user-id,1380240.464,airdrop-20181115-hdac-sum-user-id-withdrawal,accac570-de75-11e8-bd11-2f9252c4dc2f,AIRDROP,0
airdrop-20181115-hdac-f88df711-f9a1-45cc-93cd-9aa86fe79576-withdrawal-exchange,2018-11-15 10:12:25.054,UNKNOWN,,UNKNOWN-55c0f2b7-dc24-425b-9be8-6b86719f2865,2018-11-15 10:12:25.054,UNKNOWN,0,100,0,HDAC,WITHDRAWAL,,,,0,COMPLETED,0,sum-user-id,1380140.464,airdrop-20181115-hdac-sum-user-id-withdrawal,accac570-de75-11e8-bd11-2f9252c4dc2f,AIRDROP,0
airdrop-20181115-hdac-f89ec0f6-1db7-4b4d-b3eb-96931d8c5b66-withdrawal-exchange,2018-11-15 10:12:25.087,UNKNOWN,,UNKNOWN-55c0f2b7-dc24-425b-9be8-6b86719f2865,2018-11-15 10:12:25.087,UNKNOWN,0,100,0,HDAC,WITHDRAWAL,,,,0,COMPLETED,0,sum-user-id,1380040.464,airdrop-20181115-hdac-sum-user-id-withdrawal,accac570-de75-11e8-bd11-2f9252c4dc2f,AIRDROP,0
airdrop-20181115-hdac-f8be83bf-5fc1-4dfa-afec-88862d69e362-withdrawal-exchange,2018.11.15 10:12,UNKNOWN,,UNKNOWN-55c0f2b7-dc24-425b-9be8-6b86719f2865,2018.11.15 10:12,UNKNOWN,0,100,0,HDAC,WITHDRAWAL,,,,0,COMPLETED,0,sum-user-id,1379940.464,airdrop-20181115-hdac-sum-user-id-withdrawal,accac570-de75-11e8-bd11-2f9252c4dc2f,AIRDROP,0
airdrop-20181115-hdac-f8e19181-ed2f-4691-9297-e50d4bab08e9-withdrawal-exchange,2018.11.15 10:12,UNKNOWN,,UNKNOWN-55c0f2b7-dc24-425b-9be8-6b86719f2865,2018.11.15 10:12,UNKNOWN,0,100,0,HDAC,WITHDRAWAL,,,,0,COMPLETED,0,sum-user-id,1379840.464,airdrop-20181115-hdac-sum-user-id-withdrawal,accac570-de75-11e8-bd11-2f9252c4dc2f,AIRDROP,0
airdrop-20181115-hdac-f8f1a47c-86f7-4220-8632-383437c406b5-withdrawal-exchange,2018.11.15 10:12,UNKNOWN,,UNKNOWN-55c0f2b7-dc24-425b-9be8-6b86719f2865,2018.11.15 10:12,UNKNOWN,0,100,0,HDAC,WITHDRAWAL,,,,0,COMPLETED,0,sum-user-id,1379740.464,airdrop-20181115-hdac-sum-user-id-withdrawal,accac570-de75-11e8-bd11-2f9252c4dc2f,AIRDROP,0
airdrop-20181115-hdac-f8f7a299-3231-4ff8-901a-673e23b6ab14-withdrawal-exchange,2018.11.15 10:12,UNKNOWN,,UNKNOWN-55c0f2b7-dc24-425b-9be8-6b86719f2865,2018.11.15 10:12,UNKNOWN,0,100,0,HDAC,WITHDRAWAL,,,,0,COMPLETED,0,sum-user-id,1379640.464,airdrop-20181115-hdac-sum-user-id-withdrawal,accac570-de75-11e8-bd11-2f9252c4dc2f,AIRDROP,0
airdrop-20181115-hdac-f9166f64-5cd6-4391-95c3-7667b1f77b90-withdrawal-exchange,2018.11.15 10:12,UNKNOWN,,UNKNOWN-55c0f2b7-dc24-425b-9be8-6b86719f2865,2018.11.15 10:12,UNKNOWN,0,100,0,HDAC,WITHDRAWAL,,,,0,COMPLETED,0,sum-user-id,1379540.464,airdrop-20181115-hdac-sum-user-id-withdrawal,accac570-de75-11e8-bd11-2f9252c4dc2f,AIRDROP,0
airdrop-20181115-hdac-f935a436-fc6b-4fbc-a7f0-d18519658e7e-withdrawal-exchange,2018.11.15 10:12,UNKNOWN,,UNKNOWN-55c0f2b7-dc24-425b-9be8-6b86719f2865,2018.11.15 10:12,UNKNOWN,0,100,0,HDAC,WITHDRAWAL,,,,0,COMPLETED,0,sum-user-id,1379440.464,airdrop-20181115-hdac-sum-user-id-withdrawal,accac570-de75-11e8-bd11-2f9252c4dc2f,AIRDROP,0
airdrop-20181115-hdac-f94ecb67-54d3-42ca-8de7-2b82cbdc235e-withdrawal-exchange,2018.11.15 10:12,UNKNOWN,,UNKNOWN-55c0f2b7-dc24-425b-9be8-6b86719f2865,2018.11.15 10:12,UNKNOWN,0,100,0,HDAC,WITHDRAWAL,,,,0,COMPLETED,0,sum-user-id,1379340.464,airdrop-20181115-hdac-sum-user-id-withdrawal,accac570-de75-11e8-bd11-2f9252c4dc2f,AIRDROP,0
airdrop-20181115-hdac-f969fabf-2a78-4dc8-bf04-3a0f29499808-withdrawal-exchange,2018.11.15 10:12,UNKNOWN,,UNKNOWN-55c0f2b7-dc24-425b-9be8-6b86719f2865,2018.11.15 10:12,UNKNOWN,0,100,0,HDAC,WITHDRAWAL,,,,0,COMPLETED,0,sum-user-id,1379240.464,airdrop-20181115-hdac-sum-user-id-withdrawal,accac570-de75-11e8-bd11-2f9252c4dc2f,AIRDROP,0
airdrop-20181115-hdac-f98e0eef-fca8-461b-90f0-b19ded244510-withdrawal-exchange,2018.11.15 10:12,UNKNOWN,,UNKNOWN-55c0f2b7-dc24-425b-9be8-6b86719f2865,2018.11.15 10:12,UNKNOWN,0,100,0,HDAC,WITHDRAWAL,,,,0,COMPLETED,0,sum-user-id,1379140.464,airdrop-20181115-hdac-sum-user-id-withdrawal,accac570-de75-11e8-bd11-2f9252c4dc2f,AIRDROP,0
airdrop-20181115-hdac-f9c0e04e-fe35-45a5-83dd-5a2362686e8d-withdrawal-exchange,2018.11.15 10:12,UNKNOWN,,UNKNOWN-55c0f2b7-dc24-425b-9be8-6b86719f2865,2018.11.15 10:12,UNKNOWN,0,100,0,HDAC,WITHDRAWAL,,,,0,COMPLETED,0,sum-user-id,1379040.464,airdrop-20181115-hdac-sum-user-id-withdrawal,accac570-de75-11e8-bd11-2f9252c4dc2f,AIRDROP,0
airdrop-20181115-hdac-f9de8713-4a71-4cc6-a249-1166c0140c07-withdrawal-exchange,2018.11.15 10:12,UNKNOWN,,UNKNOWN-55c0f2b7-dc24-425b-9be8-6b86719f2865,2018.11.15 10:12,UNKNOWN,0,100,0,HDAC,WITHDRAWAL,,,,0,COMPLETED,0,sum-user-id,1378940.464,airdrop-20181115-hdac-sum-user-id-withdrawal,accac570-de75-11e8-bd11-2f9252c4dc2f,AIRDROP,0
airdrop-20181115-hdac-f9df5065-de90-4bfd-b5cb-634e5b495df3-withdrawal-exchange,2018.11.15 10:12,UNKNOWN,,UNKNOWN-55c0f2b7-dc24-425b-9be8-6b86719f2865,2018.11.15 10:12,UNKNOWN,0,100,0,HDAC,WITHDRAWAL,,,,0,COMPLETED,0,sum-user-id,1378840.464,airdrop-20181115-hdac-sum-user-id-withdrawal,accac570-de75-11e8-bd11-2f9252c4dc2f,AIRDROP,0
airdrop-20181115-hdac-f9e25868-0c87-478e-a24a-1ed955dc5578-withdrawal-exchange,2018.11.15 10:12,UNKNOWN,,UNKNOWN-55c0f2b7-dc24-425b-9be8-6b86719f2865,2018.11.15 10:12,UNKNOWN,0,100,0,HDAC,WITHDRAWAL,,,,0,COMPLETED,0,sum-user-id,1378740.464,airdrop-20181115-hdac-sum-user-id-withdrawal,accac570-de75-11e8-bd11-2f9252c4dc2f,AIRDROP,0
airdrop-20181115-hdac-fa1da7c0-b755-4016-82db-c72493151276-withdrawal-exchange,2018.11.15 10:12,UNKNOWN,,UNKNOWN-55c0f2b7-dc24-425b-9be8-6b86719f2865,2018.11.15 10:12,UNKNOWN,0,100,0,HDAC,WITHDRAWAL,,,,0,COMPLETED,0,sum-user-id,1378640.464,airdrop-20181115-hdac-sum-user-id-withdrawal,accac570-de75-11e8-bd11-2f9252c4dc2f,AIRDROP,0
airdrop-20181115-hdac-fa26bb84-fe85-4a9b-a5b3-e21dd7ccc37d-withdrawal-exchange,2018.11.15 10:12,UNKNOWN,,UNKNOWN-55c0f2b7-dc24-425b-9be8-6b86719f2865,2018.11.15 10:12,UNKNOWN,0,100,0,HDAC,WITHDRAWAL,,,,0,COMPLETED,0,sum-user-id,1378540.464,airdrop-20181115-hdac-sum-user-id-withdrawal,accac570-de75-11e8-bd11-2f9252c4dc2f,AIRDROP,0
airdrop-20181115-hdac-faa4a614-7a96-4a4c-a42a-93417a7bbcce-withdrawal-exchange,2018.11.15 10:12,UNKNOWN,,UNKNOWN-55c0f2b7-dc24-425b-9be8-6b86719f2865,2018.11.15 10:12,UNKNOWN,0,709.43,0,HDAC,WITHDRAWAL,,,,0,COMPLETED,0,sum-user-id,1377831.034,airdrop-20181115-hdac-sum-user-id-withdrawal,accac570-de75-11e8-bd11-2f9252c4dc2f,AIRDROP,0
airdrop-20181115-hdac-faa560e3-106c-41a5-839a-4081677a212b-withdrawal-exchange,2018.11.15 10:12,UNKNOWN,,UNKNOWN-55c0f2b7-dc24-425b-9be8-6b86719f2865,2018.11.15 10:12,UNKNOWN,0,100,0,HDAC,WITHDRAWAL,,,,0,COMPLETED,0,sum-user-id,1377731.034,airdrop-20181115-hdac-sum-user-id-withdrawal,accac570-de75-11e8-bd11-2f9252c4dc2f,AIRDROP,0
airdrop-20181115-hdac-fab93f6b-d06e-448a-9314-e10d4499c519-withdrawal-exchange,2018.11.15 10:12,UNKNOWN,,UNKNOWN-55c0f2b7-dc24-425b-9be8-6b86719f2865,2018.11.15 10:12,UNKNOWN,0,100,0,HDAC,WITHDRAWAL,,,,0,COMPLETED,0,sum-user-id,1377631.034,airdrop-20181115-hdac-sum-user-id-withdrawal,accac570-de75-11e8-bd11-2f9252c4dc2f,AIRDROP,0
airdrop-20181115-hdac-fac5ce35-3fa5-454d-ad9c-2035b0ed2abe-withdrawal-exchange,2018.11.15 10:12,UNKNOWN,,UNKNOWN-55c0f2b7-dc24-425b-9be8-6b86719f2865,2018.11.15 10:12,UNKNOWN,0,100,0,HDAC,WITHDRAWAL,,,,0,COMPLETED,0,sum-user-id,1377531.034,airdrop-20181115-hdac-sum-user-id-withdrawal,accac570-de75-11e8-bd11-2f9252c4dc2f,AIRDROP,0
airdrop-20181115-hdac-fad89c33-5a4e-49e4-9383-640664d312b5-withdrawal-exchange,2018.11.15 10:12,UNKNOWN,,UNKNOWN-55c0f2b7-dc24-425b-9be8-6b86719f2865,2018.11.15 10:12,UNKNOWN,0,100,0,HDAC,WITHDRAWAL,,,,0,COMPLETED,0,sum-user-id,1377431.034,airdrop-20181115-hdac-sum-user-id-withdrawal,accac570-de75-11e8-bd11-2f9252c4dc2f,AIRDROP,0
airdrop-20181115-hdac-fafbacee-9f12-462c-89c6-352c3cb9eb9f-withdrawal-exchange,2018.11.15 10:12,UNKNOWN,,UNKNOWN-55c0f2b7-dc24-425b-9be8-6b86719f2865,2018.11.15 10:12,UNKNOWN,0,100,0,HDAC,WITHDRAWAL,,,,0,COMPLETED,0,sum-user-id,1377331.034,airdrop-20181115-hdac-sum-user-id-withdrawal,accac570-de75-11e8-bd11-2f9252c4dc2f,AIRDROP,0
airdrop-20181115-hdac-fafdee2f-9023-4059-8e92-a21af3c2a287-withdrawal-exchange,2018.11.15 10:12,UNKNOWN,,UNKNOWN-55c0f2b7-dc24-425b-9be8-6b86719f2865,2018.11.15 10:12,UNKNOWN,0,100,0,HDAC,WITHDRAWAL,,,,0,COMPLETED,0,sum-user-id,1377231.034,airdrop-20181115-hdac-sum-user-id-withdrawal,accac570-de75-11e8-bd11-2f9252c4dc2f,AIRDROP,0
airdrop-20181115-hdac-fb2196db-ff64-49a1-beaa-d47796aa59c1-withdrawal-exchange,2018.11.15 10:12,UNKNOWN,,UNKNOWN-55c0f2b7-dc24-425b-9be8-6b86719f2865,2018.11.15 10:12,UNKNOWN,0,100,0,HDAC,WITHDRAWAL,,,,0,COMPLETED,0,sum-user-id,1377131.034,airdrop-20181115-hdac-sum-user-id-withdrawal,accac570-de75-11e8-bd11-2f9252c4dc2f,AIRDROP,0
airdrop-20181115-hdac-fb34b1a8-d91d-4011-abaf-01a85fd3732f-withdrawal-exchange,2018.11.15 10:12,UNKNOWN,,UNKNOWN-55c0f2b7-dc24-425b-9be8-6b86719f2865,2018.11.15 10:12,UNKNOWN,0,100,0,HDAC,WITHDRAWAL,,,,0,COMPLETED,0,sum-user-id,1377031.034,airdrop-20181115-hdac-sum-user-id-withdrawal,accac570-de75-11e8-bd11-2f9252c4dc2f,AIRDROP,0
airdrop-20181115-hdac-fb39b625-e257-40d6-843d-7e268965bc11-withdrawal-exchange,2018.11.15 10:12,UNKNOWN,,UNKNOWN-55c0f2b7-dc24-425b-9be8-6b86719f2865,2018.11.15 10:12,UNKNOWN,0,100,0,HDAC,WITHDRAWAL,,,,0,COMPLETED,0,sum-user-id,1376931.034,airdrop-20181115-hdac-sum-user-id-withdrawal,accac570-de75-11e8-bd11-2f9252c4dc2f,AIRDROP,0
airdrop-20181115-hdac-fb496ab8-c712-44be-8ccf-81b914321057-withdrawal-exchange,2018.11.15 10:12,UNKNOWN,,UNKNOWN-55c0f2b7-dc24-425b-9be8-6b86719f2865,2018.11.15 10:12,UNKNOWN,0,100,0,HDAC,WITHDRAWAL,,,,0,COMPLETED,0,sum-user-id,1376831.034,airdrop-20181115-hdac-sum-user-id-withdrawal,accac570-de75-11e8-bd11-2f9252c4dc2f,AIRDROP,0
airdrop-20181115-hdac-fb8953e9-8cac-41c1-9d0d-81e0fbfc2b4f-withdrawal-exchange,2018.11.15 10:12,UNKNOWN,,UNKNOWN-55c0f2b7-dc24-425b-9be8-6b86719f2865,2018.11.15 10:12,UNKNOWN,0,100,0,HDAC,WITHDRAWAL,,,,0,COMPLETED,0,sum-user-id,1376731.034,airdrop-20181115-hdac-sum-user-id-withdrawal,accac570-de75-11e8-bd11-2f9252c4dc2f,AIRDROP,0
airdrop-20181115-hdac-fb8e8987-e263-41d6-aa19-002a118e4a05-withdrawal-exchange,2018.11.15 10:12,UNKNOWN,,UNKNOWN-55c0f2b7-dc24-425b-9be8-6b86719f2865,2018.11.15 10:12,UNKNOWN,0,100,0,HDAC,WITHDRAWAL,,,,0,COMPLETED,0,sum-user-id,1376631.034,airdrop-20181115-hdac-sum-user-id-withdrawal,accac570-de75-11e8-bd11-2f9252c4dc2f,AIRDROP,0
airdrop-20181115-hdac-fb9c7a7d-3925-4c65-9933-9b4d6c82af1a-withdrawal-exchange,2018.11.15 10:12,UNKNOWN,,UNKNOWN-55c0f2b7-dc24-425b-9be8-6b86719f2865,2018.11.15 10:12,UNKNOWN,0,100,0,HDAC,WITHDRAWAL,,,,0,COMPLETED,0,sum-user-id,1376531.034,airdrop-20181115-hdac-sum-user-id-withdrawal,accac570-de75-11e8-bd11-2f9252c4dc2f,AIRDROP,0
airdrop-20181115-hdac-fb9dfee2-22e5-4da8-89b1-c9c6dc867309-withdrawal-exchange,2018-11-15 10:12:26.027,UNKNOWN,,UNKNOWN-55c0f2b7-dc24-425b-9be8-6b86719f2865,2018-11-15 10:12:26.027,UNKNOWN,0,100,0,HDAC,WITHDRAWAL,,,,0,COMPLETED,0,sum-user-id,1376431.034,airdrop-20181115-hdac-sum-user-id-withdrawal,accac570-de75-11e8-bd11-2f9252c4dc2f,AIRDROP,0
airdrop-20181115-hdac-fbcc016c-fc61-41a9-bc94-6b7f90a61554-withdrawal-exchange,2018-11-15 10:12:26.059,UNKNOWN,,UNKNOWN-55c0f2b7-dc24-425b-9be8-6b86719f2865,2018-11-15 10:12:26.059,UNKNOWN,0,100,0,HDAC,WITHDRAWAL,,,,0,COMPLETED,0,sum-user-id,1376331.034,airdrop-20181115-hdac-sum-user-id-withdrawal,accac570-de75-11e8-bd11-2f9252c4dc2f,AIRDROP,0
airdrop-20181115-hdac-fbdeb3a1-548d-43ed-b3e8-b1dd656da425-withdrawal-exchange,2018-11-15 10:12:26.089,UNKNOWN,,UNKNOWN-55c0f2b7-dc24-425b-9be8-6b86719f2865,2018-11-15 10:12:26.089,UNKNOWN,0,100,0,HDAC,WITHDRAWAL,,,,0,COMPLETED,0,sum-user-id,1376231.034,airdrop-20181115-hdac-sum-user-id-withdrawal,accac570-de75-11e8-bd11-2f9252c4dc2f,AIRDROP,0
airdrop-20181115-hdac-fbe41e13-e842-410f-853a-97f9531da9b5-withdrawal-exchange,2018.11.15 10:12,UNKNOWN,,UNKNOWN-55c0f2b7-dc24-425b-9be8-6b86719f2865,2018.11.15 10:12,UNKNOWN,0,100,0,HDAC,WITHDRAWAL,,,,0,COMPLETED,0,sum-user-id,1376131.034,airdrop-20181115-hdac-sum-user-id-withdrawal,accac570-de75-11e8-bd11-2f9252c4dc2f,AIRDROP,0
airdrop-20181115-hdac-fc078846-e302-4ec1-95f6-0c527f692ecc-withdrawal-exchange,2018.11.15 10:12,UNKNOWN,,UNKNOWN-55c0f2b7-dc24-425b-9be8-6b86719f2865,2018.11.15 10:12,UNKNOWN,0,100,0,HDAC,WITHDRAWAL,,,,0,COMPLETED,0,sum-user-id,1376031.034,airdrop-20181115-hdac-sum-user-id-withdrawal,accac570-de75-11e8-bd11-2f9252c4dc2f,AIRDROP,0
airdrop-20181115-hdac-fc0e30b4-bd2a-4707-ac2d-50101d4929e1-withdrawal-exchange,2018.11.15 10:12,UNKNOWN,,UNKNOWN-55c0f2b7-dc24-425b-9be8-6b86719f2865,2018.11.15 10:12,UNKNOWN,0,100,0,HDAC,WITHDRAWAL,,,,0,COMPLETED,0,sum-user-id,1375931.034,airdrop-20181115-hdac-sum-user-id-withdrawal,accac570-de75-11e8-bd11-2f9252c4dc2f,AIRDROP,0
airdrop-20181115-hdac-fc26283c-20c2-472f-8aed-d0ae9740a304-withdrawal-exchange,2018.11.15 10:12,UNKNOWN,,UNKNOWN-55c0f2b7-dc24-425b-9be8-6b86719f2865,2018.11.15 10:12,UNKNOWN,0,100,0,HDAC,WITHDRAWAL,,,,0,COMPLETED,0,sum-user-id,1375831.034,airdrop-20181115-hdac-sum-user-id-withdrawal,accac570-de75-11e8-bd11-2f9252c4dc2f,AIRDROP,0
airdrop-20181115-hdac-fc287521-f7b5-4db8-9a38-ed280eb35aae-withdrawal-exchange,2018.11.15 10:12,UNKNOWN,,UNKNOWN-55c0f2b7-dc24-425b-9be8-6b86719f2865,2018.11.15 10:12,UNKNOWN,0,100,0,HDAC,WITHDRAWAL,,,,0,COMPLETED,0,sum-user-id,1375731.034,airdrop-20181115-hdac-sum-user-id-withdrawal,accac570-de75-11e8-bd11-2f9252c4dc2f,AIRDROP,0
airdrop-20181115-hdac-fc45a4b3-17c2-4809-aa94-045d06c27b12-withdrawal-exchange,2018.11.15 10:12,UNKNOWN,,UNKNOWN-55c0f2b7-dc24-425b-9be8-6b86719f2865,2018.11.15 10:12,UNKNOWN,0,100,0,HDAC,WITHDRAWAL,,,,0,COMPLETED,0,sum-user-id,1375631.034,airdrop-20181115-hdac-sum-user-id-withdrawal,accac570-de75-11e8-bd11-2f9252c4dc2f,AIRDROP,0
airdrop-20181115-hdac-fc48c271-e743-45a8-ba6b-f0c7bc7b49ce-withdrawal-exchange,2018.11.15 10:12,UNKNOWN,,UNKNOWN-55c0f2b7-dc24-425b-9be8-6b86719f2865,2018.11.15 10:12,UNKNOWN,0,100,0,HDAC,WITHDRAWAL,,,,0,COMPLETED,0,sum-user-id,1375531.034,airdrop-20181115-hdac-sum-user-id-withdrawal,accac570-de75-11e8-bd11-2f9252c4dc2f,AIRDROP,0
airdrop-20181115-hdac-fc56ff66-6220-4569-9791-5700325e8227-withdrawal-exchange,2018.11.15 10:12,UNKNOWN,,UNKNOWN-55c0f2b7-dc24-425b-9be8-6b86719f2865,2018.11.15 10:12,UNKNOWN,0,100,0,HDAC,WITHDRAWAL,,,,0,COMPLETED,0,sum-user-id,1375431.034,airdrop-20181115-hdac-sum-user-id-withdrawal,accac570-de75-11e8-bd11-2f9252c4dc2f,AIRDROP,0
airdrop-20181115-hdac-fc61ea1a-46d9-4996-990f-0d8a32940799-withdrawal-exchange,2018.11.15 10:12,UNKNOWN,,UNKNOWN-55c0f2b7-dc24-425b-9be8-6b86719f2865,2018.11.15 10:12,UNKNOWN,0,100,0,HDAC,WITHDRAWAL,,,,0,COMPLETED,0,sum-user-id,1375331.034,airdrop-20181115-hdac-sum-user-id-withdrawal,accac570-de75-11e8-bd11-2f9252c4dc2f,AIRDROP,0
airdrop-20181115-hdac-fc66d17b-197d-44cd-84f8-d1849b6c5dc8-withdrawal-exchange,2018.11.15 10:12,UNKNOWN,,UNKNOWN-55c0f2b7-dc24-425b-9be8-6b86719f2865,2018.11.15 10:12,UNKNOWN,0,100,0,HDAC,WITHDRAWAL,,,,0,COMPLETED,0,sum-user-id,1375231.034,airdrop-20181115-hdac-sum-user-id-withdrawal,accac570-de75-11e8-bd11-2f9252c4dc2f,AIRDROP,0
airdrop-20181115-hdac-fc8fb26a-789e-40ec-85e5-8daff101178d-withdrawal-exchange,2018.11.15 10:12,UNKNOWN,,UNKNOWN-55c0f2b7-dc24-425b-9be8-6b86719f2865,2018.11.15 10:12,UNKNOWN,0,100,0,HDAC,WITHDRAWAL,,,,0,COMPLETED,0,sum-user-id,1375131.034,airdrop-20181115-hdac-sum-user-id-withdrawal,accac570-de75-11e8-bd11-2f9252c4dc2f,AIRDROP,0
airdrop-20181115-hdac-fc9cb907-d2b3-42cb-8ee0-9cb464ac699f-withdrawal-exchange,2018.11.15 10:12,UNKNOWN,,UNKNOWN-55c0f2b7-dc24-425b-9be8-6b86719f2865,2018.11.15 10:12,UNKNOWN,0,100,0,HDAC,WITHDRAWAL,,,,0,COMPLETED,0,sum-user-id,1375031.034,airdrop-20181115-hdac-sum-user-id-withdrawal,accac570-de75-11e8-bd11-2f9252c4dc2f,AIRDROP,0
airdrop-20181115-hdac-fcab688c-9e6f-4e99-b65c-2c91061727f5-withdrawal-exchange,2018.11.15 10:12,UNKNOWN,,UNKNOWN-55c0f2b7-dc24-425b-9be8-6b86719f2865,2018.11.15 10:12,UNKNOWN,0,100,0,HDAC,WITHDRAWAL,,,,0,COMPLETED,0,sum-user-id,1374931.034,airdrop-20181115-hdac-sum-user-id-withdrawal,accac570-de75-11e8-bd11-2f9252c4dc2f,AIRDROP,0
airdrop-20181115-hdac-fcb1a615-004b-4f74-9ef8-6924763024ed-withdrawal-exchange,2018.11.15 10:12,UNKNOWN,,UNKNOWN-55c0f2b7-dc24-425b-9be8-6b86719f2865,2018.11.15 10:12,UNKNOWN,0,100,0,HDAC,WITHDRAWAL,,,,0,COMPLETED,0,sum-user-id,1374831.034,airdrop-20181115-hdac-sum-user-id-withdrawal,accac570-de75-11e8-bd11-2f9252c4dc2f,AIRDROP,0
airdrop-20181115-hdac-fcd14d8a-bf12-4611-87b1-705c33dabae8-withdrawal-exchange,2018.11.15 10:12,UNKNOWN,,UNKNOWN-55c0f2b7-dc24-425b-9be8-6b86719f2865,2018.11.15 10:12,UNKNOWN,0,100,0,HDAC,WITHDRAWAL,,,,0,COMPLETED,0,sum-user-id,1374731.034,airdrop-20181115-hdac-sum-user-id-withdrawal,accac570-de75-11e8-bd11-2f9252c4dc2f,AIRDROP,0
airdrop-20181115-hdac-fcec59ad-df98-40c8-a3b2-6b5c8cdcd0ac-withdrawal-exchange,2018.11.15 10:12,UNKNOWN,,UNKNOWN-55c0f2b7-dc24-425b-9be8-6b86719f2865,2018.11.15 10:12,UNKNOWN,0,100,0,HDAC,WITHDRAWAL,,,,0,COMPLETED,0,sum-user-id,1374631.034,airdrop-20181115-hdac-sum-user-id-withdrawal,accac570-de75-11e8-bd11-2f9252c4dc2f,AIRDROP,0
airdrop-20181115-hdac-fcfa3533-33b4-4056-b1d5-f589e462170f-withdrawal-exchange,2018.11.15 10:12,UNKNOWN,,UNKNOWN-55c0f2b7-dc24-425b-9be8-6b86719f2865,2018.11.15 10:12,UNKNOWN,0,100,0,HDAC,WITHDRAWAL,,,,0,COMPLETED,0,sum-user-id,1374531.034,airdrop-20181115-hdac-sum-user-id-withdrawal,accac570-de75-11e8-bd11-2f9252c4dc2f,AIRDROP,0
airdrop-20181115-hdac-fd0a4b08-7a11-4fae-b318-18ae5ae12885-withdrawal-exchange,2018.11.15 10:12,UNKNOWN,,UNKNOWN-55c0f2b7-dc24-425b-9be8-6b86719f2865,2018.11.15 10:12,UNKNOWN,0,100,0,HDAC,WITHDRAWAL,,,,0,COMPLETED,0,sum-user-id,1374431.034,airdrop-20181115-hdac-sum-user-id-withdrawal,accac570-de75-11e8-bd11-2f9252c4dc2f,AIRDROP,0
airdrop-20181115-hdac-fd163d7e-15d9-4232-8e59-efeb446bcf36-withdrawal-exchange,2018.11.15 10:12,UNKNOWN,,UNKNOWN-55c0f2b7-dc24-425b-9be8-6b86719f2865,2018.11.15 10:12,UNKNOWN,0,100,0,HDAC,WITHDRAWAL,,,,0,COMPLETED,0,sum-user-id,1374331.034,airdrop-20181115-hdac-sum-user-id-withdrawal,accac570-de75-11e8-bd11-2f9252c4dc2f,AIRDROP,0
airdrop-20181115-hdac-fd2668bb-8ecf-4b90-a289-24668bdbafca-withdrawal-exchange,2018.11.15 10:12,UNKNOWN,,UNKNOWN-55c0f2b7-dc24-425b-9be8-6b86719f2865,2018.11.15 10:12,UNKNOWN,0,100,0,HDAC,WITHDRAWAL,,,,0,COMPLETED,0,sum-user-id,1374231.034,airdrop-20181115-hdac-sum-user-id-withdrawal,accac570-de75-11e8-bd11-2f9252c4dc2f,AIRDROP,0
airdrop-20181115-hdac-fd69e7b8-0d69-458a-b6fd-76fbe3788d49-withdrawal-exchange,2018.11.15 10:12,UNKNOWN,,UNKNOWN-55c0f2b7-dc24-425b-9be8-6b86719f2865,2018.11.15 10:12,UNKNOWN,0,1265.69477,0,HDAC,WITHDRAWAL,,,,0,COMPLETED,0,sum-user-id,1372965.339,airdrop-20181115-hdac-sum-user-id-withdrawal,accac570-de75-11e8-bd11-2f9252c4dc2f,AIRDROP,0
airdrop-20181115-hdac-fd75e4e7-1859-4060-b6b5-de1447de3e93-withdrawal-exchange,2018.11.15 10:12,UNKNOWN,,UNKNOWN-55c0f2b7-dc24-425b-9be8-6b86719f2865,2018.11.15 10:12,UNKNOWN,0,100,0,HDAC,WITHDRAWAL,,,,0,COMPLETED,0,sum-user-id,1372865.339,airdrop-20181115-hdac-sum-user-id-withdrawal,accac570-de75-11e8-bd11-2f9252c4dc2f,AIRDROP,0
airdrop-20181115-hdac-fd7c6c90-39fb-4d68-bca2-c74d755b4689-withdrawal-exchange,2018.11.15 10:12,UNKNOWN,,UNKNOWN-55c0f2b7-dc24-425b-9be8-6b86719f2865,2018.11.15 10:12,UNKNOWN,0,100,0,HDAC,WITHDRAWAL,,,,0,COMPLETED,0,sum-user-id,1372765.339,airdrop-20181115-hdac-sum-user-id-withdrawal,accac570-de75-11e8-bd11-2f9252c4dc2f,AIRDROP,0
airdrop-20181115-hdac-fd89278f-1ba4-4729-8168-4895d61ebef8-withdrawal-exchange,2018.11.15 10:12,UNKNOWN,,UNKNOWN-55c0f2b7-dc24-425b-9be8-6b86719f2865,2018.11.15 10:12,UNKNOWN,0,100,0,HDAC,WITHDRAWAL,,,,0,COMPLETED,0,sum-user-id,1372665.339,airdrop-20181115-hdac-sum-user-id-withdrawal,accac570-de75-11e8-bd11-2f9252c4dc2f,AIRDROP,0
airdrop-20181115-hdac-fdad8a19-e202-45b8-86a5-d2a9c82b3c51-withdrawal-exchange,2018.11.15 10:12,UNKNOWN,,UNKNOWN-55c0f2b7-dc24-425b-9be8-6b86719f2865,2018.11.15 10:12,UNKNOWN,0,100,0,HDAC,WITHDRAWAL,,,,0,COMPLETED,0,sum-user-id,1372565.339,airdrop-20181115-hdac-sum-user-id-withdrawal,accac570-de75-11e8-bd11-2f9252c4dc2f,AIRDROP,0
airdrop-20181115-hdac-fddd5876-9001-48e4-972e-c7fc743a4fa5-withdrawal-exchange,2018.11.15 10:12,UNKNOWN,,UNKNOWN-55c0f2b7-dc24-425b-9be8-6b86719f2865,2018.11.15 10:12,UNKNOWN,0,100,0,HDAC,WITHDRAWAL,,,,0,COMPLETED,0,sum-user-id,1372465.339,airdrop-20181115-hdac-sum-user-id-withdrawal,accac570-de75-11e8-bd11-2f9252c4dc2f,AIRDROP,0
airdrop-20181115-hdac-fdeb4e20-7efa-448f-8f75-07b79704c76e-withdrawal-exchange,2018.11.15 10:12,UNKNOWN,,UNKNOWN-55c0f2b7-dc24-425b-9be8-6b86719f2865,2018.11.15 10:12,UNKNOWN,0,100,0,HDAC,WITHDRAWAL,,,,0,COMPLETED,0,sum-user-id,1372365.339,airdrop-20181115-hdac-sum-user-id-withdrawal,accac570-de75-11e8-bd11-2f9252c4dc2f,AIRDROP,0
airdrop-20181115-hdac-fe140b4f-dc7d-48d1-8c98-4ea7fa376098-withdrawal-exchange,2018.11.15 10:12,UNKNOWN,,UNKNOWN-55c0f2b7-dc24-425b-9be8-6b86719f2865,2018.11.15 10:12,UNKNOWN,0,100,0,HDAC,WITHDRAWAL,,,,0,COMPLETED,0,sum-user-id,1372265.339,airdrop-20181115-hdac-sum-user-id-withdrawal,accac570-de75-11e8-bd11-2f9252c4dc2f,AIRDROP,0
airdrop-20181115-hdac-fe2e5792-f104-44e5-b5d3-a1a6919f06fa-withdrawal-exchange,2018-11-15 10:12:27.001,UNKNOWN,,UNKNOWN-55c0f2b7-dc24-425b-9be8-6b86719f2865,2018-11-15 10:12:27.001,UNKNOWN,0,100,0,HDAC,WITHDRAWAL,,,,0,COMPLETED,0,sum-user-id,1372165.339,airdrop-20181115-hdac-sum-user-id-withdrawal,accac570-de75-11e8-bd11-2f9252c4dc2f,AIRDROP,0
airdrop-20181115-hdac-fe383a7e-2497-4cc0-8f50-129422943353-withdrawal-exchange,2018-11-15 10:12:27.032,UNKNOWN,,UNKNOWN-55c0f2b7-dc24-425b-9be8-6b86719f2865,2018-11-15 10:12:27.032,UNKNOWN,0,100,0,HDAC,WITHDRAWAL,,,,0,COMPLETED,0,sum-user-id,1372065.339,airdrop-20181115-hdac-sum-user-id-withdrawal,accac570-de75-11e8-bd11-2f9252c4dc2f,AIRDROP,0
airdrop-20181115-hdac-fe5b5b79-334d-407e-a4b3-deb865d6032a-withdrawal-exchange,2018-11-15 10:12:27.061,UNKNOWN,,UNKNOWN-55c0f2b7-dc24-425b-9be8-6b86719f2865,2018-11-15 10:12:27.061,UNKNOWN,0,100,0,HDAC,WITHDRAWAL,,,,0,COMPLETED,0,sum-user-id,1371965.339,airdrop-20181115-hdac-sum-user-id-withdrawal,accac570-de75-11e8-bd11-2f9252c4dc2f,AIRDROP,0
airdrop-20181115-hdac-fe71a3da-bb27-48e1-b895-a0b1d8f513a1-withdrawal-exchange,2018-11-15 10:12:27.094,UNKNOWN,,UNKNOWN-55c0f2b7-dc24-425b-9be8-6b86719f2865,2018-11-15 10:12:27.094,UNKNOWN,0,100,0,HDAC,WITHDRAWAL,,,,0,COMPLETED,0,sum-user-id,1371865.339,airdrop-20181115-hdac-sum-user-id-withdrawal,accac570-de75-11e8-bd11-2f9252c4dc2f,AIRDROP,0
airdrop-20181115-hdac-fe99c813-acdb-4145-91b9-8b4d83c9741e-withdrawal-exchange,2018.11.15 10:12,UNKNOWN,,UNKNOWN-55c0f2b7-dc24-425b-9be8-6b86719f2865,2018.11.15 10:12,UNKNOWN,0,100,0,HDAC,WITHDRAWAL,,,,0,COMPLETED,0,sum-user-id,1371765.339,airdrop-20181115-hdac-sum-user-id-withdrawal,accac570-de75-11e8-bd11-2f9252c4dc2f,AIRDROP,0
airdrop-20181115-hdac-fe9f037b-ffa1-4361-82ae-ec4de8e11da9-withdrawal-exchange,2018.11.15 10:12,UNKNOWN,,UNKNOWN-55c0f2b7-dc24-425b-9be8-6b86719f2865,2018.11.15 10:12,UNKNOWN,0,100,0,HDAC,WITHDRAWAL,,,,0,COMPLETED,0,sum-user-id,1371665.339,airdrop-20181115-hdac-sum-user-id-withdrawal,accac570-de75-11e8-bd11-2f9252c4dc2f,AIRDROP,0
airdrop-20181115-hdac-feaa3ab4-72b3-435a-9658-6aa198750fbd-withdrawal-exchange,2018.11.15 10:12,UNKNOWN,,UNKNOWN-55c0f2b7-dc24-425b-9be8-6b86719f2865,2018.11.15 10:12,UNKNOWN,0,100,0,HDAC,WITHDRAWAL,,,,0,COMPLETED,0,sum-user-id,1371565.339,airdrop-20181115-hdac-sum-user-id-withdrawal,accac570-de75-11e8-bd11-2f9252c4dc2f,AIRDROP,0
airdrop-20181115-hdac-feda89d0-11ca-4247-8bd7-f3768d2ff89b-withdrawal-exchange,2018.11.15 10:12,UNKNOWN,,UNKNOWN-55c0f2b7-dc24-425b-9be8-6b86719f2865,2018.11.15 10:12,UNKNOWN,0,100,0,HDAC,WITHDRAWAL,,,,0,COMPLETED,0,sum-user-id,1371465.339,airdrop-20181115-hdac-sum-user-id-withdrawal,accac570-de75-11e8-bd11-2f9252c4dc2f,AIRDROP,0
airdrop-20181115-hdac-fee1cb95-b7fb-4a99-a464-8dbf8fc98cad-withdrawal-exchange,2018.11.15 10:12,UNKNOWN,,UNKNOWN-55c0f2b7-dc24-425b-9be8-6b86719f2865,2018.11.15 10:12,UNKNOWN,0,100,0,HDAC,WITHDRAWAL,,,,0,COMPLETED,0,sum-user-id,1371365.339,airdrop-20181115-hdac-sum-user-id-withdrawal,accac570-de75-11e8-bd11-2f9252c4dc2f,AIRDROP,0
airdrop-20181115-hdac-ff192d0d-3746-40fc-baa0-2a3c547e1514-withdrawal-exchange,2018.11.15 10:12,UNKNOWN,,UNKNOWN-55c0f2b7-dc24-425b-9be8-6b86719f2865,2018.11.15 10:12,UNKNOWN,0,100,0,HDAC,WITHDRAWAL,,,,0,COMPLETED,0,sum-user-id,1371265.339,airdrop-20181115-hdac-sum-user-id-withdrawal,accac570-de75-11e8-bd11-2f9252c4dc2f,AIRDROP,0
airdrop-20181115-hdac-ff1b2d37-1948-45d0-adbe-544b963f4dff-withdrawal-exchange,2018.11.15 10:12,UNKNOWN,,UNKNOWN-55c0f2b7-dc24-425b-9be8-6b86719f2865,2018.11.15 10:12,UNKNOWN,0,100,0,HDAC,WITHDRAWAL,,,,0,COMPLETED,0,sum-user-id,1371165.339,airdrop-20181115-hdac-sum-user-id-withdrawal,accac570-de75-11e8-bd11-2f9252c4dc2f,AIRDROP,0
airdrop-20181115-hdac-ff372b70-7820-4139-8f0e-419b9d228e4f-withdrawal-exchange,2018.11.15 10:12,UNKNOWN,,UNKNOWN-55c0f2b7-dc24-425b-9be8-6b86719f2865,2018.11.15 10:12,UNKNOWN,0,100,0,HDAC,WITHDRAWAL,,,,0,COMPLETED,0,sum-user-id,1371065.339,airdrop-20181115-hdac-sum-user-id-withdrawal,accac570-de75-11e8-bd11-2f9252c4dc2f,AIRDROP,0
airdrop-20181115-hdac-ff4ec1dd-9ed4-4b22-b6bb-9b68c255a922-withdrawal-exchange,2018.11.15 10:12,UNKNOWN,,UNKNOWN-55c0f2b7-dc24-425b-9be8-6b86719f2865,2018.11.15 10:12,UNKNOWN,0,100,0,HDAC,WITHDRAWAL,,,,0,COMPLETED,0,sum-user-id,1370965.339,airdrop-20181115-hdac-sum-user-id-withdrawal,accac570-de75-11e8-bd11-2f9252c4dc2f,AIRDROP,0
airdrop-20181115-hdac-ff50a891-481c-47de-8b1e-5ca234f6359c-withdrawal-exchange,2018.11.15 10:12,UNKNOWN,,UNKNOWN-55c0f2b7-dc24-425b-9be8-6b86719f2865,2018.11.15 10:12,UNKNOWN,0,100,0,HDAC,WITHDRAWAL,,,,0,COMPLETED,0,sum-user-id,1370865.339,airdrop-20181115-hdac-sum-user-id-withdrawal,accac570-de75-11e8-bd11-2f9252c4dc2f,AIRDROP,0
airdrop-20181115-hdac-ff6dffb1-9d2f-4078-840a-0ef74335f307-withdrawal-exchange,2018.11.15 10:12,UNKNOWN,,UNKNOWN-55c0f2b7-dc24-425b-9be8-6b86719f2865,2018.11.15 10:12,UNKNOWN,0,100,0,HDAC,WITHDRAWAL,,,,0,COMPLETED,0,sum-user-id,1370765.339,airdrop-20181115-hdac-sum-user-id-withdrawal,accac570-de75-11e8-bd11-2f9252c4dc2f,AIRDROP,0
airdrop-20181115-hdac-ff80974e-70ee-4f07-9dac-d700db5d8848-withdrawal-exchange,2018.11.15 10:12,UNKNOWN,,UNKNOWN-55c0f2b7-dc24-425b-9be8-6b86719f2865,2018.11.15 10:12,UNKNOWN,0,100,0,HDAC,WITHDRAWAL,,,,0,COMPLETED,0,sum-user-id,1370665.339,airdrop-20181115-hdac-sum-user-id-withdrawal,accac570-de75-11e8-bd11-2f9252c4dc2f,AIRDROP,0
airdrop-20181115-hdac-ff8760da-5049-4e8c-b7a5-9cbf3d9ae9ca-withdrawal-exchange,2018.11.15 10:12,UNKNOWN,,UNKNOWN-55c0f2b7-dc24-425b-9be8-6b86719f2865,2018.11.15 10:12,UNKNOWN,0,100,0,HDAC,WITHDRAWAL,,,,0,COMPLETED,0,sum-user-id,1370565.339,airdrop-20181115-hdac-sum-user-id-withdrawal,accac570-de75-11e8-bd11-2f9252c4dc2f,AIRDROP,0
airdrop-20181115-hdac-ffa20aeb-9fe5-40aa-9ea9-bd96fe798ff6-withdrawal-exchange,2018.11.15 10:12,UNKNOWN,,UNKNOWN-55c0f2b7-dc24-425b-9be8-6b86719f2865,2018.11.15 10:12,UNKNOWN,0,100,0,HDAC,WITHDRAWAL,,,,0,COMPLETED,0,sum-user-id,1370465.339,airdrop-20181115-hdac-sum-user-id-withdrawal,accac570-de75-11e8-bd11-2f9252c4dc2f,AIRDROP,0
airdrop-20181115-hdac-ffcf1edd-d51e-4146-b867-1cd31b76d90e-withdrawal-exchange,2018.11.15 10:12,UNKNOWN,,UNKNOWN-55c0f2b7-dc24-425b-9be8-6b86719f2865,2018.11.15 10:12,UNKNOWN,0,100,0,HDAC,WITHDRAWAL,,,,0,COMPLETED,0,sum-user-id,1370365.339,airdrop-20181115-hdac-sum-user-id-withdrawal,accac570-de75-11e8-bd11-2f9252c4dc2f,AIRDROP,0
airdrop-20181115-hdac-ffd4a066-27dc-4f30-904a-c8a38cfd1df0-withdrawal-exchange,2018.11.15 10:12,UNKNOWN,,UNKNOWN-55c0f2b7-dc24-425b-9be8-6b86719f2865,2018.11.15 10:12,UNKNOWN,0,100,0,HDAC,WITHDRAWAL,,,,0,COMPLETED,0,sum-user-id,1370265.339,airdrop-20181115-hdac-sum-user-id-withdrawal,accac570-de75-11e8-bd11-2f9252c4dc2f,AIRDROP,0
airdrop-20181115-hdac-ffe01f44-b279-45d1-894e-183d286d98ff-withdrawal-exchange,2018.11.15 10:12,UNKNOWN,,UNKNOWN-55c0f2b7-dc24-425b-9be8-6b86719f2865,2018.11.15 10:12,UNKNOWN,0,100,0,HDAC,WITHDRAWAL,,,,0,COMPLETED,0,sum-user-id,1370165.339,airdrop-20181115-hdac-sum-user-id-withdrawal,accac570-de75-11e8-bd11-2f9252c4dc2f,AIRDROP,0
airdrop-20181115-hdac-ffe801dc-73be-4eb6-91c6-5db3e6a22369-withdrawal-exchange,2018.11.15 10:12,UNKNOWN,,UNKNOWN-55c0f2b7-dc24-425b-9be8-6b86719f2865,2018.11.15 10:12,UNKNOWN,0,100,0,HDAC,WITHDRAWAL,,,,0,COMPLETED,0,sum-user-id,1370065.339,airdrop-20181115-hdac-sum-user-id-withdrawal,accac570-de75-11e8-bd11-2f9252c4dc2f,AIRDROP,0
airdrop-20181115-hdac-ffe8a4e1-a9e7-4334-9b07-30d78b1d41d8-withdrawal-exchange,2018.11.15 10:12,UNKNOWN,,UNKNOWN-55c0f2b7-dc24-425b-9be8-6b86719f2865,2018.11.15 10:12,UNKNOWN,0,100,0,HDAC,WITHDRAWAL,,,,0,COMPLETED,0,sum-user-id,1369965.339,airdrop-20181115-hdac-sum-user-id-withdrawal,accac570-de75-11e8-bd11-2f9252c4dc2f,AIRDROP,0
airdrop-20181115-hdac-fff0bb40-1d85-45bd-9721-9c3e5b4c4927-withdrawal-exchange,2018.11.15 10:12,UNKNOWN,,UNKNOWN-55c0f2b7-dc24-425b-9be8-6b86719f2865,2018.11.15 10:12,UNKNOWN,0,100,0,HDAC,WITHDRAWAL,,,,0,COMPLETED,0,sum-user-id,1369865.339,airdrop-20181115-hdac-sum-user-id-withdrawal,accac570-de75-11e8-bd11-2f9252c4dc2f,AIRDROP,0
airdrop-20181115-hdac-fff1f399-27ce-4424-8258-b0de7c929f0a-withdrawal-exchange,2018.11.15 10:12,UNKNOWN,,UNKNOWN-55c0f2b7-dc24-425b-9be8-6b86719f2865,2018.11.15 10:12,UNKNOWN,0,100,0,HDAC,WITHDRAWAL,,,,0,COMPLETED,0,sum-user-id,1369765.339,airdrop-20181115-hdac-sum-user-id-withdrawal,accac570-de75-11e8-bd11-2f9252c4dc2f,AIRDROP,0
airdrop-20181122-hdac-01c49649-51a6-44ca-89a9-c64b46182d6d-withdrawal-exchange,2018.11.23 7:34,UNKNOWN,,UNKNOWN-911904ec-8ad3-4044-8e91-5c82deef6166,2018.11.23 7:34,UNKNOWN,0,60000,0,HDAC,WITHDRAWAL,,,,0,COMPLETED,0,sum-user-id,1473105.394,airdrop-20181122-hdac-sum-user-id-withdrawal,accac570-de75-11e8-bd11-2f9252c4dc2f,AIRDROP,0
airdrop-20181122-hdac-305107cc-d420-4c00-af1d-2180ca4011f2-withdrawal-exchange,2018-11-23 07:34:16.014,UNKNOWN,,UNKNOWN-911904ec-8ad3-4044-8e91-5c82deef6166,2018-11-23 07:34:16.014,UNKNOWN,0,30000,0,HDAC,WITHDRAWAL,,,,0,COMPLETED,0,sum-user-id,1443105.394,airdrop-20181122-hdac-sum-user-id-withdrawal,accac570-de75-11e8-bd11-2f9252c4dc2f,AIRDROP,0
airdrop-20181122-hdac-51995f10-c00a-45ad-83e5-13e15d71cba2-withdrawal-exchange,2018-11-23 07:34:16.051,UNKNOWN,,UNKNOWN-911904ec-8ad3-4044-8e91-5c82deef6166,2018-11-23 07:34:16.051,UNKNOWN,0,30000,0,HDAC,WITHDRAWAL,,,,0,COMPLETED,0,sum-user-id,1413105.394,airdrop-20181122-hdac-sum-user-id-withdrawal,accac570-de75-11e8-bd11-2f9252c4dc2f,AIRDROP,0
airdrop-20181122-hdac-5f25b560-46c1-4007-bad0-1aa0b2833384-withdrawal-exchange,2018.11.23 7:34,UNKNOWN,,UNKNOWN-911904ec-8ad3-4044-8e91-5c82deef6166,2018.11.23 7:34,UNKNOWN,0,30000,0,HDAC,WITHDRAWAL,,,,0,COMPLETED,0,sum-user-id,1803105.394,airdrop-20181122-hdac-sum-user-id-withdrawal,accac570-de75-11e8-bd11-2f9252c4dc2f,AIRDROP,0
airdrop-20181122-hdac-677cfa87-c365-46c7-93a4-d1f7f9fd1077-withdrawal-exchange,2018.11.23 7:34,UNKNOWN,,UNKNOWN-911904ec-8ad3-4044-8e91-5c82deef6166,2018.11.23 7:34,UNKNOWN,0,60000,0,HDAC,WITHDRAWAL,,,,0,COMPLETED,0,sum-user-id,1743105.394,airdrop-20181122-hdac-sum-user-id-withdrawal,accac570-de75-11e8-bd11-2f9252c4dc2f,AIRDROP,0
airdrop-20181122-hdac-751c66b1-5761-4553-8503-37939487b44d-withdrawal-exchange,2018.11.23 7:34,UNKNOWN,,UNKNOWN-911904ec-8ad3-4044-8e91-5c82deef6166,2018.11.23 7:34,UNKNOWN,0,8000,0,HDAC,WITHDRAWAL,,,,0,COMPLETED,0,sum-user-id,1983105.394,airdrop-20181122-hdac-sum-user-id-withdrawal,accac570-de75-11e8-bd11-2f9252c4dc2f,AIRDROP,0
airdrop-20181122-hdac-7dba4bbb-7fdc-4da1-8a9d-58a238cf4219-withdrawal-exchange,2018.11.23 7:34,UNKNOWN,,UNKNOWN-911904ec-8ad3-4044-8e91-5c82deef6166,2018.11.23 7:34,UNKNOWN,0,60000,0,HDAC,WITHDRAWAL,,,,0,COMPLETED,0,sum-user-id,1863105.394,airdrop-20181122-hdac-sum-user-id-withdrawal,accac570-de75-11e8-bd11-2f9252c4dc2f,AIRDROP,0
airdrop-20181122-hdac-8545cabd-b619-4bd4-9dea-bc0a55b2aab6-withdrawal-exchange,2018.11.23 7:34,UNKNOWN,,UNKNOWN-911904ec-8ad3-4044-8e91-5c82deef6166,2018.11.23 7:34,UNKNOWN,0,60000,0,HDAC,WITHDRAWAL,,,,0,COMPLETED,0,sum-user-id,1593105.394,airdrop-20181122-hdac-sum-user-id-withdrawal,accac570-de75-11e8-bd11-2f9252c4dc2f,AIRDROP,0
airdrop-20181122-hdac-8861192e-de1f-4b08-918f-9b69350a3133-withdrawal-exchange,2018.11.23 7:34,UNKNOWN,,UNKNOWN-911904ec-8ad3-4044-8e91-5c82deef6166,2018.11.23 7:34,UNKNOWN,0,60000,0,HDAC,WITHDRAWAL,,,,0,COMPLETED,0,sum-user-id,1533105.394,airdrop-20181122-hdac-sum-user-id-withdrawal,accac570-de75-11e8-bd11-2f9252c4dc2f,AIRDROP,0
airdrop-20181122-hdac-96dd8a2e-0b14-4e67-a8ba-5d53718d7e91-withdrawal-exchange,2018.11.23 7:34,UNKNOWN,,UNKNOWN-911904ec-8ad3-4044-8e91-5c82deef6166,2018.11.23 7:34,UNKNOWN,0,729,0,HDAC,WITHDRAWAL,,,,0,COMPLETED,0,sum-user-id,1991105.394,airdrop-20181122-hdac-sum-user-id-withdrawal,accac570-de75-11e8-bd11-2f9252c4dc2f,AIRDROP,0
airdrop-20181122-hdac-c21ab4c3-2987-474c-87bb-290d524ec211-withdrawal-exchange,2018-11-23 07:34:16.092,UNKNOWN,,UNKNOWN-911904ec-8ad3-4044-8e91-5c82deef6166,2018-11-23 07:34:16.092,UNKNOWN,0,30000,0,HDAC,WITHDRAWAL,,,,0,COMPLETED,0,sum-user-id,1383105.394,airdrop-20181122-hdac-sum-user-id-withdrawal,accac570-de75-11e8-bd11-2f9252c4dc2f,AIRDROP,0
airdrop-20181122-hdac-cec4539d-b154-47e9-9806-5c09a2bff00c-withdrawal-exchange,2018.11.23 7:34,UNKNOWN,,UNKNOWN-911904ec-8ad3-4044-8e91-5c82deef6166,2018.11.23 7:34,UNKNOWN,0,30000,0,HDAC,WITHDRAWAL,,,,0,COMPLETED,0,sum-user-id,1833105.394,airdrop-20181122-hdac-sum-user-id-withdrawal,accac570-de75-11e8-bd11-2f9252c4dc2f,AIRDROP,0
airdrop-20181122-hdac-dd8488e1-b7ae-43d2-a417-742ffa5a619d-withdrawal-exchange,2018.11.23 7:34,UNKNOWN,,UNKNOWN-911904ec-8ad3-4044-8e91-5c82deef6166,2018.11.23 7:34,UNKNOWN,0,60000,0,HDAC,WITHDRAWAL,,,,0,COMPLETED,0,sum-user-id,1923105.394,airdrop-20181122-hdac-sum-user-id-withdrawal,accac570-de75-11e8-bd11-2f9252c4dc2f,AIRDROP,0
airdrop-20181122-hdac-dec73f07-2eed-48a0-8b68-c58a6567739e-withdrawal-exchange,2018.11.23 7:34,UNKNOWN,,UNKNOWN-911904ec-8ad3-4044-8e91-5c82deef6166,2018.11.23 7:34,UNKNOWN,0,30000,0,HDAC,WITHDRAWAL,,,,0,COMPLETED,0,sum-user-id,1653105.394,airdrop-20181122-hdac-sum-user-id-withdrawal,accac570-de75-11e8-bd11-2f9252c4dc2f,AIRDROP,0
airdrop-20181122-hdac-sum-user-id-deposit,2018.11.23 7:34,UNKNOWN,,UNKNOWN-911904ec-8ad3-4044-8e91-5c82deef6166,2018.11.23 7:34,UNKNOWN,0,0,0,HDAC,DEPOSIT,,,,0,COMPLETED,0,sum-user-id,1991834.394,airdrop-20181122-hdac-sum-user-id-deposit,accac570-de75-11e8-bd11-2f9252c4dc2f,AIRDROP,0
airdrop-20181122-hdac-e935d955-0567-4df7-bbc4-5abaa85cfde1-withdrawal-exchange,2018.11.23 7:34,UNKNOWN,,UNKNOWN-911904ec-8ad3-4044-8e91-5c82deef6166,2018.11.23 7:34,UNKNOWN,0,60000,0,HDAC,WITHDRAWAL,,,,0,COMPLETED,0,sum-user-id,1683105.394,airdrop-20181122-hdac-sum-user-id-withdrawal,accac570-de75-11e8-bd11-2f9252c4dc2f,AIRDROP,0